ae_session_id,building_type,urbanisation_level,number_loading_stations,number_parking_spaces,start_time_loading,end_time_loading,loading_time,kwh,loading_potential
56855dac-c799-4ad0-a401-30a3576c5214,Educational,0.39315171885682465,36,11,253,702,449,92.58107268229347,7954
003eb2d0-1171-4d55-994d-d7baca9b6e04,Residental,0.19793907746888084,2,49,147,700,553,83.25790792546272,6212
b86cd2c4-2586-41de-a9ea-dadc3d59122a,Commercial,0.9729334014069567,22,9,2,509,507,20.24661892057332,3418
9016b351-446a-4553-a6e9-64ff8186e331,Residental,0.34806426527874246,10,10,343,1319,976,46.32642247676081,3201
edcd5cc6-a8f7-40a4-9b47-01362d95b6b8,Residental,0.6498705664876732,9,9,417,603,186,96.34083325259671,2001
be1a10aa-8cc6-48a1-8b58-1dd96efb6e4b,Educational,0.17845077177168012,6,15,631,1288,657,10.025720520767614,3959
63e3a7bd-ac94-4e56-96df-092c684d7b66,Healthcare,0.9402375135836076,31,21,623,1304,681,66.73571075179782,1839
f170f883-b0f3-45e9-a464-8a65ab93c8a3,Healthcare,0.9396138834811929,13,46,482,553,71,50.15907717616741,2462
489506de-c2e5-4b06-b2c4-caa3fef8a63a,Residental,0.39818445781077116,48,25,476,1429,953,55.71125757790047,3793
0ab78cb2-443c-4099-b840-3ba3bbc5c6d5,Educational,0.8774492127779737,36,39,440,843,403,55.893785516546465,2714
1071d4cb-ad39-494b-9905-230936632d9a,Healthcare,0.023547292633519623,28,35,417,722,305,69.19170253893517,6248
1739304e-fb6a-430e-aef4-2c40c2cd9fc0,Healthcare,0.9997435850613196,39,34,2,633,631,24.9938183362931,4691
ee38dc43-4ea7-4ed8-9c46-03324be616f5,Commercial,0.7214577184332615,42,19,69,1011,942,16.35496923793797,2242
25adaf42-0eaa-417f-b151-f733915cfffa,Educational,0.29654419600130266,38,13,62,668,606,47.70120725272185,2023
ac8399fd-86fe-43bc-ab93-ba2c3d7f258a,Healthcare,0.5948774379641204,12,24,202,368,166,65.7266269722422,6737
150fcb2a-3738-40e3-a5d0-ed0b11cd63f9,Healthcare,0.6039794237750347,15,2,515,636,121,94.24950070981568,6535
1248c855-d2e1-446b-9946-f12350ffb3c5,Residental,0.08112959294925637,1,38,232,849,617,57.7002382232871,3803
3eb64f81-2d62-48ef-b03d-45965f5046c7,Residental,0.5039719667601569,2,46,197,1423,1226,13.448971815527957,2289
95c0346c-1c3d-43f7-a770-7f857ab2c93b,Healthcare,0.10036686894682867,17,46,587,746,159,86.46352808165516,5544
285485bb-5c60-4911-b4af-c90cf1755737,Commercial,0.24318240840790883,14,1,211,1038,827,35.27929616567627,8564
9fe463ae-bfc3-493a-a44f-24f0773c63ab,Educational,0.002087772489306028,18,48,220,923,703,65.61364668649405,4265
8019551a-f419-4893-b646-bfd2866475d8,Residental,0.1248867261104678,23,44,666,1009,343,24.500527207388302,2677
fefe7d8b-5034-4e60-8681-9036016aff88,Educational,0.9100344335897301,39,47,622,1296,674,11.560030936904866,6432
0e8ea24d-a360-4943-80ab-c875208e51db,Educational,0.47940636608538767,36,40,77,133,56,44.06614839273874,6550
a83b8b94-d721-4a7a-8a1f-cdcf15b3a987,Commercial,0.4061109585889131,9,40,660,1137,477,19.942908233861793,8752
b3fb8185-98c1-4752-871c-ecbf892deeb9,Healthcare,0.8219130423141845,42,12,146,259,113,25.289409344780413,8625
fc41e0f7-471d-421f-b139-1a4eda85473f,Commercial,0.1611707271225128,9,11,46,617,571,85.15671739321036,2879
9451806f-ea00-4695-9008-eb1470ac5824,Educational,0.5919406373082255,22,46,419,795,376,36.74054155610489,7321
07ef3b2d-e749-48be-a12d-bddffcb4cdae,Residental,0.6466725973464068,6,40,687,1110,423,32.62806675498138,2911
5c8e6367-70c5-470e-82bb-7dfebe99c1dd,Healthcare,0.16420886607880836,49,7,265,394,129,21.480473075535343,8217
a11d8830-7f1b-4269-847f-7f70cd9cee6e,Residental,0.893762335945127,41,16,390,1185,795,80.04116114084351,7576
adcd56fd-272c-4edb-aea9-c65c1359faae,Healthcare,0.36378190710451586,17,11,565,689,124,61.54728477882437,3095
8569cf2c-ab7c-4c78-8dfb-a532b854cdee,Educational,0.19355060476327146,8,18,148,959,811,52.7801757430733,7194
f039e20d-0e01-40ab-97d1-2d538279c3f7,Commercial,0.07720626476771353,10,3,581,692,111,63.772015587936565,1450
0646ff1c-7a7f-4658-b066-b43bc6b04336,Educational,0.2122722222287523,9,49,268,967,699,54.88192513994437,3829
1fea3bee-54e4-4d32-86c9-789726443a46,Residental,0.9699782657523636,16,19,320,573,253,17.668617415191775,7171
dc5af82f-be4e-4691-b987-bef36bcb2a7f,Commercial,0.5813031106745489,22,12,185,745,560,41.25009189695049,5413
4c1c0ee2-5779-43b1-a596-a7f87163d5e8,Residental,0.8133090475028143,10,25,497,1404,907,36.95680065406931,3227
8ec51e52-627a-419b-b9e7-fa7b26e3c3ac,Commercial,0.5995610239770613,23,5,289,781,492,12.025940547444565,1779
5e6a5be3-fb41-4a63-b454-6c7b6a448e02,Commercial,0.035193176918617564,18,35,595,684,89,60.78428724252327,8464
54c6a22f-e95d-423f-a080-2bd3212c3178,Healthcare,0.08730779293342616,12,14,608,620,12,43.52261763632029,5936
b2007ebf-eb0c-4a4c-9dc2-da6a0b4d6d7a,Healthcare,0.41272758064734183,21,42,282,704,422,92.17844260198223,5359
a7e417fc-d312-4299-8eb5-9756da49d9ed,Commercial,0.3083979489560583,50,13,586,1314,728,55.65655955677578,3731
6189aa47-d03c-426d-bd8a-61dd02121bf4,Residental,0.8090487633400818,5,17,148,1010,862,29.167192319922346,3887
6f4f3d3b-757b-4f82-838f-3f633304cfa7,Commercial,0.19272077265022436,44,4,500,999,499,36.20133357180512,7193
64dfd7db-8550-412a-b963-2fd1994b8f2f,Educational,0.46414018451216754,29,41,669,1425,756,75.6015135947256,5520
66d27a8f-2bb6-46a1-beae-0969c6606335,Educational,0.6341132566443454,48,40,425,886,461,74.38007133439423,9103
e694b640-5954-49d5-a7ab-6868a8cf317d,Healthcare,0.9075812267221399,1,40,574,1152,578,90.750519312798,9211
b0074bf6-3171-42b5-9185-239bd10a2ec4,Commercial,0.12712082213363274,17,1,706,954,248,26.521943386183292,3295
b9c1ab34-bdcb-4d07-bd9b-3a49488d1adb,Healthcare,0.36367014030548583,40,2,688,739,51,18.522246295153707,7225
5e674eac-c511-4d43-a8c1-de95b91147b5,Residental,0.22932366677532834,47,1,499,1184,685,65.58599902382883,2163
ed1195a9-e84b-49a7-a189-56723c577997,Commercial,0.2961713463809815,48,26,604,1234,630,57.28816337059856,8677
fbcb9d5d-9f91-430e-aa40-c7d6a46646af,Commercial,0.2582204694880915,17,19,381,606,225,15.13500723720718,9510
c9e979c8-6127-4472-ac1e-36013e2eff22,Residental,0.7470237240380363,7,14,689,1042,353,50.92482424653515,2362
e70331e3-7595-4c44-9ad0-d7ed2dbfa81d,Commercial,0.11752094997543805,33,48,192,273,81,53.6129285894924,9449
c402888e-5759-4982-9ed7-52341c04f453,Commercial,0.03721262179063456,17,45,130,1008,878,65.19347127237222,3601
b339a59b-4839-45c1-bb43-6afcf2edc96f,Residental,0.1572640561206623,4,22,665,790,125,36.39304309215764,8536
02c434d3-e0d2-4f35-aaab-7c5d164f82a6,Residental,0.40537916596150947,38,39,254,1384,1130,59.848460024904085,6949
8a41ba07-94af-4517-a4c2-eb1ab87e306f,Healthcare,0.5591701263595121,14,27,698,1155,457,36.89280806316792,2314
f20aaf34-08b3-4545-baa2-0722468f8904,Commercial,0.7143161403117282,47,46,18,856,838,36.073135475577956,1848
db2d3dd1-1ae0-494a-ab67-76aa16df68cf,Educational,0.6330135875294868,27,2,354,1350,996,82.7238728803151,4334
ca19dce9-422d-4803-b346-ca60a893781e,Healthcare,0.6193161707472039,6,1,576,666,90,49.11776029643136,3554
39627d53-a140-4596-85c6-19f4fae8a3bd,Educational,0.5451822980329211,2,23,168,488,320,41.67958715345093,7703
967a9e6c-a10e-4998-8d72-98099c16550b,Commercial,0.529561422850494,32,47,530,973,443,54.152336597870956,2293
d40190cf-30ff-4c5b-837a-69af0391bb21,Residental,0.19769708343252268,50,48,24,867,843,74.04613036149462,7038
73da3afe-9250-4fbb-aad9-6d933a911b95,Healthcare,0.08276196923209311,9,29,476,891,415,48.53304479397095,9120
d24cae80-7c9e-42fe-a7bb-f0c07c46b1d2,Residental,0.3519513573324965,27,46,279,1156,877,94.48666856402976,2046
1e8e92a5-b2d7-4111-8ba4-51ac62a18a7e,Residental,0.337103736255115,5,15,247,485,238,12.540025310589197,8570
d4b1842b-5a47-4469-90bc-23668129e91e,Educational,0.9862232651627331,11,17,135,792,657,83.16894410498737,8054
e0d0448c-ee49-4098-846d-edd1f47ac66f,Residental,0.9895096451035429,25,13,351,1100,749,10.491879462858348,2419
d11e5eed-e671-4bc9-920b-ac6a4f7cb0e3,Healthcare,0.9895816871833324,48,25,343,541,198,40.41817600929002,8933
8047c6e2-d4f5-4e84-ba5a-5ddff7ca0c83,Educational,0.6266584690545147,20,37,665,905,240,44.31957346390834,1577
fcbba66a-0a45-4f29-b1f3-d849edf982e2,Residental,0.11566804896994631,29,32,423,984,561,16.04938987749077,8148
a147f9c0-5ed0-4713-b54b-5737ca9ea062,Healthcare,0.7668893861238821,4,49,598,844,246,95.17884995594012,2196
5a1ce1dd-d8e7-4fa3-aadf-7cf49dc97af3,Healthcare,0.5655059748367065,44,36,518,760,242,80.03805160836853,8706
8e498a68-0e89-4bbd-aff7-abc0c68ce806,Educational,0.2598633693207254,35,28,687,1295,608,44.43682666591237,1561
f0f2f664-0485-48ff-99fa-01a6690b2f77,Residental,0.28242097886214135,26,25,466,1221,755,73.82694287433567,9187
88fddfb5-661e-4d54-8317-f8d4d07c6b73,Educational,0.8390733254875831,12,47,393,619,226,70.33827648528089,1742
00f1fa9f-d562-4f60-9bac-b954a2401cd6,Commercial,0.38990828868884,25,18,255,422,167,97.30117260317873,6003
a785245d-59b2-48bf-95e8-c81481bdb492,Commercial,0.5457035254712727,15,34,134,200,66,24.726642619157815,1835
a188343a-be65-4ac7-8922-a59f2731f300,Commercial,0.772555654332808,7,11,387,824,437,25.239456691315816,6850
d0564c16-7ffa-4cca-ab08-19c634d76927,Commercial,0.43333882085271813,27,44,98,686,588,69.87294753502829,9262
2dfcf33e-462e-4776-aad2-678391ae6969,Educational,0.4443153149403354,7,4,690,1219,529,89.66496392496332,9146
9d64792c-4538-4c64-8dbb-b025b7a56c8a,Residental,0.3238037646499934,27,28,388,1233,845,10.193961452943645,6146
8a0d85f2-1cd3-4fd9-9df2-854323ddeadd,Healthcare,0.9034805529292794,46,10,379,987,608,76.05509048170548,7734
740b0d61-2887-468a-897a-383d00b6a4b4,Healthcare,0.907685320730802,8,43,221,788,567,97.8611181360824,1095
5a732267-10d7-49aa-9395-be8cc95f5ae3,Residental,0.9072284775495194,1,47,594,801,207,64.76569291917495,4615
a3c7cffd-14ff-4050-90d7-9e50715f09f5,Residental,0.9663926735946688,37,24,343,669,326,68.09957144363834,8593
714e7b80-feac-46e9-8a7e-e1a6a1fcadd4,Commercial,0.6957465604889344,48,13,414,1211,797,10.875407883232366,1859
a45073f0-2839-40b9-a5b6-d9c32a65288c,Healthcare,0.5066285864819601,31,33,179,948,769,52.98779009169497,6711
6c9e02fe-3002-4364-b6a5-7f8783bfa61a,Residental,0.1726669484253327,33,50,595,790,195,95.58564279558779,6061
89c1a131-51e0-4499-9cb6-f13340b78a81,Residental,0.08745244332668956,37,1,54,201,147,62.492104946236594,8308
6708ea4d-55e4-4646-8fb5-31fda4f9a283,Residental,0.39550462466785874,9,3,333,398,65,38.87438132272198,3808
8cd9d9de-2c89-4ebd-9d4f-be062a13d026,Residental,0.10913273420678482,29,42,307,701,394,37.356176886042746,2235
71fb8732-6000-4a44-9cec-593c3c62ffbc,Commercial,0.8918300139710011,4,44,397,446,49,51.86061235917208,6286
d2a8d260-704b-46b2-81f3-7f151aaa3720,Educational,0.9748738855239804,46,15,334,740,406,59.63358885212461,3510
dfe00adb-ac25-4c78-9f78-f9d847045b43,Commercial,0.2441494944217546,49,45,228,1015,787,98.67302181376068,5603
3bc3f673-0195-4486-9445-0f80910d0deb,Residental,0.2659624113761657,12,40,117,1215,1098,52.01420101134706,9482
88b025a8-609f-4e2e-854b-e58e2bbacd87,Healthcare,0.8505110269810481,25,42,7,630,623,33.36551184268323,1884
ab6cdfd7-5378-4f63-ae3f-725a678da8f8,Healthcare,0.12391916268833547,13,13,39,215,176,34.57136747300602,9627
4b45f27f-f92a-41ee-aca7-1ff33baa5eaa,Educational,0.11471653832579176,1,38,568,1074,506,28.411344941647478,3765
64877ec6-db9a-44d0-9f87-37c730e0fa3c,Educational,0.6489880767305818,17,22,504,521,17,71.80606995756452,5860
25fc3fe5-e533-41db-844b-b5ed8a335f05,Residental,0.5512773723740394,41,50,600,1245,645,16.654162966454066,9482
2117e63f-0a62-48aa-9d79-be3b3258bc9e,Educational,0.49576478052785944,41,26,511,1033,522,91.71951280260426,5230
caa1e8f1-b1e6-4943-aebe-bec563b2cc17,Healthcare,0.9520965730526646,39,18,325,467,142,22.9223604297717,1116
12ca8839-173e-40f5-8a8d-31f78e1712ec,Healthcare,0.6650838931024282,26,19,528,830,302,34.26825831345631,7031
b4a10226-2873-416c-87a4-08f54872eb1d,Commercial,0.9607657315294234,43,6,66,232,166,53.07503172852074,5918
652cbdc6-a6a2-4bbe-bb38-f2245c71aee2,Residental,0.5311106874635156,28,10,385,744,359,16.669476278451253,5508
ff2863c8-18fd-49cd-a388-346321309783,Healthcare,0.026572656701809194,32,2,579,1366,787,97.83354615041029,3673
6b9f83b8-1631-4ce7-9523-f3cf8d822f33,Commercial,0.2647121246111803,24,42,277,730,453,61.67226411323233,4020
be75d846-cf71-4deb-8415-fce5fa754b36,Residental,0.6785793913124581,47,30,617,767,150,90.47379206339596,5368
755bde2a-28d2-48de-b61a-5fa203c28a67,Educational,0.6499842728927632,26,16,571,1236,665,43.56705080421501,4000
1a8771c6-a40d-4ef1-a82e-bb88b977358d,Healthcare,0.7093584756940476,37,50,139,1236,1097,29.672273365722386,7284
33f6d7be-259e-479f-b294-45c1aa1275ef,Healthcare,0.162062085612374,27,17,650,881,231,75.524402141553,7992
badbbc38-0c6a-4d33-9d57-7528ddcf6f51,Educational,0.2221435016951543,4,46,438,614,176,93.19886523801813,9961
98daa815-71c3-4147-8a22-20061e7a63ad,Educational,0.40847849108133205,1,11,678,1238,560,60.028292084302564,7659
18c27f50-99a7-4e85-9b90-c7409b17e427,Residental,0.3181687533332046,47,48,463,929,466,79.46841743080415,7521
7ed20655-a918-423f-8459-db2563ee08d0,Residental,0.28631839320244246,15,2,438,571,133,61.67006065818012,7334
7a8bc635-8a0d-4622-a28d-96fb2d314a14,Healthcare,0.037762389798089546,20,29,550,971,421,19.430428638108914,6782
94a0e139-ec36-4cda-9495-78821b08b930,Commercial,0.8540194799471872,35,37,668,798,130,92.40174907144842,3810
49a98902-9dc1-41e6-bceb-e1fd545dbcb2,Residental,0.6813099774672713,27,11,310,954,644,31.410730902651025,1975
32dd67cc-2574-4455-bd84-30f46f9f0b53,Commercial,0.3669675718554869,9,15,86,500,414,36.115016867911805,2751
80cc82bb-54e0-43b9-8abe-a6c25f63da4f,Residental,0.0681228344563557,23,23,374,967,593,85.13721479254723,6076
031adbc8-9b47-42f4-b299-45480c49ace7,Healthcare,0.38571889561948003,46,47,451,634,183,14.96075111797044,7368
ee7168ec-ebf7-4fa6-b618-5991cc17efd7,Educational,0.21157903923624022,22,37,121,918,797,14.286943874116655,7585
3531fb76-2d8a-46d5-ac84-9ed9e498aba3,Educational,0.7340532760260094,12,45,397,757,360,31.53197862156601,2311
f95294d0-aa77-49bc-be1b-86a0066decbe,Commercial,0.4799847766889094,18,50,554,1334,780,74.67072728427614,5933
063380a6-70ac-49ec-98c3-7e1fbc85e6a9,Educational,0.17922362548524384,47,35,628,632,4,56.23275080608493,4065
209be3e9-c1a7-4e63-8b57-fa81a9f207a3,Educational,0.9570180519785745,29,22,61,174,113,95.21271219675583,5543
b5f26640-00dd-4f1a-a153-bb68a8f85b00,Residental,0.518204766054932,8,27,246,366,120,73.21899802676597,6167
267bc75d-b760-415a-ac96-9355ce95f0ad,Commercial,0.9897123618779426,39,24,378,1000,622,21.1823838865935,4654
93468949-2793-47e6-a4a5-4da829b4f91e,Residental,0.8425739655658108,30,5,97,1210,1113,81.63741443118909,2201
d4bb0dfe-0730-40aa-a3e0-1a08fe36899b,Healthcare,0.29594995054646867,12,3,282,1215,933,13.084994939562357,5552
f84c5526-982d-4832-98fe-fbc546bc8548,Commercial,0.560368816655258,2,8,440,956,516,90.82166121819142,3877
ea49ae9c-8630-4c0e-95f2-da6fe222eb4b,Educational,0.10510452096552103,10,27,223,1102,879,25.47835421807896,6401
6c3b2530-57d9-492c-87e0-2587943f8dcd,Commercial,0.0759404614916307,7,33,482,1423,941,22.173266365183864,5604
50870937-9735-444b-9b36-3deb2086f1da,Commercial,0.8861752407558929,11,22,207,751,544,27.93993716941084,8699
29f3e52d-b547-4ca4-8cba-2abc75bfa53b,Residental,0.057440886142944736,34,1,514,1178,664,70.18928032722826,6820
03fa4356-a36b-40bf-915a-80024b977694,Commercial,0.9548263324619986,30,30,286,1020,734,23.617934196214733,1926
ec0d2281-8282-40cd-88b3-c8aa13bed7fc,Residental,0.3700701497793514,7,8,117,835,718,68.46258824442539,1430
f7599770-432a-4646-a5c8-92fa81baf1f7,Residental,0.5212091092862698,42,3,157,452,295,35.214536625848055,8715
9b38e9b2-2609-47c0-8f40-627885957970,Healthcare,0.22605689718208488,12,4,445,882,437,58.05187643566978,6118
11c10c24-81e5-4183-b6c7-3685aa9f5493,Commercial,0.18100019560732472,18,43,469,997,528,81.61969274374323,4699
916df1fa-c412-4b3a-a69c-8bc643f46be6,Educational,0.819894171026476,34,30,45,853,808,92.39521569717837,1319
7b2b166b-d0a1-46a5-b578-61123c8de08d,Residental,0.13978221670406876,19,8,242,1179,937,48.14923422743882,4567
51383e92-c220-4556-bad1-0da99c023bd9,Commercial,0.6377045546480216,28,15,315,1277,962,96.89013505075715,2005
2ce0fb1e-1619-49aa-b82d-674e1ca0cdba,Healthcare,0.38542585915022765,9,32,420,1175,755,64.63754665192607,6139
a10c22da-e341-4843-9947-b6846add0cfb,Educational,0.46489824083559006,31,46,509,1385,876,10.90695406664189,1059
3fd56daf-e96f-4ec7-8996-6b9eb1e66cdd,Educational,0.4137250841815271,18,46,303,1119,816,85.22623078822053,6583
30524604-e40c-448a-9613-4ccb75ab22fd,Healthcare,0.5404539116260593,44,40,623,652,29,98.26098222240368,7131
9a892c6a-3ea0-4b53-9c2e-139d1b539e49,Commercial,0.06474428707699198,39,18,683,1116,433,12.86061174478435,5092
c4b7df0b-9140-45d6-87e3-2e6d8edf18c8,Educational,0.8746659552110525,41,48,506,752,246,78.87341645942443,4834
c1652b66-e5ad-4fba-9984-07e71a4f7ce2,Healthcare,0.14873688443283484,31,33,106,584,478,33.37622059134001,6855
4af87b76-d4ca-4461-a3e6-22a1e71a2495,Commercial,0.21153117432473822,43,41,93,1304,1211,73.46389524870918,2841
63a1d8b7-13c8-4274-ae43-61f2534665fa,Educational,0.8754824046883548,40,23,595,1292,697,16.257668417124254,5492
18a25827-8888-4744-993e-1c8fc32b7bec,Educational,0.03470880707985469,39,16,609,1024,415,49.174357918119405,9208
515bba8c-cd77-491f-a36b-fb6e43671dc7,Commercial,0.8267440256183299,30,13,368,735,367,73.15771529406356,4905
251a646f-eaec-4729-9c4e-b5b2ace7fe61,Educational,0.5435761986958118,47,12,87,1335,1248,12.455756669307277,9778
4dd73f3c-171f-4f41-b6c0-f4b5a99bbf10,Residental,0.985080941311721,35,13,642,842,200,83.5952698107978,1496
ed7e9655-8009-4a1f-b331-d63985461296,Residental,0.6288290046605461,1,9,142,1302,1160,77.93002791715723,6962
9338157b-0fb7-4dda-b8ea-2e0da46a34ee,Educational,0.08799943614954975,4,49,398,1097,699,91.548505304143,6934
d1b7d3b2-b59d-41a1-916d-a3d1099edd17,Commercial,0.2284767532361327,29,12,305,918,613,16.562048035653508,3967
0c4debc8-0938-4262-b0b2-c9d210f50973,Residental,0.09983816368332099,38,18,392,503,111,59.28735897525342,1588
bb15c42e-3702-4896-8626-3b30cb08d56b,Educational,0.5102931068009556,50,19,379,1123,744,95.05540744302007,3004
8a1553ea-22eb-44e5-b8e6-f70127a7ae1b,Healthcare,0.6181947207488048,8,7,688,1162,474,16.112164140751105,3851
6f800cb6-1eeb-4f75-82c2-c2c9af36176e,Educational,0.7089697950402151,26,42,121,156,35,10.969578193148962,6722
1610013b-e2be-4540-8747-2e329b22d4e3,Commercial,0.39548473258112427,2,39,537,1322,785,87.14836761708835,5479
4034d9ff-7a15-4e73-b9b1-323041f262d1,Residental,0.7251150328463088,38,37,74,1358,1284,17.96785333407317,3307
68ff9a8d-9c9b-4fd5-96b7-214033a02ed6,Commercial,0.009099756580562723,6,25,576,1348,772,44.67289740612541,4713
35185a2d-9ace-40ff-8519-6d29046c9407,Educational,0.4395656400274349,44,36,235,734,499,66.0336063954287,7920
dc90e2ae-f7e0-492d-bc16-c537b5738678,Healthcare,0.35617208052852023,9,6,216,701,485,83.2344499066068,9970
4950bd65-b19a-4d3f-a669-642827726475,Commercial,0.32109598742594603,6,48,398,1106,708,46.99267201187984,6512
4125d27e-10f8-4d6b-ad83-3c362ceac476,Educational,0.9084108250584276,28,35,449,1219,770,67.14630101134175,9126
a2dd297c-64a4-40d6-9e47-c06881c0ec05,Healthcare,0.7465661063504738,24,48,672,868,196,53.42750293438451,1819
2f2be50b-c654-4bd3-82fb-96153f20cdac,Educational,0.12627284911729064,32,1,343,586,243,64.3115549015908,7513
b39ce707-da33-4f3a-9fa4-e2308c933566,Residental,0.3062486079992731,8,14,449,852,403,54.8018430149501,1017
047cfbe0-742e-41ab-a1f5-05d7602c93c9,Educational,0.4083937628467956,1,2,403,946,543,97.58559804558168,5688
c6e6873e-6d02-4c55-be1f-bc36453b9751,Healthcare,0.19003043681819742,2,46,85,1193,1108,67.87837275426006,7201
08e5da9a-34f1-4da9-bfa7-6107e703ccad,Educational,0.44215444887792377,1,27,129,479,350,91.0333258268608,2264
bd5813d5-685d-4de3-97ff-7bedcb8e18c6,Healthcare,0.40637503068338976,45,48,485,778,293,51.92146282268611,5123
bdbe8fec-90d9-4fb5-baf5-acca89f2fda0,Healthcare,0.9634225987954131,13,45,267,1324,1057,96.50580918975382,3553
73b759d7-7b83-41c2-9b0a-26235d930faf,Healthcare,0.28777361923951017,18,40,122,248,126,35.918493563137545,7275
b0bf1b99-b72e-4cb8-b3e6-e5d229fc5029,Residental,0.3078263654014718,12,28,183,908,725,60.70797462020374,7279
480787a7-f185-4d47-b525-3b8551c8b0d8,Healthcare,0.4579980072435661,2,6,3,484,481,45.505266635391145,9225
4b747e6f-93f7-484c-ac34-8ae3057d077a,Healthcare,0.0038514550855652807,32,37,71,559,488,43.41831448077583,8320
1ea7bed6-57a6-4828-bf7e-9390b1d49353,Commercial,0.9899355983261418,49,9,224,1112,888,74.69776799974753,3371
a202313b-b52a-42b6-a4ab-7082cdb40ede,Healthcare,0.8439601564175,29,40,610,1203,593,26.606036520697874,9348
59eae5f0-106c-428a-94e5-79e9f1e2e0d9,Educational,0.32024696912504147,16,48,108,221,113,79.5849861632822,4198
33ea1cd6-d906-4f66-9c0f-e40a6361008a,Commercial,0.43108049190549447,24,21,81,146,65,70.33526629836916,3033
8419deff-7321-4015-a617-b0726480b315,Commercial,0.8384200053496514,48,21,238,580,342,39.5138901164715,2824
e0acd4a4-f719-47e6-a553-53433e232409,Residental,0.2020760882840691,13,20,99,119,20,96.32416200360254,3315
961969a6-eac0-4f69-8dae-d8be583afdfc,Healthcare,0.6332582124838004,48,19,573,589,16,50.62626825291653,4417
b274d21f-0cb5-41b2-8f28-18dab2350127,Healthcare,0.1889403070745923,27,22,260,703,443,11.281244381297258,6697
96c76960-148d-4fc5-b3a7-1971b2bcad84,Commercial,0.4259226555348711,47,27,661,1324,663,19.093103379305713,5910
659b2b34-265b-4dde-9b8f-facbe9ba55a8,Educational,0.2616163639832638,49,46,639,1221,582,26.450616081169994,7643
743e0811-6fef-4386-a9aa-d7bf1ae0fd13,Healthcare,0.20973941991424427,50,16,459,1342,883,15.885424583141639,8360
b7351d36-bd6a-4ad5-b9f8-dfbec1f8740c,Educational,0.17058685828066533,27,23,230,760,530,71.93609349685214,7963
809033b6-aea1-4047-84bf-94ee69cd714f,Educational,0.6809722781937468,31,25,149,782,633,53.49426849526069,8256
bf00658b-8950-4657-93ae-66aff08d058e,Healthcare,0.18868292027280442,46,26,385,1154,769,29.18496264181522,5756
de687b1e-69dd-4182-a47f-a19dc034b23a,Residental,0.5602361420879122,17,38,703,951,248,66.29766074350572,3579
f0b79b80-f749-48ec-b5ef-205adf674c99,Commercial,0.9002195335288917,39,5,330,1359,1029,44.26251251134484,5459
80e09a5c-4798-4734-980e-24172bafaf66,Educational,0.775070664632097,25,1,214,558,344,95.26859594741873,2882
dca5a2f7-d3a9-420d-82bf-b920d989a588,Commercial,0.34732799020211047,43,41,236,409,173,24.568363939102277,1546
8c19e001-5436-4225-a897-6e2d2180e4a3,Commercial,0.5193921426439666,14,45,11,1332,1321,41.67662018491636,9254
17b09eec-66aa-49d0-aabc-86457f5609ef,Commercial,0.6367963156926094,19,12,157,1097,940,69.06703438776447,8167
700fc352-cc2c-457b-ad31-ba859bc35cd4,Commercial,0.9371769906545484,6,11,501,769,268,82.11736982034897,9179
a9a36a08-f18f-40de-ae1e-ed090bd24fe8,Residental,0.6574843232307532,3,8,86,709,623,13.642259955162725,5241
5e842993-ac66-4bb0-97f6-1d6f7b8429bc,Commercial,0.923670999969109,35,45,220,449,229,10.075254542154886,4879
1e9b75b9-fe71-4900-a111-6dff6c0b4658,Educational,0.21212224551127778,50,34,443,1036,593,24.01417151106576,6659
0386b920-185f-49eb-a810-fc5a8dd36a5b,Educational,0.733105183845045,37,40,26,307,281,54.54745526587061,4022
69ca5efb-6161-4ce6-8916-7f416fa606a8,Healthcare,0.0758911283995437,27,38,619,1052,433,22.64124676694348,3041
dcf821fb-28a8-4029-895c-e1e625d321c3,Commercial,0.2772926415365199,46,31,155,560,405,34.20428650118186,4981
eb96d777-b7a1-4ae3-9e04-c2946e567c59,Commercial,0.2894490015803225,33,7,312,314,2,78.20467765713585,5450
a57e7d81-a2d9-405d-a142-a7f4d4a1346b,Educational,0.13591177177325564,44,43,290,422,132,32.373020138723334,4132
80377b1b-452a-4a98-976f-387c66931c54,Residental,0.28849400972194583,50,22,510,1054,544,75.59535020078178,6847
90c1f29b-f48b-48bb-9f49-6fcb7c081523,Healthcare,0.771873616239894,2,17,557,1235,678,12.197015307524453,4692
844783d5-43f9-4a17-9a46-479ef40ea15a,Healthcare,0.0668037733469844,2,2,627,1322,695,17.569993843476603,2144
c3d1f525-ed98-4197-a036-a892320340a3,Educational,0.7827364821887494,35,22,400,1405,1005,75.22919437223767,1435
fa9e3e9c-bc8f-4045-b789-65a1f87ec7d0,Residental,0.690532237756622,46,41,672,1196,524,72.25375018072585,6854
f4d6f0b1-43c6-4c75-a69d-fdb00db0afbc,Commercial,0.5086365903419086,9,35,403,953,550,65.91731279154212,9924
79e72435-1b09-4a55-8048-05143a97325a,Commercial,0.3052533171920453,27,10,246,901,655,67.84401134927573,6909
413c5aae-54d9-4049-b7b4-5878a81419c2,Commercial,0.06729029025745004,41,12,574,630,56,13.769439009004321,5358
83f14740-fb97-4a21-af89-9ca2237241c0,Educational,0.08347963226854194,27,12,657,1354,697,78.37568695604921,9850
b07d81e6-66bd-475a-8a90-cdd7c0680443,Residental,0.5842511933165989,39,20,626,1124,498,75.48450755504427,2669
37b97265-3b78-4e32-b37c-63bc67d93c1a,Educational,0.24634969598751733,47,46,648,968,320,36.278954791132506,6718
fd731f77-3653-476d-85ee-561926b846bb,Residental,0.9208995018222507,36,6,95,505,410,45.47758443983913,2151
c0ca2340-7594-4086-a09a-07a13cfcf404,Healthcare,0.9513289584069509,2,43,626,1097,471,51.49625992656336,3594
a2871717-3475-41d9-a0ab-8b77945f43f6,Residental,0.8137785293555132,24,20,606,1145,539,13.888035085743562,7245
2e2de978-2db1-457e-a680-00eee0aede97,Educational,0.7674644302919822,26,46,126,787,661,66.3146342831772,3286
4589923d-1ecf-46e5-b94b-54ad14872ac2,Healthcare,0.10211653985395874,26,40,139,451,312,75.6362081813431,4437
b936e6cc-953a-4f19-906b-2f4db5630e76,Residental,0.3097750377472325,25,24,153,974,821,56.56078287686132,4318
f07e2c5c-0527-40ae-98dd-d7e99c472168,Residental,0.6865315684610412,14,44,82,322,240,37.42999763922738,4346
c54d1e33-85cb-4425-bf18-f307b1dec9cc,Commercial,0.031473183073450595,12,2,234,1148,914,26.32826480997588,7817
423312b6-3792-486e-b0ee-948fd5e8f504,Commercial,0.7145730626688687,43,25,399,523,124,43.92650821034409,7450
9fb7cd14-ca65-41ad-9aa6-2e019848b894,Residental,0.05875661276279642,20,18,339,510,171,84.90156659533541,4642
3299e2f6-3316-471d-aa28-46dbf4a38284,Residental,0.48564808085026756,11,31,472,732,260,70.72026339161445,7586
1854fa11-97ce-4ed3-a1e6-b05a289daa32,Healthcare,0.10274415969236916,21,13,317,1275,958,47.02827004781759,3033
e812d0a8-8fdc-4f5b-a78a-6c8bb8603d30,Residental,0.2731381875578125,18,47,305,946,641,73.30629895425848,3856
bd9031ed-a05a-452d-81cf-2763b543a6d8,Commercial,0.024540692301160183,13,5,322,372,50,73.0454170617652,5751
6beb5896-342a-4d71-8d95-addaefbf461e,Residental,0.6615212508633816,46,14,491,1010,519,20.641883127604093,9260
d9c09d9f-5e72-4c43-bdc6-937232b08acc,Healthcare,0.8083622363243592,6,10,383,630,247,44.806481417541086,1743
ce5c7a0a-66e3-48ca-93f2-01b4ce85bb3e,Commercial,0.4741719255140012,29,32,231,636,405,99.37046707619318,4950
72945605-6e10-4b0b-8844-fa448d33dfcd,Healthcare,0.8544842214792528,9,46,529,1271,742,70.88088625206171,8189
19a2f20b-a066-49f9-a4b9-60c1780084cb,Residental,0.31644118762653217,12,8,247,576,329,48.625000348414886,7823
a4cf0e46-96a4-4565-bf20-0ed6953b76d9,Residental,0.978476040321746,44,20,469,1128,659,61.806941114731316,6420
bb9aa021-b58b-4ca2-81f2-80e50862b9c9,Residental,0.5882874668367413,38,34,21,587,566,27.32389729463534,2045
d0019e10-4dd7-469e-bbff-f43eb3850e13,Healthcare,0.3450670305372239,15,8,536,1157,621,78.96896506138665,1331
46389020-1f54-4170-b1b5-a0ab98871e9a,Healthcare,0.1246699892320784,15,26,482,775,293,43.22109515685303,6931
9250924c-6ba7-4169-9144-81aa3e5e742c,Healthcare,0.7643272471608332,17,50,483,1372,889,75.0008926334609,6063
e3d00562-8f22-4438-affe-ccac7a1084d1,Residental,0.6976755130613236,11,32,443,447,4,65.86746954716449,3976
55c2a05f-822e-4cf0-9244-16c67c392253,Residental,0.356260122169927,12,33,546,653,107,80.75997283552556,8315
f88f2afb-471a-4b5d-9afd-85f6d78c4b22,Healthcare,0.4004733604726366,23,12,153,1117,964,14.866122815843468,9004
67d3d914-d0ad-40c0-85c4-e94544378550,Educational,0.6109999553662686,30,29,208,597,389,43.22705526450018,4770
3cf68d24-75eb-46cf-9d01-fcb242e979a9,Healthcare,0.11073397624000014,41,46,670,937,267,56.140778015168294,2357
465d162b-1103-4b4e-8c13-d5a9de9a9409,Residental,0.5991929016473264,47,17,397,613,216,77.15914213456291,8715
a702a494-b9a5-475e-9360-ecfa60644393,Healthcare,0.17075744856730146,30,18,143,1202,1059,29.73261631066905,4776
afa5ff75-db98-4f4e-8bf4-25faa227aad3,Educational,0.8788235354486781,3,3,662,1378,716,11.835715305030888,4015
67d90454-cbaa-4345-be1d-7094a2c65e59,Healthcare,0.9894459466670271,18,40,271,428,157,41.08030744830931,2530
058f0587-e214-4b41-8776-dd669edf417a,Educational,0.5072706614373175,26,10,348,715,367,39.19477622695588,3065
429ae485-74f9-4e52-943f-c69e484e7fd4,Healthcare,0.7286598882165385,9,29,365,826,461,28.334185455420116,2033
994c7b7b-50e9-4531-a605-64616084a8a3,Commercial,0.7229652224759097,23,11,583,817,234,10.988818489938303,3821
223109a0-5275-4ba1-ab66-78e20d635562,Commercial,0.2806886817298503,34,5,636,1163,527,24.94476564569745,5695
6267dad1-7d83-402b-baeb-64b6057ac2e6,Educational,0.24241783804485606,32,11,454,514,60,56.243488698347306,6127
f8684ab0-7dfa-4928-b764-16e8f254cfb0,Commercial,0.43655429697961157,9,28,501,850,349,47.32376483600628,3523
bf4e2c43-a37a-4192-be13-8ac94533eb97,Healthcare,0.8114805200576801,9,1,198,1227,1029,38.42427565416564,2217
e9f7f535-0b64-4b12-9ada-0738b7908c45,Residental,0.1839137288191689,8,5,401,442,41,13.167234896209159,4871
675047fa-e1bc-439f-bd59-5f6c94e3154d,Residental,0.6255438030298723,6,50,659,992,333,89.5145176400374,2607
40e70728-3e0e-4adc-ad67-ae696e12b7f4,Commercial,0.9830038334738301,13,49,467,1191,724,95.2832608229804,8715
fee3d351-9035-481b-aa27-a7fd1d9f4f5e,Commercial,0.3732875942881022,33,27,700,1109,409,51.380023177033976,1213
665172a5-d38f-4ea2-b8db-a2ee23cd3c32,Healthcare,0.5249439090889623,10,8,346,1195,849,45.455463605583,7155
e4c51063-d666-4f89-9e23-13fbd3e41333,Residental,0.832231761250949,34,43,11,422,411,45.183043365610025,2030
0e568b35-b8f0-4c42-97f1-6d525f8c7ff8,Educational,0.7357554458181425,20,14,355,820,465,15.04670031830658,6807
a9326d94-c44e-4c55-9039-54efed6a468d,Healthcare,0.8817201104516688,24,23,554,1123,569,11.071704934396818,7089
598dd84e-188b-435c-b33d-a0d93f7b1338,Educational,0.3820025066745685,11,19,41,428,387,44.63940143104972,1697
09aa4597-9155-4512-b258-c1655a404ccf,Commercial,0.6035383620796333,11,20,504,796,292,58.01260867027379,7436
60c2ecfb-53be-40c0-a12b-92cfd8336c64,Commercial,0.20521432746589086,23,34,359,1402,1043,16.64634645979238,5266
1ac48ca6-c902-48dc-8dc3-ecc8f274b4aa,Educational,0.6213579661566694,46,39,248,284,36,23.728644967060987,4661
3254aab5-fb0a-449c-b955-3a833acc039d,Healthcare,0.10607271512829608,14,27,381,1183,802,75.73884794536492,9907
02af9255-6f20-449f-8e2c-5dd91bd50c7d,Commercial,0.2098794185305881,32,15,33,213,180,73.8316079559037,1034
0a76b101-e066-420f-94dd-9b29e57493ef,Healthcare,0.6984443647138185,3,29,592,887,295,62.06920541075681,4203
7cf7b98f-6265-48c2-80fe-de754aaaed1f,Residental,0.2721870271838922,47,4,612,1426,814,29.74462088770332,5841
98c402dc-a94e-4174-bd7e-b91072becb60,Commercial,0.5268215436434307,8,36,79,122,43,52.86049812566561,9038
37571e8a-b2ec-4072-86b4-e325489641e9,Educational,0.3234212242354506,21,47,447,959,512,77.9656161786282,4274
5bd8d8ff-1bbf-4da6-baff-bc532057cb89,Residental,0.06954254762277068,49,15,87,987,900,76.38142068740547,8578
3032ad9d-51f0-4975-af43-29d56aa61ab0,Educational,0.27718928669119436,31,36,492,568,76,47.7506875579354,3097
1123fee1-bca2-4de4-810e-4609da77f61a,Healthcare,0.39062477272517915,39,35,244,379,135,52.613186221314976,4838
d0f84a2d-77a8-4eb9-a34b-5f7e51780ba0,Residental,0.9862924077361416,7,44,81,399,318,12.114510083834041,5795
94923e70-1f71-490e-a61f-66c9053d23c5,Educational,0.5139610873450996,19,1,56,358,302,40.793951162024804,7131
3dc4e258-e323-4ca1-ac99-0dabd9b4a9c4,Educational,0.871202650255521,12,30,687,1404,717,75.89460832816084,8152
f0d3085b-c1b7-461b-9a6a-3e50725913ef,Healthcare,0.0471172297747976,26,32,249,1192,943,76.13139698886947,4004
5083d1bd-acc6-4a72-ae8c-4a50b7f9ba39,Residental,0.5377925583975537,35,42,46,116,70,95.59150650708924,5951
b95f1496-3d30-47c6-92a2-72fed3f9346c,Commercial,0.20327862746683323,27,31,16,1416,1400,37.943103240775564,6936
c19392a9-65f1-46b0-9fac-9d9f9c2e05ef,Commercial,0.5988557719962124,21,35,513,555,42,81.79127649620786,4922
4c7a5bcb-2718-498e-8832-eef8f354a3df,Commercial,0.8451943396116527,38,23,560,1039,479,33.22176353866886,2218
63c20ab5-d065-451b-8ac0-68f59002c0f9,Residental,0.3481446291311012,2,17,443,490,47,74.98377099163133,4465
46bcc608-e68c-4330-9357-5dc59a6a52f2,Educational,0.8070126668817812,49,21,425,1159,734,15.385453657256598,3072
dcec7f92-6fa7-4a49-b699-ffdf36844625,Commercial,0.5598411614670338,24,36,484,686,202,95.49190945008843,8247
080bbb6f-246f-4a85-8cda-3aeb3f422faa,Healthcare,0.26493281148949055,12,45,670,1086,416,43.141036632442145,2724
296f437d-3f7b-4725-9788-c08df0b9ab52,Commercial,0.6292577006895467,48,40,19,136,117,85.49556768938135,2555
b8dfc583-c58c-47c5-9e48-cc34032d9c49,Educational,0.8626697970865024,47,32,488,761,273,22.25802883819423,6566
d95a94ec-f6d2-4c65-944c-bc59dc68e624,Residental,0.2286330265131905,2,30,274,963,689,31.13749973412083,2198
b6a918ea-c69b-4caa-a84a-d52875e26f4b,Healthcare,0.15758065443198965,21,11,517,694,177,11.250601408187157,1773
7745a1c9-a823-4f84-9599-6b3e2cb8af98,Educational,0.8451322064894302,45,9,174,1075,901,70.3378419847245,3946
e39096d5-88e5-46ff-8d4e-88618b777963,Educational,0.439199538183619,2,19,129,612,483,51.60576802885458,1982
56f90e5f-8f57-402f-852e-c86cba5b0acf,Commercial,0.7027410418898898,33,36,212,1204,992,98.85167330247012,3745
c23c1f17-355d-48b6-a28b-0929d9239873,Residental,0.8184565614508892,50,32,642,1046,404,85.51936919491217,4259
e5fe9e9a-8cbd-4d94-96dc-a20d8452037d,Residental,0.7963036127123889,30,16,430,525,95,22.675058445448286,7992
b4ef238e-5265-4a68-8ecf-8ad233406dd5,Healthcare,0.40475367512771065,12,24,201,451,250,58.09950744815512,4142
a4c83396-a74e-4f4f-9080-37b617195fca,Residental,0.37069432507829203,20,45,214,1005,791,91.7051281258864,3393
080d1700-c115-40ba-b8e3-9753c7ea2b69,Commercial,0.02761042993874885,15,9,108,654,546,31.818363156013458,4558
bddca4fd-d216-4334-ac67-4a7d217fa195,Healthcare,0.2515093220781832,27,22,703,1124,421,82.84728260953166,9363
79ed0f33-2978-4486-8080-475e85245921,Commercial,0.17988125658053222,36,1,235,1246,1011,22.993368654384994,2897
9cca766d-dc3e-483c-b353-a9283975405a,Healthcare,0.7958254147716236,32,30,520,1104,584,55.52242933446806,8782
d3d487cc-8957-4462-b3b6-70db7e9b50ed,Residental,0.7706870006342279,3,1,219,945,726,28.772059015595538,3488
bbefc37c-da59-411d-9145-477fe4bef7b4,Residental,0.34528323381431913,20,13,360,656,296,70.84145910828616,3187
165d6f69-4a26-4f97-b534-bd10186f3056,Commercial,0.7873014226897312,31,38,13,1361,1348,33.18971370469079,3481
724c8595-6843-41ea-968f-6175605beb17,Healthcare,0.6697577895218607,47,15,165,904,739,97.96356813794345,7785
6da4e76f-2797-44ca-8223-174da72443af,Healthcare,0.5484957564619368,37,36,181,478,297,86.100801367501,3756
b39176be-efc2-477e-b8ab-0c8e90b59b5d,Healthcare,0.3699992435452143,46,8,258,1190,932,90.71012316545114,1441
6664ea16-2755-4831-9ac3-f345e532b364,Residental,0.5227028726709653,49,37,177,861,684,13.592807881126367,9638
f0385c5d-ad35-4e46-8114-98cb7fcfec7d,Commercial,0.8138551933804987,21,18,335,1329,994,62.64165048721571,9515
b2dac2b9-4be8-4dbc-a995-2f9659d7fbaf,Commercial,0.8285666454227679,12,13,331,1314,983,31.246761239001913,4068
fc9f78bf-8bfb-46c8-ad05-4b36335d8ff6,Commercial,0.559149631241359,31,12,44,467,423,73.08493636540888,9231
1e6cde73-e7fb-4c9e-a124-2c9b34ec17ce,Residental,0.1823586211838938,41,8,79,294,215,77.24842492408204,3418
ad9e767d-e38a-4860-9302-b4ce2e2a5ade,Commercial,0.5317750035374491,33,6,219,477,258,74.55556340715204,5942
1e0ed501-bb63-482d-8862-a0a163ed1032,Educational,0.07948325222620078,11,37,197,214,17,92.1650105133664,3571
bd263ee0-25b4-44a0-ad5e-583ffb509bf7,Healthcare,0.17983623994193,42,30,403,680,277,91.90815592402231,6311
c6366404-4742-4fa2-9c23-575abf8fff26,Healthcare,0.5684912942036996,7,28,461,939,478,88.86949096641005,5437
ee47501b-8908-4aa0-9cae-ffbbbd1139f5,Residental,0.08860474829335196,26,18,185,385,200,39.32525228626874,3241
0515d39b-5423-4abb-8cdc-aa15b741988e,Commercial,0.2996397641355687,46,47,408,879,471,44.94759262500253,3990
97493418-7df5-4252-bf9e-0f907817256b,Healthcare,0.2711093433492846,9,15,304,1360,1056,16.278351047590398,3982
24a63bca-912f-4b86-b07c-bbf4051dc2e8,Commercial,0.8046645521428551,44,44,126,213,87,84.73288574237114,3520
6cf52d24-37a8-490c-9a72-7c8747c2f843,Educational,0.3407213274942027,48,31,715,1021,306,45.333605667492975,7567
c16e5762-9d07-4f82-b297-3e3daa7c909d,Educational,0.10682245506598165,35,16,243,1260,1017,85.6120415809948,8420
41d87282-deda-4c3e-95f6-e591b14ad802,Residental,0.712289888498254,11,14,77,1249,1172,51.8767048287439,6308
eef60fd5-0f0d-4837-9830-59ae4be6a918,Educational,0.968627850407489,43,48,195,683,488,63.40333880938154,1281
5ab6fb72-d583-4c1d-b17b-9a061b44d81b,Healthcare,0.8948612660355625,22,14,93,1242,1149,78.67669454024315,5605
bd76206f-f87a-4644-8325-430cf197e9fd,Healthcare,0.2472543552396531,27,50,418,1319,901,39.87702835606659,2488
eea6d871-57a1-475e-87f3-153c93c4835d,Educational,0.06664952893773057,33,32,562,990,428,74.94426114056631,9236
259f392c-141f-4978-97f8-8d0110ff741a,Healthcare,0.7137344814824833,28,6,127,968,841,75.45061937585648,2028
fe7717bb-c6d0-49df-bca0-63d643c2513b,Healthcare,0.7861396210019834,27,11,171,1406,1235,11.18446364758207,5633
cd19c9af-88c0-4797-ad89-1bd66e83dc82,Commercial,0.45382763902115875,43,38,210,1109,899,42.615937445613184,7211
03617435-f6bf-4719-b105-3577eea45422,Educational,0.23644998234112236,48,44,297,1093,796,50.72831562645221,8497
52ae4f0e-d1e7-4e77-817e-95cab2d6b0eb,Healthcare,0.9499532065154533,6,25,591,1171,580,52.59982504451514,9667
b962c996-f5ec-433b-8fa0-dd71c9d29a54,Commercial,0.9689267390459579,15,12,487,1237,750,81.60517781651608,6586
f4dd4349-9817-4425-9131-11a950e84bd5,Educational,0.49008590289848086,28,21,492,787,295,83.43460716915222,1373
614013c9-8314-4f24-ab01-13167087ab47,Healthcare,0.39239494427784494,28,7,706,764,58,17.79511239425512,7612
3c31dc09-492d-467f-89fb-b89c9db683f3,Commercial,0.7268349672238199,34,38,681,714,33,25.937044196651698,6669
ec18bb6f-6a65-4c3c-816f-761bc0c36bcd,Healthcare,0.030123080496649468,38,16,89,581,492,92.33744134318728,5339
13b2a802-0f59-48ec-8d66-dcc41c9fc0a9,Educational,0.9512789038477765,11,17,493,1362,869,39.045706903438585,8332
0ac14336-9b76-42d2-aa81-393e9fe4f27b,Healthcare,0.8996368415758824,32,9,673,774,101,17.05780269342294,5865
88668de8-986b-463d-a937-f6c7f6b3d57f,Educational,0.0014019461681091805,3,18,673,1409,736,60.337414479620534,7793
90226b73-119f-4c72-8a78-c1106b1bec1b,Commercial,0.13323062679760456,44,50,269,420,151,58.598750504125995,1119
0569bfb0-21eb-4faa-b592-86683830f506,Commercial,0.9887119908223263,48,29,82,1153,1071,98.21328615787311,3737
880ba739-096b-4520-a4f5-3eaee5123643,Commercial,0.14186209099279068,19,4,556,893,337,93.76416884950723,3540
6734bb43-04fb-471f-aaee-05cfd159e237,Healthcare,0.023317499635813865,17,25,33,1045,1012,77.791016744372,8692
b0c3c64b-a07c-4e22-9cb2-fd77430699ab,Commercial,0.6549600163413662,30,31,325,1233,908,87.55912426185228,4759
ea47fd42-fe16-4aae-96d6-9281da04318f,Healthcare,0.4938699588062976,43,22,220,1028,808,13.571860505376657,2034
3e25cc00-1323-478d-b699-72d002eb4919,Healthcare,0.6581200717544067,39,22,646,697,51,41.46384988233888,2672
438fbd93-8264-48d5-9f83-975f9db2ca34,Educational,0.14288429185599238,15,29,657,1023,366,70.68462226520546,6202
3859241c-7d73-4736-8bc2-82dcd31cb536,Healthcare,0.051417995862534815,3,16,288,1291,1003,51.93089731445035,2907
1e2f1aaa-764f-4b31-b6c0-9c340df00f0c,Healthcare,0.1636211250842815,4,3,652,1188,536,20.922864901227875,8902
7651a91a-0996-429b-b135-63a2743eaf0e,Educational,0.0945117971463375,26,25,592,794,202,48.91590755681556,7397
e1ff746e-db89-48fc-95a1-e5cd9bbd1db1,Residental,0.3440737276018586,44,1,47,596,549,62.1140216552963,6268
08a15c66-86aa-40ca-8ec5-afbcff77807a,Educational,0.024231492361929785,35,28,110,400,290,86.51305209977852,2607
786ec2fe-e7f2-44bd-b4b0-918816a02027,Healthcare,0.05716894685962748,9,33,259,1072,813,76.26141845389515,2898
d2dce1fb-edea-4696-a251-d6bb7de87e07,Educational,0.3761528149967368,19,40,578,1150,572,87.04058160893463,1130
1711a151-b80a-4f7e-b8e8-b877b0c1353e,Healthcare,0.2847073611874398,20,38,546,587,41,66.6124191172672,7177
9889b5a7-1b35-44e9-9f8f-ba6385f13e2e,Healthcare,0.09763154768575966,35,1,139,934,795,64.65997506584375,1372
a3283f1c-d9bd-4ded-b6ba-230295beea2d,Residental,0.139893011350112,12,33,592,1439,847,40.51586706216247,7635
4b9ed14d-e3d1-4360-81b6-a07526fb9ee6,Residental,0.7327672923176051,10,25,356,1413,1057,46.7100937786007,5265
81fd7559-046f-4bd2-8e28-73038068210e,Commercial,0.41104601176708977,45,7,572,758,186,15.088474068710587,8646
469f2fbb-6292-476d-a5af-80405e1c65e9,Residental,0.1545439354358109,26,13,413,1040,627,36.88737659087496,6027
c2e4c250-a7bc-49db-8750-aa7f6f8e749e,Commercial,0.4137381412701212,21,35,196,783,587,17.34657260093402,9400
b95c77df-be64-4878-8983-8fcfb2f6f2d3,Educational,0.9090843711600789,16,8,677,1116,439,92.28004104770899,8965
f7214350-85a7-4125-ab8d-6b1e36e7c123,Residental,0.2178872809326412,19,44,215,473,258,57.4774084995313,8874
c31cc74e-238f-4d23-9dcb-5c8915e511fa,Healthcare,0.43423799997630286,44,35,558,772,214,63.780433605483104,1908
62508dfb-eed8-436f-9024-6acf682215a8,Educational,0.04865510407118512,41,4,592,1311,719,34.423301715678136,6763
c51bcee5-566b-4dcc-9597-a99ddff66ac5,Residental,0.2605143768461595,36,10,62,152,90,77.78585698154119,3840
fe1407aa-7496-4388-a383-6f93f45e3ba2,Healthcare,0.8820640975678848,48,30,398,845,447,45.67908741741757,3901
1866c365-2171-4f32-904a-48d09527a685,Residental,0.022133614857725803,1,29,367,667,300,23.980713826729257,4583
fcbf2b15-672b-4f03-9fbb-5e2116bd8e51,Commercial,0.25413334120485553,42,34,549,592,43,92.61083421789306,1270
38184cce-951d-436d-b414-f1fd139d452d,Educational,0.2845992650265998,44,42,503,1310,807,86.06811298777608,6121
f97cff13-6793-449e-9b85-ad166ad1e7ac,Healthcare,0.6563165336461158,6,29,420,1215,795,22.40182521510154,8410
bdbc8b55-4842-49cf-bc49-7eb1d81c845a,Healthcare,0.9517710651632182,29,37,712,816,104,30.518041234978618,4082
051ca32c-68ba-4184-9547-64963e691697,Residental,0.6370010503490583,36,15,73,135,62,77.97108632315134,5614
446b756e-9b26-43f8-beec-a5d2458056e7,Commercial,0.6446988077201204,27,32,686,1136,450,11.673583875299657,3678
1c5e5650-5937-48e6-8df8-6c6418d1774d,Residental,0.1610620719794016,14,25,131,897,766,39.34191847128812,7271
da1bb2a8-5cb8-4bac-85a4-eb470214a771,Commercial,0.584196230239981,3,36,324,1221,897,85.71640420586094,6954
df1af947-863b-4216-a952-53d8e1ea04b9,Healthcare,0.4298100291384561,27,23,95,1186,1091,85.9655586627014,3637
c60daed4-2cb8-435a-8347-51cc631c632f,Residental,0.39274281037615866,44,46,345,512,167,75.47353344368426,4561
582db1eb-da23-41da-9f7c-8b1cf0c2854f,Commercial,0.41802035683104266,13,38,693,1297,604,74.76788391620497,5870
5c919742-718c-4fea-ac7f-e322df953530,Healthcare,0.8599593008004263,47,34,634,1326,692,53.94840308512006,2901
114e6cd0-27b1-4073-a40d-66d28e71e35b,Residental,0.41377313224637313,21,24,685,1267,582,68.82950387669814,1976
c5520c2d-e995-4f74-a449-df4159db75d3,Residental,0.15167201483302262,12,43,707,872,165,60.6559416645309,2238
c7afe6e5-aa19-4920-a7d1-94f22121eae6,Educational,0.14578923484796869,39,6,347,1205,858,59.316934966614944,8695
4a38b7f9-00d9-4f81-b688-149395f99ff7,Residental,0.8151513899796845,5,47,207,1416,1209,97.99755395677644,5623
ff05004d-17ad-41da-a53e-ee4d44d98e96,Residental,0.22848285370170707,11,19,551,1087,536,89.31908307261831,3287
a67957ee-88b2-4690-b472-ddd3f4ab0f6b,Residental,0.12116620216915408,48,15,623,648,25,61.07146441490246,1873
b1e0c9ba-a87b-4e76-af07-3bf9d5622e7e,Residental,0.7887338861892774,39,44,571,1258,687,75.26401407596838,3250
6ff2eff3-2c4b-4851-971d-897e42b0c197,Healthcare,0.8753376121243505,14,4,319,755,436,78.21327091141582,2850
9fe83583-0d5a-467f-92bc-c91d00f464c6,Healthcare,0.4248513958540129,44,42,183,1032,849,48.64062475921475,7234
dc2fce1f-ff8b-44d3-b276-86898e7c86c8,Commercial,0.8020600650589563,22,32,71,1085,1014,37.799384394430874,4374
d88fec61-a86e-4f40-ae69-d43de98bc0d3,Healthcare,0.6259046502226487,4,8,458,808,350,17.48980049942152,8313
a4908404-115a-489b-8b9e-8a42d925eb29,Commercial,0.6074316721857834,17,15,177,1083,906,33.98572351272769,7144
5bc6652f-35f5-48e1-a2ac-72ff5a8fbd66,Educational,0.026214414796167373,39,15,50,924,874,37.25939756563756,5324
0a8674f0-9fc6-457e-abaf-da9e71a45a03,Commercial,0.3805842767830997,10,35,558,1403,845,81.00879593676021,6089
7b4cf10e-f050-4716-883f-71880322834d,Healthcare,0.8879700204616146,41,19,657,1399,742,27.754163253673283,3836
3cdbf75e-aa0a-4001-bcac-54c4b9a8d062,Healthcare,0.8058276500615871,16,38,433,1428,995,19.707134370919395,3329
84528040-24cb-48e3-a47a-e77964b8bd59,Commercial,0.8500824893440693,39,4,577,599,22,92.60035298679071,8704
bd31f100-ed73-4acc-94f7-8aef2e9c9c7b,Educational,0.47571026678167194,38,10,361,871,510,71.38489307160518,4860
4ab8d0c0-1e7d-488b-adcc-0ac032ff9405,Residental,0.6287026904367274,13,17,294,377,83,10.78373400155478,3263
19e52660-3419-4515-98d6-c9f99444bb8d,Healthcare,0.8439273840828527,10,37,99,607,508,30.452288965716736,4366
484b8bc2-1af7-43cd-af36-c8a328653fcd,Residental,0.49957451261984787,38,37,239,1339,1100,16.54647642868961,6338
c1790724-2967-47ff-bf88-17be4d129e2d,Commercial,0.6155928227841797,24,45,455,1162,707,42.801469454211954,1444
f826572c-d54c-408d-9f07-ffe54c3146a9,Commercial,0.0002482853887897374,26,18,528,1419,891,92.19843368095415,7839
03466ed4-2627-43d4-aac8-9e5d87213c20,Educational,0.6527213546292403,11,33,256,1023,767,60.425438341934345,5333
0bc45e5e-57e9-4245-a868-19b6922a7385,Healthcare,0.2214519078039099,47,28,647,1158,511,12.828280052044377,5889
c826824d-a203-4962-9461-8081022f28cf,Educational,0.03507858650720497,41,27,211,1328,1117,57.44990803902868,6149
2ca81998-2ec7-4a64-b25c-858493576507,Residental,0.025629996135415944,30,6,19,832,813,99.35500995203749,7391
87ee17af-61c3-4b49-b610-430005f46161,Healthcare,0.09674706089804108,49,48,269,275,6,85.76426387467723,7063
e83926e4-6238-4ca0-8078-e32f5575c0bb,Residental,0.2529415612417083,48,30,466,1440,974,95.72337800244425,8433
83ebdc68-28ba-41fa-b69d-bb67d6319f6c,Residental,0.45559134959942427,6,9,184,1396,1212,39.10282598561794,7560
64ac1c2e-f372-461f-80b7-26536819a07c,Educational,0.5005230659439753,5,2,659,1317,658,22.226240643760136,8845
77d7b7c6-e9be-4f42-9dca-b57adf98fe7d,Educational,0.7247824575307292,9,19,157,756,599,20.12959831594355,6672
7f4e5ef5-c628-4319-94bb-aa252829e6d6,Commercial,0.06422461693228232,7,43,460,1332,872,59.314377149867994,3482
bddc3ddd-8a8a-49fa-867d-8e4c70e554c3,Healthcare,0.4042383338879898,3,18,115,1210,1095,35.3928155384894,4875
be0ca750-c50c-4421-af54-6ecceba0423e,Commercial,0.8319415492992043,5,7,624,809,185,18.300047385073633,5581
e776d1ae-c79d-4c79-8965-12feebf921bc,Commercial,0.7141398234176037,48,6,578,608,30,21.975645586485662,2254
c8505053-d856-4fb6-beb3-d68a8ad26e9a,Educational,0.7935905337686349,17,34,554,634,80,61.12112387906069,2809
0bf92fb4-52e0-4985-b017-053093d33052,Commercial,0.3420914507344083,36,12,7,1021,1014,78.66866378774391,7553
f8ba3838-c1c5-47a8-af7e-cdbb1d6d7ed9,Commercial,0.24060077938199842,5,23,413,438,25,31.297050696210373,9936
45dc19be-b9d4-420c-b7a4-10a6923ef94c,Residental,0.9130695111715615,35,33,185,760,575,29.454166295895664,8969
c5befcab-0128-4444-838f-9f2685ceb19e,Commercial,0.7273623735581105,4,4,225,871,646,16.935506410362592,6515
e9076b9a-d1f7-4f71-9df4-b8b0b1340b05,Residental,0.9052578528757197,20,21,206,672,466,38.3225976132873,8017
f4d29ca3-ad40-44f7-aaa1-fee46eac648b,Educational,0.2670944849345218,20,15,33,966,933,18.812311628645112,3331
c176e2a5-755c-4272-8020-f420408a4ad4,Educational,0.8392903072437847,46,3,280,341,61,92.93805925589724,2292
09fa8cd8-caef-4b5b-9d10-e8b1555312ba,Residental,0.5579565686308336,20,26,115,1341,1226,58.63113662706313,2297
e75c1e1f-b5ed-4a31-9921-d8b7e5a6c737,Educational,0.7536106948529306,13,3,583,1182,599,76.37442211498467,9666
43186a0a-d8ed-4ee5-83b7-fd420efae203,Residental,0.5394487139553553,26,48,225,1382,1157,67.340106714467,1740
4a64bfb9-52f9-4471-ba8f-06aa8bc2ab44,Educational,0.3905082828856753,11,42,382,1031,649,32.410949138953534,7816
fb2dd38e-721f-4176-b52a-3e3a45675827,Residental,0.4259525406788075,35,34,578,1361,783,65.7227171415972,5946
7b6b4e56-4267-4f9c-b612-23c5141f4320,Healthcare,0.6425542633024447,3,13,174,1013,839,64.65212345887966,6892
3d276bdb-5c70-45fb-9a5f-6e4acb9cd2b0,Commercial,0.3219239335862497,10,8,101,721,620,52.85670187890975,3280
6e95751c-f694-4a8e-a010-6bd7f7cf4534,Educational,0.3076214336898938,14,43,610,722,112,41.30698267762534,6496
b8d1e0b5-58f7-4539-a102-74731c1e90b3,Residental,0.5805499198747657,18,36,146,594,448,58.22320275494546,2154
80737008-48a0-48a0-becc-f11a7d83c941,Residental,0.0638969534166286,25,38,704,811,107,52.841692486631075,7805
30350bad-53b8-4311-8ad9-b78ad5988e4a,Commercial,0.3889310588861422,21,11,709,894,185,63.63614430304273,3492
be44977b-b3e5-42c7-87bf-02e12d4c31d9,Healthcare,0.2475178590717506,17,2,3,698,695,71.52856147185801,1409
5b67f89f-2d22-4737-a3ba-719e8481eccb,Educational,0.8619511069763518,18,2,117,712,595,38.40487086632791,2888
3735091c-c05d-4636-8284-a52da53f40dd,Healthcare,0.5149239322758683,48,13,83,316,233,35.679395006841,2560
3962a929-3ebc-497b-b2a3-f0fe28142f1e,Healthcare,0.9147296177097302,21,30,25,497,472,99.28938880690892,3930
d7997a3f-90e6-40a9-b654-f1deaed2c0f6,Educational,0.7106106873740311,45,49,627,1293,666,30.501143443482786,2278
4fc8e636-1e2b-4019-8248-692c7eabb294,Commercial,0.26143931889728567,33,2,443,1245,802,90.21396256899456,7803
0cdf4413-2a36-4c07-952b-52088c4cc810,Residental,0.40130578294755115,26,18,278,449,171,61.307353958006615,6789
c82566fd-d6a3-4dda-a1a2-a0f550284022,Commercial,0.5384932665903482,29,14,653,917,264,56.3053248821941,3448
d3498bac-f84d-4ea9-b7f0-dce2c85085ad,Residental,0.4460119278629826,39,37,511,813,302,85.68868453827868,7880
48e54853-0834-43cb-9cd9-ff58e6edb68d,Educational,0.36688739697536665,27,19,111,1002,891,57.990665761260246,8078
680aa5aa-ef88-4afa-a347-9fd5be4b265d,Educational,0.10807172787905339,1,27,175,295,120,44.366422129774044,2141
bba1f902-9e00-422d-8ad1-f00314ad5988,Healthcare,0.4816731988672769,6,15,296,639,343,38.42561079741036,8039
8c44e7c4-e039-43d0-8c27-b6dacf7d9890,Healthcare,0.3362322101626185,5,16,190,496,306,34.11573270789275,6755
e9e6725c-58ca-481a-b3e6-2d2030a06a43,Educational,0.34728387314660036,22,34,390,1423,1033,77.64814345874419,7514
213554e9-5d05-4b93-b839-3c3f3e7a034d,Commercial,0.6018414542542192,45,49,376,906,530,42.85177692339253,7960
963f6c3b-ecac-48a2-b2a7-34508219059f,Healthcare,0.10873975979332429,40,43,207,1104,897,33.034833402440114,6755
5851d819-e352-4f79-91e9-3aa227664e55,Residental,0.5906619547374572,1,42,157,526,369,15.60043258240881,1135
94eb3753-9ea8-427a-a1fd-d82d76787fa9,Residental,0.4489382935555204,13,1,614,1315,701,78.52150672563116,3408
2265a130-1724-4067-8157-7dca23f6d5c4,Educational,0.564812744502299,39,28,401,1017,616,58.03521085918187,5457
44efd433-945a-43df-b4b8-fa9d04abfd29,Educational,0.053066911372603554,20,36,56,812,756,48.30952526212172,9144
9b78b83b-1633-4592-93cc-68bb8e24cf1e,Educational,0.5816098065633284,24,28,68,892,824,41.85256480521949,1828
6f5a16e5-a264-40f6-8997-ea082fc2edce,Healthcare,0.444157426400244,38,45,570,934,364,25.759820255850606,1936
0b084775-97b2-4e78-b659-29b4032d8365,Healthcare,0.41649651541103105,30,47,267,883,616,28.485406491552244,2913
15603940-b219-4f0d-ab85-ceb40286debf,Residental,0.06428744164235844,22,14,534,1369,835,50.859788130711465,1654
848d1652-9c5a-4649-802e-9da3dc203540,Commercial,0.7844902733333555,44,43,471,921,450,46.56495498958455,1914
aa6330d1-e398-4c5e-b1e9-e363187ac50a,Educational,0.5379849483383183,7,32,556,1144,588,99.72050250341077,9683
f24b07ae-d779-4420-9a07-c1f433927cd3,Educational,0.5329792067821567,27,26,26,438,412,21.419707997098108,5823
de0617e5-2596-4f8b-b77d-e797ff77f4a3,Educational,0.42279570680271084,6,44,561,691,130,87.58384337429592,9972
ab46a41a-4e81-4255-91f8-41f121a961af,Educational,0.5906193611587295,16,12,364,490,126,76.45863087583835,7114
082aaf63-1790-42f7-a20a-693a40109c6a,Healthcare,0.290262777423964,6,33,288,893,605,39.38751395408926,1604
b6a9dabc-6fc6-4b36-8056-b4cf86518b84,Educational,0.08546685164383372,31,12,104,1072,968,29.936588573790175,1213
394e5f90-f5f5-4e6d-829b-7b25302eb15e,Residental,0.0557482752650964,48,6,408,1387,979,67.25630536631493,5672
5f5081dc-47c4-4839-a23f-ad177b72c3ba,Commercial,0.5795439848804924,46,8,498,1352,854,31.530660187487598,1434
9014f6cb-e278-4e77-8658-484ca56a8fee,Residental,0.42584950264316423,8,7,248,283,35,93.71381867171502,4230
9a5012cc-d0e7-4cfd-bf4f-18328297fa15,Commercial,0.4385514032163066,15,17,231,378,147,13.349285854983881,9638
a0256b8a-378c-4dbf-b5b5-832297a4eb19,Educational,0.21258118872684617,9,18,403,1295,892,37.787354902092204,7566
fdcd50f2-6ed5-48e7-b09d-24410999c065,Residental,0.7495961735157539,49,39,157,425,268,60.165051034405565,3138
1e676142-0ed0-4fe0-98f7-fdc977c70a4f,Healthcare,0.8395903791982422,37,27,594,1377,783,55.56110865088411,5664
3b8c8b1a-5aa5-423b-a37a-afa3a8f6f004,Commercial,0.43106242399454364,9,35,558,746,188,31.556440351940292,8026
c035b74b-1fc6-4abe-9027-c2ba601dea0e,Educational,0.6272044392019716,41,26,555,986,431,24.701617809836215,1960
cac67c90-9027-4e1e-82ab-6580b4bc552a,Residental,0.9575259782405071,45,18,319,1216,897,77.40691265389945,4106
7577ceb3-64a9-490a-acec-83ab99e746b6,Educational,0.33804697108956305,34,10,607,675,68,72.26139311056248,1199
35edc245-9162-4116-a874-117af8878ce6,Healthcare,0.2409808353823667,40,37,212,247,35,23.094560787850536,4807
dc09d313-aa4b-4882-b374-2886536d3312,Educational,0.5956881104546106,13,5,636,656,20,37.18592356048241,2542
affc12dc-2a6b-49c0-b1e8-dc47e5bbf208,Educational,0.011066172339618707,49,44,64,523,459,11.592277999961558,8902
431a1adf-173f-41bc-8dc9-63693334eea7,Educational,0.6904736396819999,19,26,66,983,917,97.78665938237518,6158
a0b2b450-e717-4925-9a26-cb1aa426aaac,Residental,0.20884202766959303,8,14,633,1231,598,74.89320764575649,8323
20b1da13-3494-486c-8bab-f499df8f7090,Healthcare,0.5851436343695562,18,8,235,333,98,46.086194219220104,5012
d0d5a4ea-0c22-4b38-b9f5-a19baa35735e,Residental,0.24590016289897243,26,25,484,740,256,27.041272625538603,4463
342e20be-a437-4def-a821-3862cfffbab2,Commercial,0.015191727116488307,11,7,94,1425,1331,77.52365350433548,9242
08d70520-1edb-4ced-9f26-12a6c5935971,Residental,0.6249273075544255,48,18,395,547,152,13.659681516594778,5835
fc63754e-837c-4159-af7b-3738ed466bd2,Commercial,0.9795487834126931,40,33,39,96,57,65.79273183343214,3442
24b8e8f9-b868-4df3-be0a-79587d56acca,Residental,0.5377227895088544,28,9,6,863,857,15.403186111529292,5762
bba113ee-7a39-48b0-b7b9-a8fabaa77b4f,Healthcare,0.1330380991525406,37,20,608,1299,691,98.38515860295794,5970
e0e36c00-74d6-4efc-aa7d-aa5e3db29637,Residental,0.3288404640917454,3,30,284,617,333,51.534738557871975,9854
ff0495aa-70ef-4a78-bee4-b1926620cd7a,Residental,0.19910770220947638,42,4,263,1261,998,63.79364652211907,7850
8a38c749-332d-41cc-9bb4-fc511843f6fd,Educational,0.3249405834804746,32,29,106,362,256,80.8666919440627,1220
92faec7d-3a1a-4dac-aca1-085489ad74dc,Commercial,0.8337960834135257,6,9,41,380,339,71.68227573538775,4470
384b96b9-09fa-464c-ae44-83ac47e6b580,Residental,0.5845093764476409,13,31,700,859,159,10.20446383604521,9508
2adc7877-0ad4-4039-8d57-408d07f8d9fe,Educational,0.5972624119556427,30,36,164,996,832,46.22727371461815,8088
cfaa1baf-2765-4115-b796-473a8d08913e,Healthcare,0.0560974195196996,37,49,387,1194,807,27.580880783578493,5555
23b05275-a91e-4370-87ea-0a3121e4afd8,Commercial,0.02861934889997908,4,21,317,1245,928,97.2471451063342,2513
015c5125-f82f-4b22-a25a-bf8971953736,Commercial,0.6799907040500929,1,6,410,1387,977,85.60936819535576,3339
a70ba4dd-be76-44e2-9c0f-662d649e0104,Commercial,0.7068125142318643,45,7,108,1422,1314,29.291621230836604,1351
422613b6-b798-48fb-b50f-d3e55c7813c8,Commercial,0.5560400343918362,24,24,463,820,357,83.32236805072294,4560
9979127d-0935-4ee5-8048-ec5dbdfab51a,Residental,0.8270836499957427,26,16,611,1402,791,43.1534048578194,6117
419f3d71-9372-42c4-bc6a-d4c8c3e37f17,Healthcare,0.12676903615899038,2,33,692,1167,475,51.95666131751588,4550
7613beef-2f77-4c65-acf6-b6c77b3681b1,Healthcare,0.8661628348024819,27,20,21,915,894,48.515608764194795,6627
ae4756c2-c794-4ff2-9fb3-5f049fea24f9,Commercial,0.3594876726136047,22,47,318,957,639,49.39758476231847,8049
63c9a32e-315e-43ef-a94f-c4396f2e218b,Residental,0.2118632681990884,47,16,449,537,88,30.064900130811274,6271
1ed4d787-40a9-4a2c-98ba-e10ae0e029fa,Educational,0.4147475868745143,40,41,557,967,410,84.72142622283091,1450
cb1e5da4-edee-43f9-8a3f-0932f5ccf2e8,Commercial,0.37221074492452766,12,23,189,1118,929,71.95446904213365,6688
51305639-f0f2-4fd4-969b-d044e5fd39d5,Educational,0.5108034114715958,45,47,690,1354,664,43.09643641661856,5016
4b09238f-0ace-4814-8936-6a9ea479bd8b,Commercial,0.6963829716686685,47,26,638,892,254,95.24898540636059,2039
71b96121-d26a-4c96-8396-6f3fd131123d,Educational,0.8748649785797754,23,30,479,623,144,55.25840257707291,5580
9b8ac338-8c26-4481-8788-bc98f8c5b27e,Commercial,0.05103839917405828,47,48,323,647,324,66.86789130679539,2550
d0ac79ee-f60b-4e0a-bc2c-658ca4469e94,Residental,0.47575217019433413,12,16,453,1088,635,68.29318277663002,9203
9f1d65b1-0d90-4018-9400-a7b0883fc56c,Commercial,0.4145497154107106,48,3,39,429,390,79.5829326915886,1272
7421c4fb-db02-4a01-915d-17b2bdfc5f9c,Residental,0.3667869454979822,38,17,369,1071,702,19.020526445650223,5686
7921f0b6-63de-4ef9-9888-53abc6031358,Commercial,0.44412992924245753,18,37,44,1226,1182,53.31692256971551,1790
283d9b88-0a70-4f8f-9ba6-9ee691d9103f,Educational,0.01436921312843742,10,17,640,1251,611,30.568214238600603,8453
6bbce659-f2d7-49e2-910e-bd01a45a2467,Educational,0.502149737944294,24,29,566,656,90,67.57331677180841,7321
a3ed2bc2-eb97-4dc2-8e22-8ded28f89b61,Commercial,0.09626452755028314,13,3,476,672,196,15.252617815439182,1105
2edd00bb-48e2-4c6b-a490-b6af490f42d8,Residental,0.25164322555303975,33,10,206,1015,809,72.40573445842159,5689
4d140fe9-16e1-48b2-aaa2-8c78f4e378b8,Healthcare,0.6807721435971105,49,25,158,637,479,62.390296392792614,2744
5f352634-981e-4a08-9871-ab70eeb68085,Educational,0.9607236448480259,45,48,59,1127,1068,50.47538601798172,2530
99423994-7aef-45db-8fc7-58dfbfa03731,Residental,0.4856907904676757,33,26,11,894,883,85.43055940680917,7731
542410ee-caff-482a-a321-2bd377dc885f,Commercial,0.8973284063268863,43,11,210,1132,922,31.518412060509107,2352
91f795cf-6855-46b5-90a8-3bec684a2ba1,Commercial,0.6582930852324373,40,15,537,979,442,92.9307255814672,5489
40a9d9af-12b4-4d26-92c0-94e416b5baca,Healthcare,0.18900648482878368,24,48,31,567,536,11.928253799875128,4863
c4de9f67-66f7-4d82-adb7-56f2269d820a,Healthcare,0.16260230283125865,29,26,683,970,287,16.631701682494494,4685
f2babd9f-f02c-4bb4-9fd4-f55a334a03c2,Commercial,0.23881995801306666,29,16,520,708,188,97.17049981371679,5841
2b087dca-5d64-4f76-855c-f758d0e3454c,Healthcare,0.7858377856687054,18,33,295,1374,1079,33.976022366757654,4222
d53df20e-2ba0-4fcf-9e8e-9f312f1f662b,Healthcare,0.6562167686519824,13,38,52,425,373,74.20888312349592,5678
5280db58-1b36-4476-9f0e-226594164c22,Educational,0.49412391959738744,20,26,304,1054,750,21.654606902681657,9875
fc4ef639-0698-409a-bfab-b325e0ad43fb,Residental,0.45555471963064953,42,10,174,940,766,33.65747231519954,5511
95433a2f-7f2e-4012-87ba-c8e45d8e262c,Residental,0.9833994380089253,2,34,7,55,48,10.077737107288812,4628
9c4d2176-f211-4c8c-8144-b6288559cb89,Educational,0.020900758808477415,1,3,158,438,280,74.7466458675765,6911
02a6093c-bbd8-4f26-aec0-d68a39d70432,Healthcare,0.020257413513407818,11,21,653,1230,577,39.2231746667185,5924
4faeeb75-23be-4a66-9b26-1f1f1e150b00,Commercial,0.5532738894178608,45,33,412,719,307,39.05113561856177,9473
ffbe09b2-1dc7-4fdb-8aea-9a9cc69534d4,Residental,0.56163552996121,8,32,511,567,56,25.291908149901197,6679
95282b98-54f4-40f1-abf6-36cc5800172d,Commercial,0.966087443220064,4,45,391,700,309,23.193941105016815,7776
2bcf22c0-081e-42e3-b62c-37cef2ef1527,Commercial,0.8197229375658868,14,30,177,1016,839,19.231603879406663,5265
2b854a38-49e7-4f1d-98b2-0869c3f79df2,Commercial,0.20552168689604033,44,43,214,1404,1190,34.277902257234715,9343
ff282ab7-28fb-43ad-98ca-944a0ed95371,Commercial,0.0913056718337022,20,50,167,167,0,80.79482500457273,1177
19b4e4e8-67f4-4cc0-b0c1-f7a1cf9bd105,Residental,0.2977755656342248,5,10,602,673,71,66.18429427169366,6544
c68f0f24-5154-407f-a1db-71c6869da44e,Residental,0.7149875395379532,20,37,72,1315,1243,34.10221741588616,9459
691ea9a1-357c-4f18-b73b-7f8fa7efd441,Healthcare,0.3180785122544535,25,41,35,963,928,27.847312973707684,9095
0b4c3cf9-135f-4fd1-b22c-3728a60e7bd5,Healthcare,0.3764672170203085,13,43,150,1057,907,33.99604040370306,9368
203d978b-d7c4-42ba-a3cd-21300330ed80,Residental,0.7882697364066228,13,1,159,1217,1058,28.039114782280393,7164
2e9db245-3a70-407c-89a8-59fb37473710,Residental,0.9295488848487183,10,5,357,838,481,81.33697953788865,4774
22fcac18-ab72-40c0-aecb-e0454be4ee24,Educational,0.14498480123309154,24,31,201,574,373,14.477611993844265,2502
9607236f-2121-49de-8578-16f9c044c16d,Healthcare,0.23824192530433863,2,34,308,1338,1030,12.015072008973705,3314
9c85ada1-e42a-4e50-8e7c-7f6e1b113574,Commercial,0.388109568397912,31,46,447,495,48,59.047115459466305,7540
bdccf6bd-016b-4aa0-989e-db0ca48ae118,Educational,0.2701139502623209,14,7,321,616,295,61.8589466504486,9523
06fd2574-a0e3-4d7e-a069-17d85f7bea35,Commercial,0.9662670821367286,30,16,379,949,570,84.09528811148756,1549
8aa739da-b87d-4c59-8f50-916b94126b82,Residental,0.9368277370613605,26,34,617,831,214,65.30755988641874,7347
f067903b-bf6e-4f57-88fa-82179ce86a00,Healthcare,0.010761960330866405,34,30,380,743,363,64.83321599186536,8370
49c3969d-a013-4114-bed5-44435fd36f62,Residental,0.674818690250663,41,4,587,1247,660,13.303832935374809,2504
1cb34f1d-03e4-4e5c-b377-4f367dd011a7,Healthcare,0.1966653990370999,8,23,30,253,223,44.078502191295236,5392
79fc8552-6861-4a47-bc2b-5c53c67fde47,Commercial,0.16441628522715002,12,1,468,836,368,59.286510886525335,3953
e2f3fde0-583d-4c3c-8f1c-d292baf3db79,Residental,0.2294522740351802,36,10,121,251,130,20.083345768228018,5007
846d7b91-ab90-4919-98ea-1e3202cad55a,Educational,0.785670595897871,23,26,612,939,327,11.639368031631436,8440
a739d308-bdb4-4efc-bbcd-0c7231166a2c,Residental,0.5879077367199144,8,34,110,1399,1289,26.224933726217447,7986
08def402-c99b-4b5a-b404-db5b9573f2e6,Commercial,0.8736319247131594,40,37,537,666,129,93.48844046415546,8436
b07e8aee-4b16-4a2e-af4d-ba644fbc4059,Commercial,0.492856755330945,21,14,529,1088,559,35.77429635656878,5684
c24a09d9-e7e5-41a0-9b86-c1eb0bc46a3a,Residental,0.31802940082796827,45,18,26,380,354,89.50099219119754,4725
79e5fb15-978c-405e-a533-c399d8e8205c,Commercial,0.6036914565298167,1,30,276,791,515,46.88145752304066,4217
c54719f2-fefe-43bd-ab6a-86bb4946fbf2,Healthcare,0.651768123172023,14,44,534,1132,598,87.99983302812338,2399
964ae5cc-dd45-451f-a8ea-fdd1f9ffbe22,Healthcare,0.873607433815051,49,50,443,683,240,57.21784741874025,5339
c13685d8-dfdf-4b98-9439-72f0d174e9ac,Commercial,0.8652817478304295,24,3,259,1118,859,29.7811317801298,7930
98d414ff-be1d-45eb-be78-c25f77adc569,Residental,0.9382057178009738,21,17,140,1352,1212,57.49278061213008,1585
c80b2540-fe9c-459b-86d4-6c360bf9650e,Healthcare,0.19238096197557197,14,49,82,944,862,96.17402781531104,6779
a96cfd5a-98f1-4435-835f-d8357356a8e0,Healthcare,0.94615200338234,25,48,395,1287,892,95.18446761718256,3439
8ed734a2-bdeb-4431-a6e8-bbda0cd2baef,Commercial,0.5723375605951184,7,34,551,666,115,57.34881803593982,9834
c1f31909-6130-42c4-b249-0771628557da,Educational,0.4612438620288396,39,33,415,1122,707,88.68319570485373,7440
80a9cd07-bd1f-48d1-a564-b477a2040424,Educational,0.4960310962683212,46,28,270,784,514,36.6185919090698,9228
b8ef1b51-7b10-4714-bd9a-c32857976c21,Healthcare,0.011448462789968694,31,20,72,1261,1189,91.10733159596208,8328
69f513f8-0123-4088-85e8-90381fb31473,Healthcare,0.8526706026773809,26,24,666,1432,766,21.759581991935292,6744
7fe5341c-dd14-4f29-8170-f048ed938159,Commercial,0.6951617191415519,40,7,200,531,331,30.055156578501485,6299
733ae00f-6c92-4867-9ea0-3b46081a91e3,Educational,0.07222763067857896,12,7,19,489,470,72.8870226319135,9727
b97cdeec-898b-4304-bb36-2b2fe7c35a40,Educational,0.44223307834967995,12,24,50,342,292,99.10106173559653,2994
24591e20-cd36-47e4-8d4d-c23fb524ff7e,Healthcare,0.11231904492358957,2,15,678,1058,380,41.035260440396016,5828
adb49de4-7ebf-426e-b8c4-8bc594ec213c,Commercial,0.7401295940371105,43,32,120,1313,1193,28.439086868706294,7204
4ea5f395-d518-4c13-a255-3cbd860337d3,Commercial,0.37249097091023087,20,43,391,742,351,45.06247506335777,8994
e302df80-be67-4c94-85d5-70063c3cef9b,Residental,0.7933665114908244,18,15,112,821,709,90.10796112894616,3627
43ea1370-82ac-4f5c-a14e-40981d7e1edd,Educational,0.9602774658523335,4,4,613,1128,515,89.03790566027378,1274
dca21c16-a06f-4343-80e6-b50c14685f97,Healthcare,0.17103744377202634,10,11,222,870,648,18.569772945976645,8276
8d8aba50-5193-4528-8c80-ada74ae9a039,Commercial,0.8438417190461215,19,15,171,1296,1125,61.70733307499955,4890
0d602cbe-a5d7-46fe-a9cb-e9efd50ad8a4,Healthcare,0.009142587548307768,17,20,509,1231,722,89.41368250513877,3918
68900c2d-9d0e-48f8-a768-44c775f2ca5f,Commercial,0.4675338440938316,35,36,493,1244,751,96.46701100794343,6663
22647e52-9345-4dd0-953a-383926f269a8,Residental,0.7520091850120709,48,28,532,973,441,94.11285398895546,4610
628f07f1-7b18-4909-8266-b44cf60b2399,Educational,0.007456998887791388,8,50,453,787,334,84.7103961365744,9212
cd5046db-7d85-40c7-8945-ca383e7ad042,Educational,0.8249951650810224,45,5,85,591,506,27.619345736660847,7553
8f91971d-1898-4b16-b596-310bb3993ae0,Commercial,0.3183356163180777,30,21,384,964,580,61.41532415522714,5943
57ce9abe-7ab5-49f7-8d3e-95992d383a25,Residental,0.7231069245200016,5,14,64,1141,1077,51.177687226979366,5031
5ef67583-21ee-461b-a6e3-211631f20540,Residental,0.48070155007812354,48,9,1,391,390,92.52543233361123,9072
4a04212d-b54a-4dc7-a786-651c78b4b817,Educational,0.47933829883552737,1,14,170,1083,913,99.4756225936743,6155
ac98447b-9f02-4790-a2c3-2f3a22bcd4aa,Educational,0.3131430135006692,14,2,289,1349,1060,65.8216532865662,7956
cd084331-33e5-4642-b0ae-d9cb35a1e514,Commercial,0.9913141400265373,46,35,27,960,933,46.725007385586736,6007
d04d916a-d06a-4c6c-b59b-6f87e0b46355,Healthcare,0.904333533468335,5,6,197,1141,944,18.56892354852673,5149
f5fc294c-e35f-41d7-8d32-c9bf79dcd7a7,Educational,0.6394041605862626,49,36,252,916,664,44.43609729281813,7191
e786fe59-93eb-4720-b360-0b1afbe8f6ba,Residental,0.8644058921933464,32,13,98,627,529,40.09393052757491,3829
aa433dfa-0e1d-4d69-9708-1990cb98ab2b,Educational,0.11129969410560236,16,13,718,1370,652,34.36567437412908,7776
fd7138a5-792f-411b-80c0-ee7d03ce54a1,Educational,0.994104373036945,46,21,250,1069,819,41.92070499125147,7977
6ddc8348-07df-427f-ad13-4b838631ef54,Educational,0.30005621431389284,32,33,613,1064,451,90.18955761642255,8368
6243a95f-869e-49a3-9c3a-1242fb20888d,Educational,0.1979168411124208,39,28,704,855,151,86.20078997392265,2063
ec6f8ba3-af19-4620-9861-3b2719be92af,Educational,0.22655129768710836,6,14,310,380,70,44.22960866544321,6218
e0e41864-e6b0-4656-9225-a2bc1f45cba2,Healthcare,0.14853597078738845,14,33,65,893,828,19.85014769089009,3829
80fbb099-80e1-4784-9a13-3c7babfc06c2,Healthcare,0.2794341500551013,41,29,655,985,330,98.09764157036822,3355
8a5a1551-cd48-40ec-ae14-cbc8bba42098,Healthcare,0.6706288982296362,44,7,151,1147,996,22.35519526925672,5338
f0396b6f-3999-4b5d-9ce7-ae9f03e3f177,Residental,0.17986826200929418,45,12,241,1100,859,23.81118307707897,2562
6086e995-de74-4f89-9042-124c779bbe1f,Commercial,0.34382409297318184,27,26,453,1273,820,16.152368634445324,4914
330dade8-54f8-41cd-97f2-37bb260f1108,Commercial,0.3018857956260249,50,4,429,1196,767,34.153559402843925,8391
73088d50-baf8-4aca-b03e-9ac4a0b19f94,Residental,0.9266874029382774,17,45,580,723,143,49.899392334990864,7721
30ae7e55-4149-469c-8037-c6517b6ca610,Residental,0.1228374963609411,5,9,89,1283,1194,19.80600057807697,7971
8481082a-716c-4afd-89e1-c7e70ea2a201,Educational,0.07167230187456353,35,39,508,1277,769,69.09932667488633,3344
afe5ca1e-b0b7-409d-bcac-e17b8f698d5b,Educational,0.45601046255628597,3,1,629,755,126,48.91852659112815,4880
f58f9755-74f0-45ac-b322-72ba1bcd9e5f,Educational,0.013264131723465522,31,9,298,524,226,10.285533077080256,2691
e7912dc2-2db9-4718-9d44-1a5c68fa52f9,Healthcare,0.7355414028829673,34,8,374,551,177,76.26955953550178,4560
a4573b7a-7f9c-4a5e-9c7f-ad2bda89428f,Healthcare,0.9234844587271688,47,36,500,1077,577,28.627201247892167,2627
326c8d1c-5cf1-43e2-9b47-3e3527a44d3b,Residental,0.03614954609672649,22,9,385,1344,959,71.63917738425712,8187
c68d629c-3d1e-478c-8dbd-98a4a3d1fa2c,Commercial,0.7570462416798698,9,32,294,1234,940,22.36393774435779,9629
601695d6-a714-4cc9-a830-482e1f84da4c,Healthcare,0.10433642064575288,22,17,655,942,287,55.08268308497131,8103
40b60df1-d1ca-42db-bc46-170aa7273cff,Educational,0.5765500008773642,33,21,491,590,99,21.264617671962597,6407
1fb2c533-dec2-4bbd-a769-1076e4a90a5d,Educational,0.02986593675828153,11,13,445,974,529,97.22343086114672,5367
c594566d-50b4-48c4-be30-5fe275a9ee42,Residental,0.44970412281361893,15,17,659,1111,452,68.15886762234712,5468
a06bc731-1752-4d7f-8f0e-3ae718dd09cf,Educational,0.21234124908357388,25,46,27,1276,1249,40.610802581857605,8466
6af08559-0b68-45e2-8035-c54d6cca996c,Healthcare,0.5991536744926811,15,4,17,293,276,97.51661326906942,2308
e2bcb491-7179-4e73-918e-a9a33061b00d,Healthcare,0.9800022156154816,15,18,19,177,158,93.16711858434039,9906
df0a33dd-b1a3-4eeb-b69e-d9b6a4652278,Commercial,0.8593127800416197,4,35,134,1340,1206,36.78172082940917,1141
9053d1d5-f0bf-4a4d-ae66-6feec9ce6a66,Commercial,0.13905939290215852,9,43,702,1056,354,26.231249965352475,1390
00625414-0d42-4b84-bcb9-3dd9f4c706ad,Commercial,0.330404340287607,18,37,287,795,508,49.76077427587148,4543
ff2b199a-d549-4bef-b9e5-edc27ef68c3c,Healthcare,0.13023938226641607,25,49,91,978,887,43.66983724482266,6875
c39e4a43-8749-48e9-87d3-fb0be0648ca2,Residental,0.14880222566110246,31,27,234,287,53,84.30105837155037,6887
07f1705b-24cb-4668-a9d4-be2186209fdf,Residental,0.7814428949886228,14,29,509,1376,867,90.26907119785463,9747
3b88bcbe-112f-42aa-a198-bf1eb4a2c3c5,Healthcare,0.790503686697673,46,18,61,1112,1051,78.28485311573964,7782
63810001-6c90-46f6-9ddf-3dd553db2fb4,Healthcare,0.8223266339897565,27,36,32,879,847,80.33463484629186,7991
76fcfce9-d4d8-4516-9340-8c56c8858e51,Residental,0.937420486895509,12,18,23,809,786,78.88368306473271,8255
764aaa4a-0a03-4e9a-afe2-fb411c15842f,Healthcare,0.021634889069568675,9,4,657,942,285,52.26815750670651,3429
faed13ba-8190-4afb-a330-cde93ff75b93,Commercial,0.18216139273536092,7,38,594,1195,601,58.652851993770476,4242
9cc49053-d6b9-4389-882a-6f393c452d4e,Commercial,0.5653637163708486,41,42,673,1440,767,64.4152903029663,1654
a2d34346-a3e5-4e6e-8a66-5a704639add8,Healthcare,0.3350485423146574,41,4,98,1254,1156,92.33577358920108,5864
2f314e33-6582-432b-a147-78df0ffe7c37,Residental,0.16852092152752662,25,7,114,725,611,16.140007307507965,4575
4467b9a4-9e46-466c-aa83-b8d8a9beb320,Commercial,0.5092026376645065,44,26,166,808,642,98.55705721201309,4102
ae173d4b-8fcd-4778-bee9-66e723ac1d8c,Educational,0.5869306396449838,1,48,188,1302,1114,81.70962255454194,1487
c9609b6e-f162-4912-b62a-16d48b05d191,Commercial,0.23912267785610786,45,4,289,599,310,32.94570640246545,3655
438cc56a-66c4-4094-accd-9c98f6ae9dd5,Healthcare,0.054916936420279505,9,34,118,371,253,56.014976903817285,5954
aa5e1c2c-9da8-4838-b97d-0d6e4c3ea7e9,Commercial,0.5940125531415327,47,14,538,1251,713,51.98060761108451,4502
6739fd4c-e2d0-4d2e-8235-2bb0ba8510bd,Healthcare,0.7576254580034535,19,14,262,1349,1087,50.048320896671115,3617
0ce6f3fb-d3bb-4f9c-86db-425e1eb6d02f,Residental,0.5360724420653976,3,25,192,983,791,52.13717492525022,6238
93a6c087-6441-4e44-9d3a-b5e3bd19457f,Healthcare,0.22991239004800812,8,48,639,1140,501,27.827411676796416,4133
a0b72de0-fc67-40b4-a51b-170a1a2636aa,Residental,0.36003517494104686,29,7,442,978,536,73.00201632366125,3786
2a570eeb-3eb6-4ec9-a11d-9a0cb1b224f4,Educational,0.29237966547793603,30,8,506,684,178,64.60337037494966,9954
87ea65a7-4944-4827-82c1-ce6d98104a98,Educational,0.5676646934899634,41,18,258,1085,827,54.556361140833936,2069
fd8bd3ca-de88-49c7-8061-be830ddd1cd2,Healthcare,0.48918836100972685,7,33,656,1255,599,74.35969812721457,7192
9f09f30e-2b41-4677-b71e-52faf1350dd3,Commercial,0.1819687020740255,18,32,695,1316,621,95.8479969250173,2540
ce12f134-4dab-4468-a2f1-ec10d51e216d,Educational,0.9165685980029427,18,38,589,1181,592,73.98465797794415,9460
a2e3cd85-9a63-4aa2-9928-e062db1af6a9,Commercial,0.873809063723255,34,1,371,514,143,56.867285916515385,7976
3254efae-aa3a-407e-8ff7-8a9a128b37d0,Healthcare,0.4017730711011219,1,49,644,672,28,61.16650925584767,3960
ce8b3be5-ab0c-4a61-a4be-5db06aa2b9fa,Residental,0.24222828374612393,5,10,342,1244,902,12.233389228343826,4837
b96d8112-7926-416a-9150-a3a30940a56c,Educational,0.3396536704771971,13,23,564,679,115,94.80580812071875,6735
3e20c008-4c17-4445-915a-ce7cb6a6ae25,Commercial,0.7454891670009018,16,32,555,711,156,21.696383670847286,8847
77e804b1-f477-4f14-ac95-33f716b06658,Commercial,0.7581086003720576,48,29,78,474,396,32.98453737154715,9771
8d8b3779-818f-498c-b520-ad4d67abdac3,Healthcare,0.2809281427077055,38,4,146,849,703,28.793866756992994,7323
c6628f57-f9cc-41a8-850e-4a79d6ef4dc8,Healthcare,0.1408593418693983,27,24,289,1215,926,62.63542738589494,9828
38db8035-fb43-45ec-beb4-2cd686c7208e,Commercial,0.3300056470206032,32,50,581,850,269,87.85063041094365,6320
85f52c32-e9ac-4c96-92b2-c06d45b7fa58,Residental,0.8719749917515889,25,8,523,958,435,76.9190817651684,4050
75fc4db0-be28-4fc1-8338-a59deffbef20,Residental,0.3728663959173997,11,33,570,736,166,94.51906014969981,9287
701a720f-7991-4b27-87ac-60c8047972e3,Commercial,0.010096922307074596,6,28,389,1387,998,40.29800150099234,6787
09815e7d-4dc9-4f2a-afe9-25b7c71eaeb0,Healthcare,0.9049621221179879,30,44,688,877,189,63.5167920372362,8363
ecddd90c-1f9d-4068-9eae-054541562e14,Educational,0.06042412012997178,30,7,110,596,486,51.805034967143364,1762
2ba06969-75ab-4bf9-b097-20b5c7c8403c,Healthcare,0.8632741413701496,14,29,90,474,384,28.148373875813665,7769
c9ba3cc9-f5f2-4722-8855-391ca5394712,Commercial,0.8711193222690352,19,35,162,1089,927,39.08317985176083,5808
b39be455-e367-4cc2-b5a8-38067f55efb2,Commercial,0.09159992619778123,41,40,29,263,234,25.126139856564095,3775
dfcc0bc2-b471-4b8a-ac74-2e5a0384d3b6,Healthcare,0.7988979477851682,15,25,495,645,150,33.15811114868106,6999
7332ba92-477e-47a7-87a9-2b55c1985d33,Residental,0.5079810843665724,21,33,57,186,129,79.83601280766786,3744
1d135b22-9d92-4c72-a958-00d825d5299d,Residental,0.2776694104112605,14,38,147,912,765,49.305732483041425,6986
f87963cb-ad57-4c94-a7f9-b714deb98720,Healthcare,0.12656536571363497,31,22,455,1242,787,91.04520137366052,5603
77e6a25c-befa-42fb-bd25-1f4e437a73ef,Residental,0.9509053080560949,11,7,666,1127,461,42.27256460197554,8176
cb640ad9-aa35-42e9-975c-d5b468c43412,Commercial,0.5968745605336185,8,9,359,1023,664,14.579587138308874,2211
21cdf656-bf35-4e9f-8ca8-9bb4b7470158,Educational,0.9244134101465283,3,22,632,1263,631,10.198202828589203,5206
c50868e1-35e9-4ed0-8de2-67bc36f23ee8,Healthcare,0.34471581480268887,38,37,581,1302,721,55.81441043633076,4175
bc0322bf-a846-48b9-bc6e-11e5bf1c635d,Educational,0.07559878120326136,42,49,536,553,17,10.093968894997413,1622
4bbe4c83-f7cb-41cb-b620-404034f52686,Healthcare,0.4166246906950567,6,21,328,1419,1091,72.93976695796776,8285
e310c307-4527-4824-8160-2ebfddfdc120,Residental,0.8371781008800645,29,17,493,996,503,41.58058794348778,7907
746a6df4-7eb1-4521-95a9-d5fa834fe5ac,Educational,0.7286049429660835,12,6,277,1087,810,34.20721720636669,8260
57798e15-feab-47b5-ae40-49135a71b460,Healthcare,0.1127761577782439,2,23,634,1154,520,13.971754285878612,7439
edc814fc-7acd-42e4-a683-95ee8f8cdeae,Educational,0.6076200134830541,48,8,222,300,78,56.74284445039653,1932
61ce949e-37a2-4079-945e-c30e94dd95cc,Educational,0.2622356506943331,14,21,465,1037,572,10.46803449182008,9988
af8faabd-0855-45c3-a554-eba283d150eb,Residental,0.05311981974281166,2,29,184,856,672,75.31202833140546,2807
0f98d358-7596-455f-90e7-4b9dab8aecba,Residental,0.4625696643038809,35,5,195,1113,918,88.2157553077505,5464
1b380ef9-5211-4eee-bcf3-ac73eb63ded3,Residental,0.06666457193312736,28,45,135,1184,1049,71.92266167754593,5028
70613da4-47b0-4519-9f23-ff2243f9d8a5,Educational,0.344733208051307,30,13,537,658,121,41.11660096983444,6927
7e0604fe-fdf0-459f-8c44-5ffc71e410f7,Commercial,0.6598223215099888,48,31,482,493,11,36.214434106787664,7056
ba6eef67-7b68-4a0a-a98d-58241541080e,Healthcare,0.9106404059219221,4,36,644,725,81,73.64482976554156,6697
3a8a0b5a-d91d-4759-914e-ccaed6bba00a,Commercial,0.9839699609866204,35,33,502,800,298,93.53355134134455,2486
23351d9b-c0f5-4afc-b19d-6f7981986766,Residental,0.9457111138925942,19,17,138,1326,1188,34.749227192023525,6565
436fbf05-1b0d-489a-98c9-67f6cd614622,Commercial,0.04041716593624922,6,32,611,830,219,88.37158366214855,4855
03307f9a-5e64-48ff-ad81-820c34a43bab,Healthcare,0.7597433090166504,16,39,578,730,152,26.162926678796822,9554
316ed9c8-837e-453c-8545-82ea8f8f662d,Healthcare,0.3564287660617206,24,33,390,692,302,54.8870224102957,1873
b4f20b2c-cf0f-4961-9d2f-67a81d862dd6,Residental,0.95103940753406,7,10,579,787,208,22.717965300035633,4322
6b13d2e2-31d3-48de-81c8-d2d925ffd03a,Healthcare,0.7009896337793812,47,32,392,545,153,24.391622803716345,2075
c86e1627-3103-43ee-8f76-bade84bf2b64,Educational,0.2443437256961004,44,46,456,1348,892,81.65703877090837,5531
b4d016b9-f233-4e2b-9f55-63563d6d7898,Commercial,0.22347689718371555,30,46,574,1030,456,92.73055838492587,6753
f9ebb22c-5328-42de-8936-e82854749071,Educational,0.2737413887087409,20,25,192,866,674,10.463127352047902,3283
00e1d4f8-1c33-4111-9048-c762dc95ace8,Educational,0.026145434033347237,6,4,613,872,259,61.36185433472642,9743
19b4a9ea-2564-4cd9-a305-e061cb81c0d7,Educational,0.3408942848454716,47,27,286,541,255,35.78338315729095,5871
a8a5043c-9f25-47ed-8bbd-a75bb3053060,Educational,0.7160536769177955,19,50,202,730,528,35.214125126364664,8527
003b3741-e019-413d-9304-c056fa03db03,Residental,0.6661534407925207,43,32,79,1017,938,45.05181763527294,3472
08b87685-55d3-4b0e-bdc1-a389dd0c9942,Educational,0.9478240286274318,49,20,186,755,569,89.96085863111945,5399
0d455b5b-ca35-43d2-8c4c-3eb5e5158b8e,Residental,0.4963087500643698,22,11,550,683,133,31.01134544252922,6836
128fdcb3-ed25-4467-b802-b55061a6f270,Healthcare,0.8748601130695195,24,4,308,1299,991,50.75747950719767,4194
9e00e4f9-8cd1-4acc-bcec-3fa80ad204b8,Commercial,0.4615933172641413,49,42,303,1061,758,31.86519348089749,2713
21d0e7b0-bf89-44ea-86ef-275c9130a033,Residental,0.9954918185766021,22,14,570,1066,496,63.54341815918403,2401
64f1220f-7577-47e2-80dc-a363969ff5d1,Commercial,0.9334459582972797,18,15,392,813,421,53.277027253295046,1211
da9f17ab-c129-41ce-b092-799b507431a8,Residental,0.524649296864291,9,26,47,1343,1296,34.063995047434645,3771
44de86e1-bc94-410e-9f42-3a9002614c11,Educational,0.05786988301495888,19,47,626,1254,628,44.432333588704495,4686
18ccc9cb-098f-4b93-a745-94924db1d120,Educational,0.46917985018177777,39,49,180,181,1,66.3660792015695,8274
2bae139c-2c84-4e6a-9fd0-b915528f0878,Residental,0.49736950205951047,25,8,245,674,429,20.545270071141935,3133
52219594-7bcf-4176-bfcc-a12ff0e012f8,Educational,0.7406738307133832,23,47,590,1319,729,12.84569951284594,5824
d91cc95f-d250-4a50-add0-79da37951c21,Commercial,0.7227244011402812,24,30,426,1016,590,35.55690977805993,5076
23777e8a-725d-4ecd-8922-d8fe318d8932,Educational,0.46954212534365003,25,2,83,672,589,71.39352912983689,5174
cf751748-998f-493c-ad58-68330559a212,Healthcare,0.25230213993273143,10,5,444,1028,584,57.1549727635164,1963
303232e8-9f8a-4d13-836b-3aac17432d95,Educational,0.241881422907131,35,6,76,161,85,21.990690057263613,4649
17c8d8d5-58a9-446e-b18f-d8c4d54d8e4e,Healthcare,0.7855540999676842,44,3,346,1234,888,66.10707724434084,9888
f9601b76-63da-4266-a630-fd5327d39771,Healthcare,0.08207198160076934,24,13,226,656,430,35.69126934933574,3233
f3002c34-de8f-41d1-ba37-e22062480966,Educational,0.2272874355563359,9,16,338,882,544,14.931347657265766,2709
9c563d76-eb28-4909-9e1d-c5af3c67a215,Commercial,0.6211369997153514,26,33,189,413,224,99.59355975364826,9530
7b10e3f5-be63-4ee8-b426-760b4962bd8e,Residental,0.04039175627685243,42,17,435,1173,738,89.91918018813729,2058
c89fa940-2b86-4456-b6ef-b5527c69e099,Educational,0.4450571503901243,34,26,671,1338,667,97.3344102331883,8029
808bae29-f084-42a3-a77c-c66fae390320,Commercial,0.24339360468680127,38,20,682,1052,370,60.09812013463709,7899
133eab1b-74ce-4b2d-9353-610983618857,Healthcare,0.6764214931552014,45,36,41,1294,1253,92.6629933273981,5368
aad0163c-234c-48d3-bd07-958fdc0c5cb8,Commercial,0.6271743335230019,30,19,532,548,16,82.91851680504398,1942
81b12483-0ac9-4ad8-a7da-f5b38cc608ac,Commercial,0.5293588484569051,20,27,242,1403,1161,25.64671873924706,9428
d323b19a-b87d-417c-872f-c3ebcf42865a,Healthcare,0.6756782960572367,22,27,299,423,124,77.71321181824298,7567
bab2b1a4-6691-4489-95fb-db0c03e3ab4a,Educational,0.47153498757062273,19,32,649,1043,394,90.49840098900054,9547
2103912e-8fb5-43e4-9281-ccb080a9c998,Educational,0.43842243898934763,30,33,467,505,38,47.0458344028469,8753
89ac2ed2-49f9-49a4-9a73-1438318a55bd,Healthcare,0.6710047221802447,21,38,289,979,690,87.58739219373567,1725
c69891dd-3841-4aa5-b481-354eb1b400d1,Educational,0.5698075171912855,31,26,264,617,353,99.50161332344287,6848
ea21d24f-1401-4604-8787-b1d62ac6fbb5,Residental,0.48420556393205494,40,27,507,613,106,89.65508972910018,1843
4e6a88c1-0fe2-45ba-b089-eb8bdf627418,Educational,0.5797947958940174,19,13,582,650,68,48.67681996671445,6841
b7bdcc18-db63-461e-bcc2-07fc28589bc9,Residental,0.8539129244712641,5,36,504,1371,867,79.69442975525818,5208
d42d6dba-2aa9-4cad-862c-f71646d5d0e7,Residental,0.44634900539197164,35,1,315,826,511,90.97062845444424,5147
3b7df4d9-c91c-41be-a597-1ceb4563ca6f,Commercial,0.8028705828962364,42,31,15,689,674,99.68101876336847,5719
e29a3427-46de-4f42-94ec-c653108f53aa,Residental,0.2827454258277172,50,46,207,1184,977,55.07613812944768,5380
86202d59-afe9-497e-b815-fe8398160490,Educational,0.7421337665849147,5,30,537,1017,480,72.81174582708411,5286
79286dfa-2511-49da-853f-2a0cb5c64955,Educational,0.677457741205548,27,12,697,1040,343,18.12894386977218,5779
3f062f23-fa9f-43ba-b13e-e6c02ae9954d,Educational,0.9958816653126287,8,33,317,1259,942,54.49988376861514,7395
809bb53b-4254-45e3-bcae-6aa7a0fc5b53,Residental,0.8256789700928373,20,17,30,794,764,76.11727660374825,6380
586c722d-81c3-448b-8e0e-a9f6114cfa02,Commercial,0.1192253553030449,17,18,625,1229,604,88.99295361191889,6983
60e4ebca-23ea-4a36-9dde-497aa08753fe,Commercial,0.5941761291076807,50,34,438,1302,864,56.16009528452734,8073
7618f9f4-8bb0-415d-8778-0c38cb4be6e9,Educational,0.42497188179064926,12,44,681,1040,359,85.69801816335163,1011
9283d21d-644d-4153-876b-b90bf31cfad0,Commercial,0.8108809649723242,13,24,566,772,206,14.122151278197705,1366
0684a7dd-8695-4aca-ac5c-cb35ae1f31ac,Commercial,0.7100634478143991,21,21,496,1110,614,32.557717460151096,1366
1a99247c-1097-47c9-a4b5-4f236d11708b,Healthcare,0.8371639911233116,24,27,686,1288,602,85.5186742076497,6935
e0c8adf1-823d-4df6-80b9-d279d44c27ad,Residental,0.8553070920216859,29,4,223,638,415,67.24689779351183,9248
8bb1e4f0-55e4-4779-a683-038bd4ceadbe,Healthcare,0.6345819152746032,11,30,382,599,217,83.03896313587828,4340
df0be974-4739-4feb-9a1a-3739bf411877,Residental,0.6273716672521769,10,26,63,1340,1277,60.51171342698201,1991
20ba3e98-15ef-43a7-994d-9c22f6781897,Educational,0.36036621937011437,35,24,1,683,682,87.13288926295444,5640
2f88b4cd-f72d-40e6-8fca-b3bff8f6a2f3,Residental,0.8710350160684109,15,24,108,430,322,26.84152460040976,1074
a4768317-017f-4690-b348-c5be72eb195a,Healthcare,0.36398536089868894,39,37,294,959,665,60.45978270321737,9768
0253e41d-2ce0-4bcd-ae69-ec34d590ec82,Commercial,0.34569736202183976,47,42,157,596,439,19.6161214019226,8978
124ae08f-50e2-4f3f-971f-53746f2851bc,Educational,0.2766689255127982,26,9,424,1198,774,29.186052003373508,3253
2371d861-b3c8-4cc3-8560-b721a4e86f89,Healthcare,0.332330517219273,20,40,167,967,800,21.238900918012693,9956
b131edf1-c495-4026-a2d6-4ea946b123fd,Healthcare,0.2603996804534172,41,25,698,1299,601,74.40443131215746,5236
8326dcbe-7574-4273-97a3-a25ce8a48290,Residental,0.7774509160798795,19,44,718,814,96,37.428884084967734,5527
f40766a2-2158-42ff-975c-bb1370196a5f,Educational,0.6922634975968652,3,31,388,1161,773,27.399585382835042,9168
3b3a5bc4-f222-4557-b88a-2c1a1aa0aabd,Healthcare,0.18754678125644175,10,29,55,404,349,21.447627715266286,3865
08f885c0-0235-452a-ae63-96068d7944f1,Residental,0.9338059413661935,32,16,281,1116,835,95.98803338312696,9157
f627a092-a372-45a2-b9c7-4025896d4042,Healthcare,0.14960365098760464,15,15,65,830,765,96.70129680425723,7600
899de0de-40c4-4ae3-95ca-ade36ab8124f,Healthcare,0.9405656952777082,5,17,12,1043,1031,35.90964596603726,2762
0726c5df-1686-460a-b2c1-aebeaa6abfcc,Healthcare,0.7166066170140152,23,33,644,1427,783,85.02922746782855,8385
b230e91d-59fe-4f4f-80c2-c743cd5b012a,Educational,0.017340299741761767,35,20,12,743,731,40.41160016523706,8316
c900fc8e-165d-42ae-9777-78ca89daea14,Educational,0.08133115699749638,25,7,204,738,534,28.143702292084452,1905
75ae9aa9-7b61-430f-b0a7-4565362fad87,Educational,0.3902614177239103,31,45,53,648,595,69.69479600652986,6411
0f6f1579-cf25-4f4c-91e9-bcf5a09ef17f,Commercial,0.11266932417415954,35,36,327,1000,673,26.73488370221231,5514
1939fa36-ebf3-4e82-9688-79f50aeaac95,Educational,0.246035061366499,9,42,653,721,68,31.026042677943224,1754
f69fe732-36ed-400d-8bbe-ec58df8972e6,Commercial,0.19975153535474577,33,1,617,981,364,82.20955096921026,5521
69562470-8dd2-40f4-9776-6dd37e15ca1d,Commercial,0.28373807520839245,36,4,26,435,409,60.05223173436329,6452
cb07142e-e3f9-4a86-ae60-e99f91112e0e,Commercial,0.823527766806415,33,35,318,437,119,24.459910701689232,9510
3923b40f-1c6c-466a-ab92-b44fb45d9c7b,Commercial,0.30730773953568813,3,32,214,899,685,87.56368401677733,6116
2ae93c4a-d3b1-45a6-9ec0-b1b257ac8a64,Commercial,0.8135923572729604,40,9,19,269,250,81.81812703275892,9323
0d1a6bcb-0e2b-48f6-8554-0837e46325b8,Educational,0.11680652535538716,8,43,543,624,81,78.57817987191896,8980
21f50c43-58f8-4ab7-8f71-b0f643fe84cc,Educational,0.3029086732160575,46,14,713,1324,611,16.079629253762825,5976
8c0d5a49-32ba-4def-a70e-92b98d794b41,Commercial,0.15572142760002716,36,46,653,682,29,74.19522808022428,5879
89e84e27-1c7e-4579-81dd-e44340cdd96c,Healthcare,0.667960506732661,31,22,31,749,718,51.45462227595436,6033
13136047-d017-4a75-90b6-17e98105ba24,Educational,0.6621211380979592,23,28,158,669,511,89.01649089981123,6943
ccb410bd-c7da-414c-8b9f-26dd116d3972,Educational,0.860689362540726,22,7,375,435,60,62.689826306739285,4179
53bd3de5-86e9-481b-a3d4-5778bb799a3f,Healthcare,0.41879646348130295,10,28,606,719,113,20.96824449924575,6833
ead3220a-b662-4d3d-995d-f3b7ccf63177,Residental,0.8458445831557142,19,22,23,1429,1406,61.89741679941202,7606
3c8c9c98-4109-4aec-887c-df08f2ac6253,Commercial,0.8837302048513059,6,17,50,388,338,41.62914258183643,7077
fac1a944-ad8f-4b4c-999b-f6d096786dd2,Educational,0.5058187439368826,33,8,60,1202,1142,68.80539544564742,5265
f09d4fda-157b-4b61-ba0b-d35e4f0b01cc,Commercial,0.95685487512309,17,10,172,1312,1140,57.05618174891525,6606
5c54a335-09b1-434e-a8a4-15a0995e715e,Residental,0.34771781747397923,5,1,286,449,163,37.36000678777354,2751
8fbeeaac-3e08-4dbf-ac6e-c872d17ce048,Educational,0.9822585595720521,16,33,466,874,408,33.76499956977125,7292
8483d365-7d81-4b2d-bb62-0ec512010b6a,Educational,0.13506583051779675,22,34,566,1093,527,93.8255999540559,8382
5d3994a4-714e-4c3f-90fe-b7d1169defba,Residental,0.31789797225668326,21,28,364,1294,930,42.75691715910718,2533
83fadead-bd3e-4ec3-ad1a-10958a7f6e3c,Commercial,0.17168313559263426,21,34,544,764,220,18.71028888458673,9889
f39a6bec-59f3-4e18-b831-466ca60ea58a,Commercial,0.33143985329621195,37,45,271,843,572,90.21361024695683,2267
41900c15-05d8-4d37-9fff-e5d93a8f045a,Commercial,0.7103092235744624,50,25,557,1058,501,44.5786005841213,4384
d33d2d69-d549-430f-a488-7567ee9e821e,Residental,0.28842819665011077,1,30,654,1327,673,61.56963302420077,9755
96928ed6-1d7e-4202-9b57-1e3e8fa17563,Commercial,0.4803879474175684,50,3,528,986,458,54.88690866574288,9147
07eb827f-e2a4-48e5-9e57-b32eb59b6235,Healthcare,0.7239254275575596,40,38,350,895,545,86.3633294205473,4334
ed9b4db1-a945-4282-8957-a6e6c47dbc7a,Residental,0.6206257621239908,12,10,155,542,387,44.364803292835155,3307
34d6f728-e5ef-4a16-b6af-2eadb1bf7764,Commercial,0.8213086987927681,27,27,93,1036,943,72.56992858032984,3855
996dd875-7bed-4deb-8d1c-381831a9ffca,Residental,0.07936118516820012,12,15,551,1316,765,94.23440782124683,2287
c25e9bbb-c89c-4471-9e72-6179c072fe2d,Educational,0.7386993505491707,5,49,74,1213,1139,37.80570255446127,3064
9e896d58-e91b-4373-bd89-3d7056c76709,Healthcare,0.22643192557553804,17,45,503,1050,547,19.906593262811565,3989
2663c8a9-62b6-411f-9328-33acf59b68d3,Commercial,0.899754282713361,18,42,621,1147,526,10.089345443195523,6621
359a168e-7455-400a-84ed-3e7033dfcc61,Educational,0.20175039311798215,9,17,612,1298,686,83.77839489940042,4525
dbc571eb-5cc5-4e51-b52f-381928964b8e,Residental,0.07552570672126258,23,42,266,292,26,49.84210247854881,7141
1d0043e5-69a3-4671-831f-64dce8312859,Residental,0.40066257619603074,10,23,304,728,424,64.56387009810095,5557
6a8cf8ee-1802-40f8-843b-700ee6da83ca,Residental,0.6422435509841778,1,26,307,1428,1121,88.03246450349484,2063
272497bc-6bdc-468f-8aaa-dcd2f6aa35ef,Residental,0.5966030623047376,14,18,54,81,27,29.391429739460854,9489
54a19884-5ce0-43c3-b205-6e9d5e131e8c,Educational,0.2654328872217002,3,43,674,1216,542,94.74191377360746,9208
7364f10d-887c-46d8-85ac-d74b053c4514,Commercial,0.251657336066874,12,4,501,836,335,60.25727293767479,9491
5ab387eb-d67d-4674-8e80-0d6f4962b043,Educational,0.9655416334231804,24,6,73,1036,963,72.85616224373904,3617
b1a8e0fe-8e8f-4358-b679-593a90aa8ada,Healthcare,0.5508333624296534,27,34,163,1300,1137,48.58558027317858,4836
7be1df8c-e764-4537-b916-c050e4d0a9a3,Residental,0.9599303170037613,21,6,253,955,702,13.630445286171545,7698
06643383-bcf6-4747-a8f7-890813bf67cd,Educational,0.23907034454442821,14,35,660,892,232,70.29291496234336,1044
d5dca05a-eddb-483f-b985-2ea4cff54272,Educational,0.5540747658960505,18,42,248,745,497,23.927031074564503,1191
b430ea48-632e-453a-85af-982595697bba,Residental,0.7722549024912273,43,16,117,220,103,65.13076113383885,3070
e912c515-c2e0-4112-a71e-bb76bdf70444,Residental,0.18474261016311688,47,38,242,318,76,98.14110011132077,1268
149cab17-607d-496c-9267-813ef5fd2330,Commercial,0.5389429019002142,22,17,242,1115,873,11.68302573784567,3551
af28c44d-f562-411f-bf78-c82e365a1262,Educational,0.30357337050929156,33,35,458,608,150,21.343177408174512,4927
7a8c4a37-3088-4dc1-9988-d17ac8ff2971,Educational,0.7048163508830455,35,2,264,278,14,19.92717881701436,8760
1ecf09f2-e3d2-4d11-92ac-8df510c85a6a,Residental,0.7479118182177266,23,47,24,1288,1264,37.27983820051536,8898
145361c2-24b0-4347-8a0e-f6b9a2ac4a5a,Residental,0.08183780759174752,31,6,244,557,313,74.64812711044013,2566
0e67abe1-1886-4911-94c3-2974805fbc6d,Healthcare,0.516113781281556,12,14,667,1287,620,13.164797422275505,2357
7092935e-6b6e-4fe4-8ab5-85d9644d28ce,Healthcare,0.06993799165090553,33,6,692,1100,408,10.407488944442992,8302
d2499342-c817-4b9d-ac8e-ae6db0be09ed,Residental,0.18471420874908284,38,29,36,436,400,40.279005313124564,3213
8131e295-b1b6-4043-b724-a79cf8995542,Commercial,0.41233226034652093,20,38,276,309,33,89.27828269742758,7215
c6140e89-2bd8-4ec6-aaed-397df463f823,Educational,0.7684579984590023,44,5,273,1231,958,15.298839744223914,8913
fe2ae9b3-d014-41e2-9605-a5983373fd2a,Educational,0.8814865344042413,2,21,489,724,235,83.6531832162956,1342
69f4e021-0b07-4a3b-bf39-880d9ef23d52,Educational,0.4446902359251622,41,7,369,610,241,52.35090694354922,6398
4e2adf65-7b21-40b5-9279-e95c3d669b16,Commercial,0.4237001577795917,3,21,59,827,768,36.310425236645315,4421
0df5b68d-a2ba-458e-8fb0-fff01b64b3b2,Residental,0.7116970582959403,17,41,681,1378,697,57.45441568953504,3435
aedc5300-500d-4ab7-9be2-cc3a30ea9a1d,Residental,0.9505346719622584,11,13,179,1256,1077,13.525722021928278,1497
b3b2aa35-92ed-45ad-9e09-37f2b22646f7,Educational,0.14776490174247325,22,37,149,978,829,48.03225160586038,7844
7a74acca-b40c-40b7-ab15-ac3a35460173,Healthcare,0.6295447040174099,14,31,610,1098,488,27.65370682462429,2184
e34e7b89-b227-4552-a353-a0940133edd7,Healthcare,0.9967434789689659,5,30,107,737,630,96.18559554311997,4601
71a24652-dd28-4342-87f7-50243f8a2a2d,Residental,0.9186186074880232,17,39,655,856,201,43.2139401159093,1975
f6f50a80-963d-4cad-afa8-a80f579dbcee,Residental,0.9238950376651429,42,40,225,283,58,15.682898777008543,8273
eddb4440-9a05-4195-a6e5-cc362ecc3bc9,Commercial,0.9973415184430988,38,45,19,53,34,50.84363771408995,8287
aef68368-4386-4cc3-a351-fdc7129d64ea,Residental,0.07053820565182078,14,2,494,1126,632,59.853591706976104,3876
ccbcb853-721d-47c0-bb0c-63938306c398,Commercial,0.26931584543211784,20,9,566,934,368,46.94913397682304,4163
5596365d-e221-4e12-b7db-2d87224341f6,Healthcare,0.44154133676069984,49,14,104,1130,1026,43.58446587045964,3493
28d305fc-8fd2-4c30-ab72-d4a554601e03,Residental,0.918522439643056,17,43,29,181,152,71.47928034003586,5734
8d65b6ed-b575-4cca-806e-6705e0bf050e,Educational,0.28758168322630884,12,14,160,1308,1148,55.21076613974361,5459
617e3478-485d-4508-b367-0e1336c7e2ab,Residental,0.3275522405123118,25,32,101,1201,1100,87.69249928000764,3296
adc741aa-e3fb-4f69-9dac-5a180f79cf3b,Residental,0.08711540274654861,6,8,668,982,314,37.21831917457503,3665
bac0994b-008a-4410-89d4-ca4d0c4b3135,Residental,0.6133121959229567,31,15,288,1226,938,51.24359632595829,2214
9be62b9c-38ad-4d50-8061-cdc21bdd3fd8,Healthcare,0.010173738928815679,32,45,495,1040,545,72.87765613302213,5104
aec6fbda-94a6-40b6-9f7d-8e646e5d2a5c,Residental,0.2226598232249919,23,21,68,747,679,42.70578335018274,1724
686f8bf9-c274-4e66-8b1e-c4d2466aecb5,Residental,0.09566904105371987,36,1,223,1158,935,96.94381556521243,4368
99d13dc7-7e57-469a-b809-d5a8d13f4840,Healthcare,0.8323363655564182,43,35,153,433,280,39.223493296539566,4148
691ecb71-4a81-433f-8b9e-b168dd5ef7bf,Residental,0.5855531654633251,43,6,153,246,93,92.28970022711486,3578
a6113f37-acf6-4463-a785-a72dee34b434,Healthcare,0.6258201997378501,29,20,544,1129,585,18.549844885657077,9929
64e92638-4b7f-4656-8085-ed0fbcbfb081,Commercial,0.22092610904355925,18,21,687,1325,638,32.036277166303655,8483
f4d51a83-c1da-46d1-9f4c-933103de1e46,Educational,0.9005381064901836,29,34,286,807,521,16.541542886183453,6885
85f8dce5-cd80-4e1f-8033-2ffef2dbe1b4,Residental,0.21134676170601896,26,17,59,743,684,35.993143663343254,4097
91c5be86-bc60-4634-9e16-66a918b0a643,Commercial,0.9918393888268825,14,25,33,600,567,39.59955369984303,2924
f9fccf2d-0d5a-44f3-aa01-fd3a8a5dc952,Educational,0.50230808987654,2,8,236,315,79,19.258213679374844,6555
357049a8-e9fe-4b9c-a8ed-bd962a9b0a88,Commercial,0.6642607544408382,47,21,340,584,244,40.6511732722846,4640
cb5b4f5a-f74d-41ef-a50a-b0d80e10a893,Commercial,0.18350541341937987,44,18,479,1221,742,44.75121177919075,6447
3352032d-bf7b-4209-82e8-f8703310e624,Educational,0.04832224290004761,47,27,168,735,567,46.3394002153398,6141
7fbd7b3f-9bd1-4576-a33d-22ed5b809b1b,Residental,0.9043571643645208,28,14,334,718,384,75.65740834192626,8348
d23e9f29-9c93-41e3-9bb1-f5d583219163,Residental,0.37960847171770384,41,9,492,531,39,71.46234592625325,7749
b13a05f1-0a14-4ee3-8beb-33ec6491db9c,Residental,0.3424339180466861,30,45,360,1280,920,53.161837316057394,4776
0085abdf-508c-439c-826c-8b0ad131a72e,Educational,0.6711583842230656,6,4,599,781,182,39.082416615904194,9886
23fdc3f2-3e63-402b-ac96-77da7f18e9cd,Educational,0.9554061589886804,31,15,491,948,457,49.04217104390477,4203
b310102a-cac7-4cf2-a048-5f4132addae1,Residental,0.5391635873210867,16,13,693,1093,400,42.831618007985114,9701
f3fa9332-ad05-4075-9ec8-fabeeb81afb3,Educational,0.6168374400212474,20,46,607,809,202,30.33848421657785,5308
0fa89cf0-5cb9-4d1d-a236-2575aceb6bd4,Educational,0.9046535338815795,18,27,82,340,258,55.285541613691606,1001
cefef002-ca78-42f7-9310-c7b61d7ec938,Healthcare,0.4771170506862821,40,22,4,649,645,88.25892308840737,4521
98f77b71-91f0-4151-bf9b-c4eb5643877d,Healthcare,0.1048458275045615,24,40,361,573,212,82.59332852507376,9802
b1e247b8-6635-4c43-97b8-3b2d563dd762,Educational,0.15277341835472447,7,7,636,1229,593,88.78665280067385,3324
2a1c617e-5ea4-4eb8-b611-8d8b37d409eb,Educational,0.0005526188496924878,49,13,615,1064,449,17.007260289749894,4064
9ef1f59b-9d00-40eb-9488-b8d2dd1125e3,Educational,0.2958342628438435,26,33,462,1355,893,97.61164285437006,6893
0936df59-f4b7-46ca-93c9-6a07c863f307,Commercial,0.9868599465432295,1,1,454,1055,601,76.07573116983575,1236
9cd22a3c-a6a4-4c28-ba92-6ebe4616ef49,Educational,0.20647984321462376,19,23,576,794,218,49.23201929160715,9540
12462ebf-491d-435e-98ad-4556cc945d82,Healthcare,0.760166861016957,29,18,703,866,163,31.730417839329867,3483
d1cc1f2c-59ec-4192-b86c-9732987a2329,Educational,0.10156659643785848,34,30,715,1337,622,23.325449284292326,1892
313fd670-368b-437d-9758-c00f9f838a06,Residental,0.8048166722958402,23,47,245,434,189,53.46978597434965,8569
23157be0-ec76-4e9f-a444-ff9cc26e50d9,Educational,0.1117969215447443,25,4,416,934,518,59.2278320977725,9239
62b819cf-be23-46f6-acc8-df685d6eddfe,Residental,0.3629889453091334,9,36,245,1240,995,26.934773645793634,2746
18c10155-8452-4cb9-8e61-16e393a4e0c3,Healthcare,0.5532411701062616,32,36,487,1025,538,70.13947576573486,2951
7aff1b80-2e3b-4fb5-9c82-8b42b17a619d,Residental,0.8259375886685012,25,41,180,614,434,47.360106896873475,8439
8cd551c1-8f27-463e-a681-a90f52b034e5,Healthcare,0.37633181067637345,5,48,269,462,193,23.994809226937498,7772
297b496f-2125-4e53-aace-8e313f116c89,Residental,0.09960630339029353,44,9,624,1263,639,50.002532940793365,3442
5129de12-596a-4f62-aff5-6e8dddcccd8e,Educational,0.144497837778499,29,1,317,328,11,67.07120949222103,9949
1c891ccc-f7d9-4d8b-afbc-c09809642587,Commercial,0.1909296927906995,3,38,145,237,92,25.902559000781824,7981
3907583e-cf73-4774-95ae-7350f72c34dd,Commercial,0.4923755230311402,42,13,669,1408,739,78.23796460852763,1875
a953da5a-d7bf-428e-8d86-6416f8c8c673,Educational,0.3600767168173187,26,50,135,929,794,64.6592447656341,9722
81257e87-991f-45f6-a7f0-adaed2e6c81e,Educational,0.5508632685107596,6,27,50,172,122,70.46211194051122,2982
0792b267-2dce-4440-84e3-668c45901667,Residental,0.2603425242668238,28,19,499,584,85,84.29418621940931,8620
5453af22-70ea-4420-b377-e7336311e467,Educational,0.23094102672899708,46,49,186,769,583,31.86989098134974,4394
9e033ac2-da04-47c0-87dd-cf38d56a262f,Residental,0.9080694280299612,5,47,39,1383,1344,38.36969259521751,3026
55be0cae-06dc-4759-8974-ce777b30493a,Healthcare,0.6455238873314729,18,7,320,328,8,76.55900659142777,2167
fbb19290-f468-4a9b-9547-003a1161f45b,Commercial,0.14458623494895917,39,43,389,824,435,72.75141269950055,1326
7615230c-8612-43b6-8231-5cc207f61edd,Residental,0.8807740942576467,16,13,114,302,188,41.801719546514434,2796
92ccba8c-e041-4d0e-80af-cd236a32d88c,Commercial,0.4491412743024277,30,26,585,893,308,96.84828802842087,8693
24cd9e5b-3339-491e-a84d-12c283870cd7,Commercial,0.8068155678029265,43,44,206,667,461,14.621482739256646,8147
45ba0ed5-cf02-4aae-b01d-3d925d2cdb4e,Commercial,0.7284166958021054,24,21,604,1383,779,63.90352812044157,6715
5e8c6d85-4b22-4ef5-a53c-3ea6fb5cc0db,Educational,0.6964052564569752,41,19,25,994,969,45.80549018965693,1016
1ea96e88-44ae-4620-b9df-ed73a313a316,Commercial,0.009868546242353338,39,30,514,928,414,30.249956865877454,2573
ef60d069-0f6e-4ba6-a3a9-b2c5e0ff9ba6,Residental,0.3867618601949371,19,48,109,715,606,14.45920043911603,2808
b63ba670-b236-4592-aa45-edd84a39e75e,Commercial,0.5206617059838206,26,46,362,378,16,82.19712083880306,3124
e7567b8c-4898-4c8b-9383-55b3d71b1d63,Residental,0.3750150434960158,39,8,385,1002,617,29.125525456403,8741
6a66c960-bd5d-4519-a584-eef813b6cd3e,Healthcare,0.900085150437712,8,31,82,411,329,74.51313240649178,2821
398b5dd2-1f17-45fb-8502-50b458ceb56d,Commercial,0.4363638468535669,44,45,98,555,457,19.218911949059127,4659
50a1e618-cc49-4eb8-b9b1-ee6f1ffea0b7,Healthcare,0.5844083907145721,17,28,114,1317,1203,93.55640844979496,5580
089ce59e-e3a0-41f2-8ac5-7e6ac6b22f5e,Educational,0.07555644481298007,5,2,193,290,97,29.795287002423542,5434
b55f0595-a52f-4643-a47f-5daf798e7f80,Educational,0.08325621444025166,29,37,273,782,509,39.38718138509063,8641
19fd57ee-0f34-4d0a-a06a-67256ba4f5a7,Commercial,0.7530087593067832,22,20,84,1355,1271,45.32439376666651,4425
001744de-8211-42f8-9a53-3ecc3254b46e,Educational,0.2330638666062197,46,35,48,458,410,62.97096956183411,1957
49dbe887-5767-443f-8c99-41bcde87141a,Residental,0.8227472529236768,2,34,390,1015,625,51.17293655521223,6983
764cf9a1-b97f-4255-97ba-499e3effe762,Residental,0.7975888108892153,34,37,345,782,437,30.789939683726693,5194
5dbed2ac-cba5-4729-8d6a-54eb1f72cb91,Commercial,0.6303812323296766,20,5,543,723,180,78.0728644328043,6056
42ac36f1-773d-4b3c-b8dc-d495eb489bbd,Healthcare,0.6157881127249826,2,7,700,1415,715,64.7540651462051,6048
58538cf9-33e4-4c83-ac06-3b0230d5f239,Residental,0.5310669634516033,4,43,690,1227,537,39.66853426288695,4540
0420d87b-7c6d-42dd-96c1-6bb0d9426a30,Residental,0.879479153574728,46,19,588,1222,634,69.61835379727965,9400
06d7d33d-d957-44c0-8c98-f8a5a0e21e21,Commercial,0.6204593772589441,21,13,136,1278,1142,51.42778424770064,7358
3f9015c2-db88-4a1b-8561-fee265edeea5,Commercial,0.012834247659613496,9,7,244,604,360,56.09823937260681,2788
a9221371-8d09-43ec-9337-d0fb3aa7d690,Healthcare,0.08130473849116593,48,13,445,922,477,50.38926909585316,4378
e58f2f11-3e85-4930-ab43-2c0ad4ccd720,Educational,0.3502491261588263,18,40,316,379,63,41.629358738636654,9505
b0add585-59c2-46a4-8fcd-9cfa62d09a41,Educational,0.07584100536045224,34,34,385,1201,816,26.38435637055153,6752
4f5e07ea-20dc-4844-a9ed-1ecb3cd2e4ec,Healthcare,0.5535903305972596,13,44,508,887,379,48.53522700150073,7034
b3e961b9-16bb-46f2-a72f-76588c158b92,Commercial,0.8656085418204621,34,41,465,1261,796,49.05766358814854,8647
af462904-aa2a-4973-a2ee-8993d08e0775,Healthcare,0.817253652420553,1,39,477,1332,855,25.301716892148296,1299
7a9753e9-bdf6-4fe6-9555-6a659909495f,Residental,0.5580896790958634,15,49,109,144,35,83.77934688313903,6681
e1e7032e-6122-4890-88a8-e4b163fcc184,Healthcare,0.9021428968253151,13,1,157,1081,924,61.065716192968445,8703
2b8216c7-91b5-43da-aa6b-7debe2006818,Residental,0.5774196475279784,11,18,258,506,248,48.414651826603745,6551
ba1a582e-0007-44bb-b488-a4c7a0b17fed,Residental,0.9500690900386018,48,36,640,769,129,92.91420392911994,3984
73ebf203-2d54-4516-b771-a43f3aa5b194,Educational,0.7797590396106446,18,22,447,562,115,33.45385603265906,6675
aacc0e5b-8602-47c4-81ec-51d50ee323a3,Healthcare,0.704633157900506,28,8,82,923,841,85.73900864148175,5701
4d9f3824-aba6-40bb-877e-dd3f72d697af,Residental,0.34366277865180805,40,3,14,540,526,45.33610403929225,8567
3e49157a-ee11-42f7-9068-be70fc34235e,Residental,0.7265381467735259,15,27,446,661,215,56.69587294133089,1069
8f537c82-8c20-4279-b6f5-8877ca61d1ae,Healthcare,0.050902027443622155,33,16,134,513,379,93.22381194392064,8060
bb3d15f1-c86e-45eb-ae97-2ea0269a66b3,Commercial,0.3579028901898178,34,26,307,1436,1129,99.85351424856188,6071
c1b93699-46e7-4801-a35b-dc2468416da7,Educational,0.482037183075277,34,27,34,389,355,81.4436312199368,8846
24e83ce4-ab6c-4638-ba37-6a7a8c1e4f24,Residental,0.10792254039495697,33,6,457,638,181,25.97224538932128,4508
b6fb8181-2c48-45a0-8744-903628949875,Residental,0.10540910747926768,23,47,520,1164,644,91.6684248098031,9106
024cfc48-3518-4ab4-addf-35604cb03f76,Commercial,0.5621320238110055,10,38,186,506,320,93.85414572919491,2659
85131cb6-920f-42da-a3a4-8f242ca6b371,Healthcare,0.3039375833299355,35,1,127,1138,1011,29.112899183723787,9526
67e2067a-e958-40d1-a075-8577629b5da6,Commercial,0.28775716813205987,44,14,315,933,618,31.514414596481732,5047
fcb9ae5a-a173-46ba-9484-dfad544b682a,Commercial,0.29749285519916,46,19,271,981,710,87.59825365838918,4746
bdcd2fe8-693a-4975-8ecd-b3d0bf1e86c9,Educational,0.46169902322687273,25,31,88,548,460,36.20847355415145,3815
92004eae-439a-4d14-8c84-2217387f682c,Educational,0.7964138263786898,15,18,471,903,432,71.75333555798235,5681
e98cdb42-f9db-43c8-bf95-94b52d3e7190,Residental,0.12803582443116612,48,29,627,1056,429,58.15478798743827,3930
cd5a4e22-ef23-4bf9-8e13-51728d3c1610,Educational,0.6270737333554998,7,13,310,410,100,46.00018539585976,7238
58e02888-c46e-478b-8d5b-2cc40b626133,Commercial,0.6184119626973944,2,32,346,1103,757,12.158268547626095,5999
998d8eff-e26d-4c12-9c4c-c935a75f657c,Healthcare,0.9441285417299328,10,36,299,419,120,44.38169686877792,2981
637c4f28-33ff-40f0-bd0c-9e749b31099f,Educational,0.41892108991113897,20,44,12,229,217,23.686243878874627,2684
fc2ab45b-1890-4671-9a2c-d11b8217ef81,Residental,0.5464888921434923,46,24,163,1391,1228,58.553402503427485,5566
a7a2d691-5652-4677-9d57-d23d7be7ee4c,Healthcare,0.27553474892288154,29,35,595,1190,595,17.35981870693065,1186
4b8b1df4-a99a-465a-87c8-9a68c9a879d8,Commercial,0.32255481718562196,6,14,385,628,243,11.638656999892468,5254
68000e70-8193-4fa4-8788-016a904c09bc,Educational,0.504346904887977,18,17,527,736,209,16.758085283907025,8637
c5e608c5-b803-4248-857f-b27e8be5596d,Educational,0.5468236563965627,12,36,397,1438,1041,78.83079295556443,9998
1caa7cd8-453e-470b-b386-520540fea468,Residental,0.15001970608297122,13,6,34,430,396,63.53651339007503,4267
fa482f9a-d018-4995-b505-dd3ae0723f72,Residental,0.451237632411975,29,39,382,1280,898,12.145881205597984,5659
97667113-c524-4bcb-8cb2-61dc8510ea67,Commercial,0.20580095289273692,12,21,627,1233,606,80.7831967144383,1604
c914d467-b18a-4317-9f91-1bc9c31d3b56,Healthcare,0.240032610169862,20,3,28,1091,1063,34.456353010218294,3454
625088f4-641b-4498-9838-2de2c8de69d9,Healthcare,0.9640818181372576,31,4,267,915,648,53.710351080646134,1740
79c98c50-0b73-4a33-a6c9-32a6ff32b91d,Healthcare,0.686342575755377,37,41,57,85,28,42.330177579911144,1747
5febf2a5-d6ba-4edf-8cda-446adb9b90e3,Residental,0.6568074239342757,5,36,541,828,287,37.38560706816746,6186
3084dcad-c741-4c2a-bc6d-36686766a819,Healthcare,0.55436934596709,1,30,220,963,743,58.18099651814942,5577
33bab775-fe8b-4556-8588-b71241b62487,Educational,0.8844937361758289,24,45,451,648,197,24.82404471160794,6903
b3d049ec-17e2-480c-9d56-d6b417d30f2e,Residental,0.42036270420209076,13,4,553,1025,472,91.5830200114341,6036
cfcdc56a-5cf3-4ee1-aeb1-16f94e74f70c,Healthcare,0.6300580712516163,16,24,118,1359,1241,78.19765062820385,8345
819d810d-3086-4749-b160-30418fb51aab,Residental,0.028359955237010626,15,19,493,895,402,22.65973359526622,2136
2d705165-c80a-47d6-8927-9ff365108b1a,Commercial,0.00843013687774019,13,31,507,1356,849,34.95624297212815,5579
d8552acb-bee7-42f1-b451-b771187c21cc,Commercial,0.06395973740032546,6,18,511,1009,498,53.339082619179976,3433
7d6548f6-d677-4adb-ad65-ad3833857d4a,Educational,0.888597231913564,38,40,355,816,461,13.396114771258683,1497
bbe1c106-024b-44c7-9b04-585dd0c5fd62,Residental,0.24685934157932388,27,21,359,1319,960,44.167098437898716,7692
a22db4b6-f9ec-4566-a4f3-4f52531a7c43,Educational,0.7183510650927847,22,19,89,606,517,18.339044146028147,9744
62ac2f39-7904-4659-ad10-1cdeb8315066,Healthcare,0.9657202864040445,43,8,160,172,12,96.39665217645086,2372
20cb414f-433f-46f1-a976-75a9549e78da,Healthcare,0.36323048086174003,14,9,325,882,557,51.12072516079031,3440
4174f6d4-48af-49fc-b974-5cd238d8c460,Educational,0.9733909751279001,41,22,140,189,49,28.542481754321106,8800
d7add94f-8c5f-4a2c-83ba-1e66dabd7881,Residental,0.5086040557479975,41,46,197,238,41,36.02694271089243,9836
5fe6c75d-6937-4088-88fe-e2106b63e97a,Residental,0.7268196687581655,1,41,20,905,885,51.39232395337317,7662
45e847af-2283-44be-8a39-f1d108542f2e,Educational,0.2813317745873707,15,16,473,807,334,59.32616311469139,9832
7c70b307-d5e6-4d67-b8e1-3af188258848,Healthcare,0.6324385149298509,12,47,666,1078,412,80.05519715835642,8727
8a311799-c552-4a1d-b190-f46f1d727007,Commercial,0.4917655370616518,14,42,230,292,62,58.29735481949877,2966
e0d80d83-0f59-4b32-a65f-a470dc87dedc,Educational,0.5033669696215269,29,29,69,735,666,82.91737122607405,1183
1b5b98f1-bb6f-43d1-af90-1adbc177a525,Educational,0.43189774976798345,30,23,360,635,275,16.517417020628717,6913
ca349768-b203-4e62-a32e-5ceda29d4b38,Healthcare,0.23250101961171077,50,15,248,654,406,95.66720892271803,8705
e1311fd5-3530-487e-a311-c27850d4a179,Commercial,0.8620349894443391,13,45,156,234,78,27.973221615277836,2786
d8ab6fba-dbf0-4ba7-bbac-110c58bdd0a9,Educational,0.5875400200208853,7,6,552,850,298,59.14490486331319,4952
bd47dba6-6de5-46ab-9894-540f9fbd95f2,Healthcare,0.22623928212492306,23,29,594,893,299,96.25496712549632,4673
1071613c-7659-4a72-be47-b5d4cbd038f0,Educational,0.7430048648725078,38,34,457,672,215,60.27317277384348,2762
d0bc2175-ea8d-4b71-a44b-3004c1c4342d,Commercial,0.3639744763377689,49,8,267,909,642,17.5760869335152,8913
5644a2c0-9e67-4e5c-9904-57132a464063,Residental,0.03709334209804982,7,15,587,1345,758,89.2770620882057,8990
67489af4-2515-4236-bac1-192a6eb840d9,Educational,0.09703571330218097,13,18,618,1291,673,29.443928648947846,7003
c4ab2428-c959-4115-963f-223f48118223,Healthcare,0.02062396379091591,10,26,73,1011,938,49.83748475325154,9566
cbfcb231-25a9-43b3-8c85-dd5479830444,Residental,0.9266190425176444,29,29,644,1068,424,86.63151038319742,7895
5475da9f-ee17-4da6-8468-065dd9570b27,Healthcare,0.12172872697672521,29,17,510,1258,748,27.310697484919633,9548
b5d31efa-beb5-4e39-b9f3-6572b84d6b0f,Healthcare,0.1340557486219066,16,49,90,1064,974,37.048364014895995,7538
827c260a-82cd-4753-804e-fa78debd47b6,Residental,0.24554049680051693,37,14,113,227,114,50.968050509749446,9153
9f9fabac-dbad-484e-b6f6-8d3abeae7b2d,Commercial,0.7066225567184108,16,16,527,794,267,32.001992961744385,8035
d73f9608-63d0-4a91-b519-64bd83746e2f,Residental,0.3465971001633459,36,41,578,684,106,17.289154100101328,5986
699df23b-0d03-4f28-b41d-e698569610e0,Commercial,0.6111278279463891,31,10,117,1076,959,12.358874123206338,2446
50f4cf6e-84d0-48dc-bab2-e0a4744dd444,Residental,0.35179575546636943,46,43,697,1056,359,66.32575776948768,3070
19dddffe-d0f7-452e-9cad-f6fad4486af4,Educational,0.7874969918527003,4,9,605,1095,490,59.52625659570008,3792
f98526b1-1c7c-45fb-8744-b42dd126e55e,Commercial,0.167158610380312,15,31,701,726,25,59.92770912218903,2541
311790da-7681-49e8-ad97-ee97c8ad1cce,Residental,0.3721756306821733,16,29,673,770,97,29.891003809153677,1549
e7c89890-34ac-4d38-9ed3-92b82ea1497d,Educational,0.4838640709885851,37,42,90,227,137,78.34151615249841,6755
4a16b116-16a4-4b70-b778-a8d66ed5a866,Commercial,0.6799054050175517,18,37,132,254,122,48.91101858028467,8860
384e1a06-225d-415c-a419-9eee94159e18,Residental,0.22075003514144564,8,9,13,499,486,70.48815698632993,4394
5b32c056-689a-4eae-907d-c48b7c9de9bf,Educational,0.3575037691720694,7,25,110,512,402,73.75659693463284,9607
a9703359-e8bb-4fc1-a77c-befb83fdd0d4,Residental,0.6024091005720931,47,19,75,599,524,22.38955017933444,8353
b476b4c6-0cde-44af-9008-4ad2d851ce37,Commercial,0.7730891486523153,28,23,349,838,489,43.17355934076498,9200
462f1723-eaa8-4d29-a48f-11d83211540f,Commercial,0.013573953371707859,31,34,468,688,220,22.404221969001163,1003
67223d80-6cc3-4a11-96ce-36a568c1c0a6,Residental,0.4348504952967487,12,17,579,672,93,21.17623220020471,9548
0cd23ed5-73df-4f72-8bbd-692af7a91892,Residental,0.15868068271744484,26,31,513,935,422,41.768476439643706,1273
779453e6-a4ad-41e4-8322-f729171887a7,Educational,0.8248996657523697,28,43,689,1369,680,82.15614240078735,9301
deeeaee5-10c0-4496-b764-87e8fa0d06a5,Residental,0.8390396182217358,8,27,394,1409,1015,93.45029936485608,4139
6d9e7842-8423-466e-a440-25d3020b54c5,Healthcare,0.9761070882366112,49,34,448,946,498,56.58327765535635,4791
185b9e85-6ea9-4ead-a01a-43009f96be29,Educational,0.49909767585305254,9,32,555,1007,452,84.25576639168136,5667
62cd11aa-453c-4ea8-9bd1-4efa8198abb7,Commercial,0.9329378118763877,40,8,429,1434,1005,10.051349917288999,9601
78734423-4724-4c9f-b2c8-0aaffd22670f,Healthcare,0.5659931887754446,48,38,556,968,412,58.84931060019568,9691
d2855c97-caa1-40ef-b1db-37b1e273b850,Commercial,0.4720173375767168,28,9,173,1037,864,43.60483393550076,1440
ccbf2cdd-7693-47a3-a832-07b5232f2ec9,Residental,0.7524819873805392,10,40,277,982,705,83.99257236901518,8859
51b51820-84eb-4ce6-a6f4-02d0d6ce7089,Healthcare,0.39403386539873475,37,24,673,1331,658,94.60590464088503,6073
5d91fc55-deac-4115-81bd-745babbf8dc6,Educational,0.8262661423106528,20,7,480,1230,750,71.17804094399625,5890
c5ff507e-e036-49be-9be0-7aa210d7613c,Healthcare,0.5364729398603134,46,23,173,811,638,78.06784088541832,7677
1b0719f5-2209-4e45-9564-d33994010ecc,Commercial,0.739594925503079,18,21,31,1324,1293,13.71217802879811,3193
3df93074-8480-4558-87ca-8d32f120b4c9,Educational,0.9744633862892373,38,9,237,1051,814,14.457345743837692,5303
24dab935-1de9-4a79-a46c-238e16406af7,Healthcare,0.3448871498549676,5,49,276,438,162,54.71028521124366,9043
c3ee28f1-5177-41f0-9bd8-9969fb94b132,Educational,0.893567044451546,5,49,418,495,77,94.53232070050883,3924
efb4f8f9-8fc8-42f9-96cf-d23a38f39e45,Healthcare,0.3359505576818512,19,5,481,1183,702,22.497904274951047,6278
db14d9ca-8fee-4903-960d-01ea1b0a5ef9,Healthcare,0.5647731419086026,39,48,116,235,119,59.845506739578006,6837
2dd220b4-02df-4d91-9984-8c91186a612c,Residental,0.9082413570159782,19,43,41,680,639,51.76536769841084,3851
8e300b03-a8e6-42bb-9d89-25078f2fccf8,Commercial,0.6942075205126781,43,13,700,1216,516,36.52929215405068,9870
90058b5f-095d-445c-a48c-3828057968d4,Residental,0.8062633535507258,50,12,271,1119,848,34.699129145303885,5214
6325a601-e6fe-48dc-9abd-884d699dca76,Educational,0.7678480136639214,17,9,477,1016,539,29.269021686042638,1065
e9b31eda-8f0d-4127-b06c-6ac6fd1387f3,Residental,0.826907900495128,5,39,453,1361,908,37.777864110120845,9850
8e029298-5e5f-43b0-b701-5ee11bf1d3d9,Healthcare,0.016147447153392336,30,43,220,436,216,32.94946320276851,9502
c843b29f-39bb-4461-8875-103a9826129f,Educational,0.060330157954794794,23,28,476,547,71,30.876776652673065,5903
5c7f6128-4184-4dec-89a1-065736ce4bdc,Healthcare,0.9340468227161934,49,34,425,1114,689,38.25121346760217,3187
ad6d74d5-928c-424a-a648-1a7bc3ab3985,Residental,0.048559030950920956,50,35,66,1003,937,51.63639405295448,9201
ff297d9b-9277-411b-b802-975adfd2d8c5,Educational,0.34780190381455345,33,4,68,1071,1003,25.49095963377499,6553
d76d1592-0e2e-4f6a-b8af-e208e14ac321,Commercial,0.3803162275252856,32,22,499,1328,829,28.608972993390978,7322
8eea56ec-ab82-4e32-936f-27f9d7350dbc,Residental,0.0049073957685176195,5,11,203,1185,982,87.4751427891512,5973
d1bd6921-0084-4fff-a07b-f7e909a0e34c,Educational,0.14025556751511792,12,5,104,1281,1177,62.5638781358107,2685
f64f9893-7ce5-455a-8e05-241ac66fe6e6,Educational,0.13443182684105737,34,27,696,730,34,75.007716349617,7966
3a5dc76e-cb80-4c24-8f8e-45861746a76e,Residental,0.436317051231244,17,33,367,1419,1052,10.272626402690051,3291
4d9f966a-6ac9-46c2-a6dd-64249c2dab05,Healthcare,0.013190058095321477,42,15,215,1291,1076,51.99648383180719,6260
b0d05891-db7b-4249-adc4-9b0a97923871,Healthcare,0.09689148941772374,15,19,363,902,539,79.03975008990095,8452
aad50c01-7bd3-44bb-abd1-a5e2c213d800,Educational,0.5359762085950197,34,36,358,1040,682,49.36424751608403,2836
72697257-8872-4433-aa70-698b76867bf8,Educational,0.2024752879010112,26,11,356,510,154,82.54525395520017,4342
f282a0b7-dabe-4ff8-957f-338d59446af1,Healthcare,0.750649239968962,44,25,167,710,543,68.41109579307842,1894
372afb8b-8ec0-4100-b93f-039e8745ab85,Commercial,0.869602479170199,34,11,633,1200,567,38.37503155374306,8827
f0760547-a3b3-4821-941c-bdab05a73af7,Residental,0.31555989603509305,21,28,238,1065,827,23.860491203856974,2530
ee2e1a63-eac8-4f18-9eeb-038444574ec4,Commercial,0.14340063964288674,29,36,423,1081,658,72.80837906416603,1327
fe987a8b-763a-407d-a762-ff294a760888,Commercial,0.15674637674721936,39,25,676,1168,492,83.3159591294101,8791
fcd47183-1923-4816-8d9c-c55c0c1aa84b,Healthcare,0.8984523284506022,10,49,16,1062,1046,98.94636641988437,1000
7dd609b2-c0fe-4be7-8be3-916eb13c8967,Educational,0.10882339985282641,45,10,555,1392,837,21.358330110900624,2756
b81c8f1e-26c5-4667-8f87-5631869bda5c,Educational,0.9428455561072914,14,44,529,1057,528,85.51699232708545,4429
5a49cff1-4c80-4b43-a97e-07c530722bcb,Residental,0.6190885467272126,26,14,495,599,104,34.29754503086761,3977
bf727215-b53f-4156-a6b8-4eeb448479e8,Residental,0.2890573030106507,48,49,617,1358,741,57.34485580128993,3905
6f0234c8-4bae-4f04-9767-e62f01424170,Commercial,0.9092816797244324,8,2,577,1042,465,10.790855196291622,2680
7cd35a01-8240-4056-ba00-0cdce2d5e1da,Residental,0.6669796094386597,50,35,673,972,299,90.17599306155279,4513
ecb331e6-f846-4b9e-813c-954b9a69f92b,Residental,0.9709644680931822,16,50,420,919,499,91.52969857894334,6041
6edb7610-70ec-41e9-8bee-304a8f49feb8,Residental,0.20995431253514174,2,25,110,316,206,66.68132875497106,8105
b7810965-246b-4f37-91d1-17da26c8a6fe,Healthcare,0.7231107176715206,48,48,356,477,121,33.59320816836887,1643
cab0d7c0-8e98-4365-8532-c104ad7fde9c,Residental,0.5152599648671198,16,43,195,984,789,45.39888340560011,8074
7ec7b09a-d526-46e2-9203-c8caec670a3c,Educational,0.3370234432534278,23,11,584,1054,470,74.1227856959875,7709
c509dfa7-1d4f-499a-8e10-68795594de68,Educational,0.40370541778459523,4,30,347,453,106,32.80642123710806,7223
0976c074-776b-420e-acfa-8ed7151264c1,Commercial,0.12052236304526098,22,16,443,1319,876,91.72248931489375,9301
6e378e72-7554-4e66-984a-341f2d185197,Commercial,0.5388200122679708,41,41,460,1422,962,24.231480337819345,6880
17eaa66e-fda4-4699-9814-4765c22d23f4,Commercial,0.16679532956301069,37,49,694,701,7,33.13384383658426,2692
46089030-6970-4269-8441-d796c6e3bc93,Residental,0.24879123666476477,2,45,706,1091,385,55.04559695406601,7047
5612d59b-4615-465b-9291-cccf7ef33650,Residental,0.15172454642155464,4,23,225,762,537,79.82002429711345,8505
25909981-7821-4adc-8e54-cfa902f14090,Residental,0.8858470156626932,31,6,691,924,233,77.52206488530075,7404
61cb34c3-6089-46d5-8387-bbd5cf375d43,Healthcare,0.6904097115408349,14,27,664,1109,445,31.478269265191802,8104
f1e7d89b-5fce-4ab5-b3ca-4bd6a19ae292,Healthcare,0.03151563858511297,49,32,161,224,63,76.37668972282341,5827
6fa0f371-3851-44ec-b3ac-38130725f7cf,Healthcare,0.4175288736466818,8,8,578,1263,685,87.90882725207132,8716
3cc2bafb-a9c8-48e6-9f98-bcd23d038d92,Educational,0.5817599284922351,29,42,439,701,262,75.01166976932403,6092
c846e01c-5f3d-4191-90ad-a93d0d731174,Residental,0.18214551572785542,7,45,674,1331,657,58.663150085966095,6743
909d9ceb-431e-4d77-ab12-9daec1605a48,Commercial,0.8106631523678919,3,31,402,871,469,57.2449213879152,1269
c22b7feb-087a-40f9-a6ed-fdf1d2e670ca,Commercial,0.7509920668857247,14,4,290,599,309,55.0896359683494,9129
77c068be-3922-4896-aecc-5cff8597e853,Residental,0.05224921746362221,50,27,591,1368,777,98.58108282665897,7145
48d87e52-e1c1-42a2-ae2b-61c2ecb08427,Residental,0.8593326981047358,23,4,82,498,416,45.83076264546725,6067
c411ec28-183a-476f-906c-2340f6d651e2,Residental,0.31885043878363906,47,14,47,1052,1005,57.66662628946847,6595
c2334a40-ac1e-4936-a6b5-fe4d45718cb3,Residental,0.8459052712250289,17,8,291,401,110,98.77856822350356,9145
df82da55-d323-4863-bc49-e57b963fb69d,Healthcare,0.5229374058855791,30,27,562,1204,642,59.49985125406349,5350
a7810f0b-efc7-4f72-b5dd-520b70cc4c25,Educational,0.8786389224157235,3,42,158,1039,881,98.84731150510765,1278
e0c9fb47-f4a6-4167-8712-db6e4f58bfd6,Healthcare,0.578171488876542,3,42,102,1228,1126,88.1417218998629,2591
a0989697-b071-4c2a-b294-000898093bb4,Healthcare,0.3263017461026486,49,20,632,984,352,33.05836629353993,7757
5e0d2a2b-20fa-4cab-a753-ffabb99bd2a2,Educational,0.824478775488019,43,48,386,563,177,83.9844847327347,4602
71d48221-45ca-4479-9235-65ee51f97d39,Commercial,0.9696793603794323,34,3,132,1035,903,19.74458520626812,3816
4c781e58-d245-4ac4-ae3f-1fb3b5b917bd,Healthcare,0.15629706675566746,35,16,290,896,606,61.99990618366463,3777
c8789a10-0fd4-4bda-9844-ae49f174f542,Residental,0.6553560494105295,39,15,624,835,211,47.16779870376438,1894
dd90a90e-e061-4fd4-9370-f3b99d317b95,Healthcare,0.7224683858985804,33,4,517,958,441,27.079942292128322,7548
7f27efe0-c117-4cd8-96b2-4b5ec5728048,Healthcare,0.5623914755092462,11,44,330,601,271,95.01258068907003,5802
ed297a40-5e1d-4320-9b34-4d5eb4cc2335,Healthcare,0.5254961254794841,46,4,151,422,271,96.98701220556548,8185
c03bea90-ebac-4ef4-86bf-4c9f13ea577f,Residental,0.41804418567918133,5,24,137,1197,1060,43.06759329206054,8935
92147f08-843e-413a-b42b-5a6d0dd828de,Commercial,0.7423101857415817,21,23,196,1204,1008,73.81839204108604,6062
dbf25af9-3498-4051-861a-7f8b269600ca,Educational,0.958256464942101,39,32,270,354,84,55.48087562672674,5272
cb0fa10f-3e3e-41ac-bc8d-e52bb55fec79,Commercial,0.9305119076017327,30,30,593,825,232,86.12725327089906,1584
9b0b77ae-e34c-437d-9a49-c15a5c3dd9bd,Residental,0.044959330080038495,19,46,607,1310,703,93.13540615790843,2993
4b0bec50-2412-4d92-839f-26df2830fe2b,Commercial,0.7572427004697119,1,15,634,1065,431,22.835758134369684,4109
75b361e4-c841-4276-8eca-d4daed69806c,Educational,0.5471128618345754,17,23,205,1261,1056,58.29288293181978,2853
575d140d-5443-4b49-ad4d-f0bec5c332e8,Residental,0.16056913430895992,47,19,452,1187,735,85.90957878538494,4960
8db35509-2cde-4a1c-ada0-e21f0c27ac9e,Commercial,0.332633891850844,6,48,124,1179,1055,66.2764446103138,4866
96ac852f-8e81-443e-b3ad-fa55492dba8b,Residental,0.41586592681331314,24,22,8,1120,1112,88.1644416793928,7089
f3faedc1-aeaf-4c01-98d7-e9be44057305,Educational,0.9845085692551757,14,5,273,592,319,14.152964197706009,5659
4e1c1196-c44b-4fdc-9857-a90ac7824b2a,Residental,0.9000503610575572,23,49,459,947,488,96.90602790300787,8249
ecd97544-aad8-4e3b-82fa-3f050670fbde,Commercial,0.7708306434976608,40,4,625,687,62,22.71395278334769,1584
43025008-eafc-424d-8c7d-6632f0d38421,Educational,0.9397743068484398,29,32,227,1121,894,87.6362071972739,8405
19162e8a-bd00-4a9b-92ad-99278cf11ebe,Residental,0.7513609342167166,23,33,191,596,405,77.3115463374606,8594
b995784b-8d3d-4c3e-80b0-d5f68cb56173,Commercial,0.45829950294467947,35,44,593,1383,790,39.4021890281565,4745
8b2767c9-7cc3-4858-9972-044409b8a35a,Residental,0.05442132525176879,50,38,379,670,291,46.578471942925844,2309
d24dd966-ced4-4e36-9932-fe36adc1f52f,Residental,0.422117251914656,18,2,359,1291,932,46.84571616005725,9162
73762509-28e9-4be5-acb0-c93bd7033b95,Educational,0.568016585792095,34,17,290,392,102,71.26011424627421,5879
5feb2134-122f-459e-99a9-e491d6db835f,Healthcare,0.000966017635377292,44,25,605,1432,827,47.17818779859796,8614
69148d39-84cd-4927-ab3a-5699cc9a4847,Healthcare,0.27865864083510217,23,17,288,394,106,15.158000667201463,5639
003856da-caa0-4a02-bab4-56723a862600,Residental,0.16480603328792742,45,33,349,806,457,79.6494342684824,5029
d08e51a4-7843-4a39-b681-7fd65f9610c7,Educational,0.21684930241758005,21,42,550,856,306,89.9208520543411,6429
f6cf3e2e-abf2-4e2a-aa70-31dbb027430e,Commercial,0.0228628972780478,24,38,529,861,332,69.48107913737152,1882
1c790f1c-d1be-4afb-a6de-35d26359274a,Educational,0.8302412138967556,30,40,611,955,344,93.55854724360266,6299
fcffb60a-b97d-46fc-adb5-51444f9f7b35,Commercial,0.8455818253517389,20,17,261,759,498,92.53599112275316,9951
c4e4f0b8-132f-4f7d-af20-4ff4750e24f4,Residental,0.23933867853989121,26,19,564,1203,639,27.715287027675185,4702
84f8edd9-932e-493f-a47d-a58855477c07,Commercial,0.7120322386434913,16,37,613,1081,468,78.80742821126785,6392
3eb4f9ce-33a8-4cbe-9c22-5673eed29e33,Educational,0.8177335829315631,4,40,289,654,365,49.0897580114754,9709
3bdb0933-16d0-4665-8445-92532a3fdf1a,Residental,0.6511205492419437,13,42,705,725,20,38.90089387799607,3335
01ac198a-138e-41f9-a43f-78ba30a03b3c,Residental,0.6657664184436749,26,26,607,854,247,51.659289904693416,7594
09315642-7ffb-4b51-a4aa-8e97de980c4f,Commercial,0.28072067549600943,43,2,305,1324,1019,49.5086243062133,2172
63b85136-de1d-44b8-b931-2a0765e2114a,Residental,0.7931904094326429,23,49,252,595,343,87.02235880762005,1649
c8c9d8a0-c9b3-45c0-a25b-9987166bf6a3,Residental,0.023445215212574144,16,33,38,757,719,65.82623383720446,3199
e8f96a5d-b0cc-4405-a299-40f8a54b5540,Commercial,0.8582564059926118,32,35,554,758,204,80.10598442807404,9632
c0e09f5a-621b-418f-b4cd-a812b5d01a4b,Healthcare,0.4822893381843629,38,15,262,1423,1161,68.21969890195388,4434
c1bd1aa5-d5a5-4c1e-9e41-a6b838deacfb,Commercial,0.39273542465349454,3,36,512,966,454,19.17368873439282,9395
92f2dc77-21ea-43d2-84e1-4da301a26a4e,Residental,0.9713257794108844,38,2,609,1056,447,93.96507394712815,6128
4c593525-9758-4d5b-949f-d87789ef6317,Residental,0.8771416212149215,9,35,463,785,322,36.82586535497185,2580
4483e33c-57de-4b54-86e8-d346871cc34d,Healthcare,0.3854534609254038,23,7,631,873,242,15.613309189260995,5316
f4c96fce-1601-41f6-addc-04d1f7b1d6d6,Healthcare,0.01869864236011054,16,34,103,1126,1023,81.11640706543035,6555
5e33fa4c-7f20-4489-a772-879b9ea982b8,Commercial,0.3981792484389062,30,39,354,569,215,60.236992091692606,7443
0f4e00ad-7830-40cd-84ee-89f8c7730d52,Educational,0.26965934006219083,29,10,469,1070,601,52.54115104402467,5496
7ddc9d34-511b-46e4-b2d9-c791ff9ee503,Educational,0.751969157977964,18,48,271,902,631,15.730943441895276,4934
f7f394a2-b80a-415e-9e6b-5402feddca14,Educational,0.6509604872252489,5,43,450,1068,618,24.781754313039194,8205
91018f22-8fe9-4e3e-938e-e51b182372d7,Residental,0.6307690954109977,43,40,61,291,230,23.85285096263044,6767
c3e2540c-c359-4434-8b64-93af8adb59ce,Healthcare,0.7815413651771648,35,28,604,659,55,23.256881411081654,6784
48cdc335-da29-45bb-a312-c9694754f348,Educational,0.9312270929074058,1,32,63,1159,1096,11.844289966169585,4590
ac4a00de-6010-454a-893f-04955e7efdce,Commercial,0.17498750075839697,50,39,160,1194,1034,60.98930915628432,9121
bbdb618c-af7e-4589-a161-435cd99298b0,Educational,0.3331935560819619,42,40,42,340,298,70.8729762032685,4554
c229eacb-3f1d-447c-82fa-7835f5bf0f6c,Healthcare,0.007195405723384618,47,17,467,1327,860,86.63744768529132,3254
3108f985-e8b4-47ee-810b-b9b053e6fbb8,Commercial,0.9857167434190712,38,45,79,1247,1168,92.00305673374407,6048
2b3e4821-ed6a-4678-9e13-ae5a9a4d6642,Educational,0.18110385204051216,22,20,21,166,145,95.54167688773994,9945
3dcd69ae-34bb-45e4-a2ff-abe8a4046c63,Healthcare,0.27881362601462967,48,18,274,928,654,43.49536006648549,2954
a932345a-467a-400f-98e0-3d73c74d61fc,Healthcare,0.7535464589385845,1,14,379,1405,1026,37.88914927003159,5736
0a4f8f5e-a613-4c7f-98eb-c0168a2a3a55,Healthcare,0.9032814303438765,41,23,331,1092,761,68.51828335690067,6490
ee1d627e-df7d-49cf-9430-d7d542400e5b,Commercial,0.5560960451817596,43,35,626,1207,581,70.26684323786696,4018
a02cdbaf-cbaa-4240-ac98-39eb23ab5f12,Healthcare,0.9118677596442912,42,22,577,1038,461,77.84276323307202,9283
e9c3d6ba-2748-4325-8b95-570b3e5a8c1e,Residental,0.024275100337344035,18,27,217,1355,1138,15.008557916422426,3293
c7811bbf-08bc-463e-9aa6-0434888bf945,Educational,0.47051098541135494,25,3,625,748,123,14.885153567559277,5038
dcd360f4-4c32-467c-b815-775a73ae1f54,Commercial,0.029652307262125532,13,49,105,1120,1015,37.81305278199321,4951
4bc5d300-295c-4c35-94e9-5ab9410b14ba,Residental,0.8838548224863303,14,17,251,695,444,67.20599897348879,8379
a543447a-0db8-40b8-844d-23f97237a09b,Residental,0.20246243835275912,37,25,184,1252,1068,89.40493184102127,2989
95fbe3a4-6baf-49ea-ae5e-b982d56bc9e9,Residental,0.8778227868693878,40,3,373,1117,744,28.87457763862376,9308
bb81b215-7331-4e50-9f1e-e3efe2f2bc45,Commercial,0.7924014937866594,4,5,40,592,552,46.49983119708544,7378
cdde5815-4aac-4321-84d7-07dd082d0b01,Educational,0.6621263930188342,29,24,434,1174,740,55.82124853818118,5835
08ff682a-565e-47a3-b199-80b57f8476e6,Residental,0.4382769836841066,43,33,401,693,292,56.457076080080405,7174
e0d3012b-9343-471a-a239-03ba78b49083,Commercial,0.4060779297449869,17,35,60,824,764,33.04535164520492,1365
cb4cbf62-f892-414c-8746-86beb8b5c529,Healthcare,0.32428290854884634,42,36,315,558,243,67.34831176500617,2831
314aba24-0f9d-450c-9beb-73ab22b650e0,Educational,0.48705468077608194,41,43,344,454,110,88.1410181276249,8318
6a197673-677f-4cb3-a140-556bcc0afb8b,Healthcare,0.4942268898050256,48,43,222,1046,824,23.273878789150412,4330
b96b2e2c-5e74-4857-9514-d92dc390958f,Commercial,0.8045754077447833,1,32,411,1389,978,47.445689518507166,2423
8cfc7b3f-662d-41c3-ae1f-9bc9acb65a6d,Educational,0.5319810998994156,24,13,309,660,351,58.18791087156862,3390
c638618f-49ef-4cd3-8ad3-19ff6a9c9d21,Commercial,0.028330980566842245,30,34,640,1231,591,66.03385910983502,5284
0d376c86-b8dd-4adb-8d05-201e3b63339d,Residental,0.7978421193504904,18,37,181,1327,1146,62.10195239407749,3844
ab351d04-d3b1-4858-aafa-c57875f5abff,Residental,0.4669690064608525,46,23,299,848,549,35.42344924159039,3930
e5548cc7-955f-490d-9e54-9f77c759fc48,Commercial,0.9738000888274796,37,19,580,1154,574,21.996164466680895,2860
6e15237f-0935-4de0-8c76-56d65cb277e2,Educational,0.48078551529472835,37,30,246,1079,833,79.72520618538657,1213
f737c797-aba5-4ced-b8f5-db84735f2d1e,Healthcare,0.07340135219802524,10,32,164,343,179,11.959753316058936,5320
d6608c25-2c4b-4170-a1fc-8b792ded5942,Educational,0.4117289607445771,31,1,606,662,56,40.39254475607498,6892
042cb02b-25dd-44e3-a088-66471d789aec,Commercial,0.4140631288849558,10,5,607,1434,827,83.64047093425721,6701
d2cbe500-9092-4d51-a9da-d0011f1028ec,Commercial,0.17162775350168225,40,40,109,213,104,89.3905962099349,1840
eee08b78-0dab-422b-b41a-0ba65e473851,Educational,0.25620500106308697,25,45,156,714,558,15.137323713886996,6935
94d771ee-9759-4b7a-9708-e42398bf450f,Commercial,0.19608752320218537,11,39,100,1091,991,40.64482865585149,9718
dcda87be-c434-4948-81da-4970455ad04d,Commercial,0.8766270725235833,18,18,253,358,105,94.47131362153691,5538
99959de4-f825-4f28-8878-8a7eeb97ddcd,Residental,0.020708254976632867,35,23,442,1168,726,42.19210755628901,1035
918fa503-927e-45b2-a7d5-f840ba548473,Healthcare,0.36342481014973427,33,10,505,821,316,34.568976312567145,3550
05652b15-c2e1-443a-938f-3ea98e925efe,Educational,0.9562340022121825,11,9,463,1142,679,36.48950147093794,3706
62ee226b-5cd0-43d2-bbd9-4babe0a0b605,Residental,0.25930636955527386,35,1,121,1348,1227,21.247264238733912,5657
ae1f368a-4cdf-48e2-a5c7-b6128ef10beb,Residental,0.0947622024428495,16,36,706,1332,626,31.39278807663966,4494
ab5f76f7-ee97-4678-b978-947db079c1bd,Healthcare,0.24575111897246604,1,46,703,1175,472,97.11549626717044,5047
c2acd510-32e2-4e7e-a084-d61e1a8abc47,Residental,0.4510634282765895,8,26,458,646,188,70.66174747466668,4428
24099125-a950-47c8-a920-f96c4a1e593d,Residental,0.8412618018961755,14,42,281,929,648,87.59457770155221,8668
538aaa8d-7615-407d-a1b3-488ba0e63d2e,Commercial,0.9029756542455635,22,5,439,642,203,22.217712909647098,1081
3042b7ec-3389-455b-927c-8b1ded9ae093,Commercial,0.9070336068555527,11,48,210,1191,981,90.47339369003696,7104
36702683-8638-4394-8ee6-f11ef559d1dd,Commercial,0.48060726128419673,42,34,133,1012,879,34.532251535390174,7475
285f3ab1-6733-45d8-a331-b131d7060674,Commercial,0.6784720507461818,14,33,527,864,337,88.71031098273048,1550
ca36f8a4-1c48-4a5a-8c2f-9802ce977bf7,Healthcare,0.7806210122620819,48,13,26,991,965,42.386894880815596,7215
7e07b36e-1921-4717-bf70-a622769d30ae,Educational,0.8523112546733135,42,45,486,813,327,32.118503214071424,6034
01d00e0c-feaa-4b7c-a768-f4ebc22be55d,Educational,0.7124570903014209,50,13,551,880,329,42.76419691251844,1028
85313e0d-a7b8-481c-a091-1ae2ff365d13,Educational,0.5250814445389748,38,22,534,1348,814,56.331076801191855,5223
3ba1b9d6-05f2-4ac9-8ca7-1c60af8d3823,Healthcare,0.449641163149741,31,24,441,1098,657,71.52734921016518,1324
2b450967-6075-4aa3-aca7-5d6d2bb45db9,Commercial,0.49730067991470583,50,14,590,1061,471,91.99718867948411,9652
481bd24c-a4fa-4aaf-a9f7-c9668aa77f9f,Healthcare,0.5063307787201404,8,38,424,566,142,37.67664353766628,2302
bbc44ffb-d570-4e5f-9bb6-e520d6a8d023,Educational,0.6457584415089327,38,26,544,1064,520,48.46407223177041,9330
677624ce-e4b5-4ec9-83a3-6ab0d40e13d8,Educational,0.45189260915663587,50,8,217,1152,935,40.953944847380235,5189
a8299e58-5c91-4654-b936-dde832c039ba,Commercial,0.1553055764379918,28,9,90,661,571,42.332807442014165,5297
1914519e-262f-4829-96e1-334bbe06ef6e,Healthcare,0.5254493230374873,42,27,321,999,678,71.86209089229612,1796
7f9d5b24-8e7e-4f86-a4cc-131db8a16a0b,Residental,0.24992693402985489,20,47,193,1276,1083,29.816180235228824,7635
c26e04c5-769b-494c-8114-292e93c152b5,Commercial,0.7120357089500532,38,25,186,737,551,69.96917548730679,9643
8e0890a8-63b2-4f41-8bef-76093e4df60c,Commercial,0.6337019824341117,39,41,114,636,522,23.30943915044169,2070
7eb8c54f-6ce8-4fb6-b2b5-f955790b230a,Commercial,0.4042441650976687,46,23,396,789,393,67.60439326938035,3505
f2844b62-0d64-4c94-9845-4d766ade1968,Residental,0.21500211852494,21,44,601,749,148,40.43031634598505,3914
a215cb51-d65a-4e8a-9fe5-796604386902,Commercial,0.21421865163422638,24,2,203,330,127,69.79606272032646,9074
2b026d8b-f0b4-4d94-b035-d33ae6a2ac11,Commercial,0.7298583653770285,30,11,73,1092,1019,36.08258960021067,4693
88919dfa-2135-43c8-89ff-d9af17480cc7,Educational,0.3963076961693932,16,39,556,936,380,91.77542707713712,4286
b6b2a614-7fb2-4e74-8285-98a69efe84fa,Residental,0.19349367565527797,13,37,433,1149,716,83.27044191874481,5601
8407cbf4-fd4b-409e-9a46-76c18d81ca1d,Residental,0.27757581450557856,13,17,663,687,24,70.13803062032889,6849
72ce290f-1f33-41ba-8321-07cc83a96d14,Commercial,0.6272546920733563,40,33,419,1010,591,11.693972422824903,9243
345b4809-a795-416f-9e3c-2dc70d836c93,Healthcare,0.10117935132019684,50,19,510,1412,902,75.6270885313641,6480
d77e15f1-854b-4fa2-9904-5ba8ec8bc4b5,Commercial,0.5285948802780475,9,28,271,559,288,67.80319030252683,7756
d24f0b9c-3f67-4b24-ac4c-778582e88d7d,Healthcare,0.05265463617435673,24,26,534,1191,657,89.30264583380479,2476
5681c051-7cfa-4148-aaa7-e824c6eebc66,Residental,0.14141409353975531,24,27,320,595,275,47.2067655681717,5210
770a70e1-1957-48ba-9d2d-425345302fa0,Healthcare,0.19581323690421404,19,37,589,1381,792,15.734972790643035,7830
788b50da-7de2-439a-b1ef-369a2aee9495,Healthcare,0.8802088971904288,6,40,244,1304,1060,43.570008945972454,6738
814cdc49-7f91-424f-bc67-cbceae4a2fe5,Residental,0.8091867535902713,14,40,115,759,644,37.95947223252141,7434
4a32924b-ecb0-43a6-87ce-6047379d3483,Commercial,0.53758483412946,9,27,612,1021,409,76.78499893099539,2435
3cddf458-fa2a-4c10-9eee-064fa9dad176,Commercial,0.9002429294744777,30,28,38,568,530,47.536379426236174,1458
7298c968-b5b8-426b-85a2-96291b592096,Educational,0.6487071600300129,37,5,594,891,297,88.22733352333215,5149
de428eab-1b50-4343-8003-d07aa1ca12e4,Commercial,0.015497543819582127,9,25,237,607,370,28.3209763629818,2454
949a009a-3a3a-4d19-99f7-27f3382d3ef0,Healthcare,0.6670544129648864,24,14,692,1397,705,55.47944721703697,8443
2e0e8450-5e6e-4af1-ac81-ab643a32ff0d,Healthcare,0.4430130974738783,25,44,405,1161,756,44.40611247771112,5158
c231000d-e008-4a3f-8ba2-a577bdd4de00,Residental,0.9812528389414511,20,32,619,1322,703,97.1573243734264,9644
fc488599-d01f-4e48-9657-53f6d12809cc,Residental,0.1704862856130428,8,45,554,1374,820,32.51338239127201,7343
4abb37b3-cbf1-41be-8305-3eb2560fd636,Healthcare,0.5332077584614096,21,50,463,539,76,12.664900346986592,2044
b2b61bb6-c134-4b37-8e1f-82424d72a789,Commercial,0.8267762673888434,37,5,512,889,377,67.26078403679749,4997
aa1f6218-0990-4bd2-a699-b9c743399933,Healthcare,0.027682505947553726,42,43,254,836,582,10.990337411944685,3877
fc829c3f-d73c-4e87-adb4-19b002f40d42,Educational,0.5058283525663042,47,19,610,1244,634,75.93519543087942,5802
44df0698-477d-41c5-b303-7867d2c42cc4,Residental,0.9439154094254828,24,7,49,1174,1125,48.206488493916964,1642
10188451-25a0-49c5-b152-7720721b71e0,Educational,0.16386702093568783,39,26,154,1279,1125,40.86012912542,3590
e6032d87-6ad7-45d1-92b8-27d7a25d9e7b,Residental,0.6554897895228577,8,27,534,731,197,22.175435717186538,6571
e6d92e89-ebe3-40a8-a317-5d1a1c878b84,Educational,0.9584626144463029,22,45,207,330,123,76.59038849002904,1005
c5944f68-276d-4a19-a170-d0389ce4ddb6,Healthcare,0.7752953420573163,27,17,55,941,886,86.4708175857053,5344
57d1a442-7bd5-43ee-b019-21f4158eada7,Educational,0.12159631448874919,40,11,454,1017,563,36.04144015597785,6761
4a60217d-b1e4-4b6f-97fa-2c7ebc41b2c6,Residental,0.51216093747418,19,30,511,927,416,42.363685755335176,7358
d2eb1a6f-5940-4747-adaf-e03aac9499ca,Healthcare,0.30005311466161055,22,2,570,1062,492,76.01855675724369,5877
143696c4-6d67-43c6-8c64-9b305de8510a,Healthcare,0.08830090199484886,21,7,255,555,300,53.9982094245792,8857
5d771588-e52b-49b0-af00-0437ce54199c,Residental,0.22075709176885783,24,40,300,625,325,88.4388594978821,5534
8fc78f73-8f86-40b2-82b8-1a73050ccc55,Healthcare,0.35505682611343625,30,12,144,341,197,84.43735674724496,1578
b00a361e-6869-4849-a975-b2915e3717e6,Educational,0.6744627614353287,32,25,340,1121,781,32.902665744894335,5991
5073eb0b-48d1-4e3f-a610-32caa22b6818,Residental,0.25873014118133764,1,9,131,816,685,86.90684317498987,6650
2466946b-0935-439d-83e1-4d3ebe3fda6f,Residental,0.37867583598230403,31,33,576,1198,622,60.513935634256704,9494
a074d334-b16a-4e03-a0f3-aad44196fbb3,Educational,0.07968105575037698,37,28,115,642,527,50.219331245246785,8646
177f3ecc-f234-45ca-8eab-1254f33b336b,Healthcare,0.42943975370958243,44,32,640,967,327,57.34743630195169,7276
7791efd3-44a2-4286-9f1e-f7d997288d11,Healthcare,0.10416974462180073,42,35,305,835,530,50.98568221598731,7225
b9382ad4-f403-43fa-841b-5218633105b8,Healthcare,0.40918456652344304,20,21,712,1395,683,22.80657457581517,6300
3e1a37d4-3ed4-42bb-bf31-117ea23206ed,Residental,0.9199625257257152,13,5,717,1396,679,94.87182016972211,9925
96de3770-2747-4328-88ac-4f32b5841b5c,Educational,0.15995629801775924,37,22,555,1115,560,30.940390250977824,4982
799896cc-c8a7-4c07-a7a4-1221b3735220,Commercial,0.24833351966618977,27,34,242,1191,949,75.19057590610193,3235
08933778-32e0-4fd7-97c4-be2c239f7f8b,Residental,0.02009396631103899,4,22,129,1182,1053,22.450439531718978,6941
06645ee8-4479-4e77-a10e-7e603909ccac,Residental,0.4580114015245095,30,49,141,517,376,13.037954702465115,3098
102747d8-1157-4e0b-847d-cad76d6bf088,Residental,0.8710150291727974,40,14,574,622,48,63.13431775170291,4115
a2ded030-5514-4d78-b31e-6c25d0d60875,Commercial,0.5756979006295528,31,32,615,1373,758,52.67030190448128,1340
89539b5f-622e-4b70-9108-dd0f6518afb7,Healthcare,0.9938290271810696,2,28,583,912,329,42.45715564890383,7762
4957eee5-273b-4973-8849-6ed7c8c3bc8f,Healthcare,0.18558713921645154,33,23,569,661,92,85.23168291965571,9440
847ca042-1286-4c8a-844e-7074d2a32085,Commercial,0.9010784043502394,9,25,379,541,162,64.0240594312286,4460
fee4e13a-780d-4541-a130-10c8f2be4746,Educational,0.09028942597146072,28,20,499,979,480,37.59316876216562,4062
94b6587a-8716-43ac-86a0-932ed6f329b6,Healthcare,0.35369915795395324,30,31,679,944,265,70.8494295707142,1128
1e65059e-b6fb-4171-a2a0-d0e14ac38bde,Commercial,0.6559917026307496,28,11,647,1040,393,61.8391959741459,1714
0a9bf544-0bca-4baa-ac09-6c33584a8a8f,Healthcare,0.8885658868673139,36,10,251,752,501,29.54231536747548,2551
acb4ea6c-5d88-400b-9e4c-742ae3822d46,Educational,0.29735277977204677,24,44,171,747,576,14.923581805366641,1669
fcde5502-3b5f-471c-9c4d-ebe3059c4998,Residental,0.979132333022257,23,30,438,631,193,67.63943393843267,5104
55eec6bc-7dc4-4bb8-92cf-dcc3a2569277,Healthcare,0.12782443581639047,35,32,77,738,661,30.848195923432847,5906
68649578-0938-4be5-adca-69763e0ffc81,Healthcare,0.6610824946586343,49,49,226,1072,846,52.70483066215472,7957
3477dc6b-4174-4878-900c-9e6bf1a37a0f,Educational,0.6870765421596432,37,13,246,1319,1073,23.982458694921387,8379
b9b816d0-b763-4862-962d-4fdd395bb5ce,Residental,0.2117125999306324,36,32,91,299,208,76.29803970920777,4193
126b16e3-84b5-44ae-a403-84ab715f2fdd,Commercial,0.49971225147694043,11,28,691,1439,748,14.372327769686446,1648
580992da-8265-4d28-9593-df46a64732dd,Residental,0.5009089276263097,48,20,283,1273,990,95.84555487713921,1687
1d7d9912-72c5-4e24-89e2-a02ecbca2fb4,Educational,0.06062567038139799,39,1,427,1247,820,81.60003960870696,7888
360fe0e6-7fdb-45d3-b17b-c929a047e0d7,Residental,0.5355618591143685,4,10,208,749,541,51.48702644913667,5570
756f2db6-595b-4cdc-b64a-e50f40f1dde4,Educational,0.2922498278824691,31,16,213,848,635,61.7818763941767,9184
d7078572-82a5-4580-a714-b560f375fc50,Commercial,0.38102064917751277,30,31,454,571,117,36.11239734357884,4848
40127ee1-2291-4d89-8761-82d7a62c2ebc,Healthcare,0.3731504581737436,5,38,274,1236,962,37.209043498130924,5605
52f1cf21-6fba-492d-97a6-16025b279c4c,Residental,0.14140420656294428,9,10,396,488,92,26.5698486694373,7915
5183d399-2160-4db2-943c-8edd0460fae5,Residental,0.29184808975032106,12,2,694,1352,658,10.952920603184586,7111
00899797-67a9-42fa-9717-29659ef4a5b5,Residental,0.4596896632282633,42,45,654,741,87,24.175993168064146,3725
4ebb07bf-fe21-477a-87ed-c18d8d2ecdb5,Commercial,0.9562394659849244,49,19,541,1049,508,55.143443580456015,6871
ce9072b4-0830-474c-b85b-960b005611bf,Educational,0.3351991280925898,38,44,247,522,275,16.01872826092913,6279
aac2e893-d1cf-4997-ba36-22b166ba942f,Educational,0.9141693405523451,6,7,420,532,112,95.61645359085345,3767
5a569f1d-2d54-47a3-824b-b17c63784cda,Healthcare,0.9667821410002219,50,2,246,1281,1035,34.153828571479416,8141
e566c9bb-dbe7-4579-933f-469d82aeb19e,Healthcare,0.6284643990227299,32,48,456,1008,552,71.5879958441715,4887
0d180b34-a1f1-48f4-b609-581f903049f2,Commercial,0.3999450535927881,11,18,287,1307,1020,54.016015204214675,8111
7e24f6f8-6fd7-44cf-b3e5-0777866c6f76,Healthcare,0.7154966790680163,42,30,440,1059,619,84.48351848790728,9205
5ca0b7a4-e3dc-4ce9-9379-7e309521e159,Residental,0.3136118965479775,49,10,255,1115,860,31.194273118185993,2565
3d7e641d-49f4-4ed3-9b5f-5dec9f56999d,Residental,0.26470840955024066,23,2,481,942,461,76.93935473908356,3035
78c0e5ac-e3a9-4b04-b190-20501f1c3c1c,Healthcare,0.8385811320775735,47,20,338,470,132,64.6076202714817,5123
2ea6ac31-b780-477b-8b49-b999c341005d,Commercial,0.7032838906976376,11,30,674,723,49,59.91261080381832,6871
eddcf088-3746-44a5-ba94-a41bbdc72712,Educational,0.3649274797881289,4,47,477,1307,830,59.31785583771649,1153
4317e049-c0ed-4ce4-84a9-694093d200b6,Residental,0.03219598385223521,26,5,293,714,421,86.17870340875983,4060
01eac7ce-9712-403d-bb23-a0bf3b75a5a7,Educational,0.7262301926675809,48,47,105,1266,1161,91.16861942908528,5240
59430b07-bda2-400f-83ba-8a955070ea0c,Healthcare,0.5985629221171471,13,43,484,1334,850,27.557145826562277,2533
586d666a-647c-4888-a3e4-860aad32bf84,Educational,0.22674750139296052,44,32,388,439,51,58.84092912389078,7448
44da4916-12a0-42e0-8ff6-ef3556ee2828,Residental,0.49302709851468773,38,23,445,746,301,70.43588553783471,9129
2092b8f5-29e4-4057-89a5-dd58ea4b40ce,Commercial,0.9841495182627716,31,32,118,1437,1319,29.416505634365816,2174
fb9f2346-104c-48e7-8ad9-077f3201ac20,Residental,0.7256855756801907,40,46,179,1083,904,91.6714484623143,3073
c2189b35-a586-483b-993c-be7bac2edc91,Educational,0.111052967995794,13,26,376,841,465,41.15856355964448,2864
4d2ee64c-9e53-4de3-8191-4eaff9a4b677,Commercial,0.7796488008092538,44,32,635,1048,413,36.190582462861485,7593
15c55e28-ce8a-4c00-8532-c37792c49730,Healthcare,0.6522855962486515,1,23,544,1025,481,24.683121041355754,6629
ec32757e-c4f4-4b23-9b14-772203617ed9,Residental,0.6644993904658046,39,14,62,996,934,24.85904268323306,3577
7963e67d-18b4-4991-ab42-d70b6e421e4e,Educational,0.7009642223305833,3,8,435,442,7,82.61493112614282,2253
645c016a-06a6-480e-8b7d-f0edf6b3991a,Residental,0.9811358561608085,27,50,498,1355,857,89.78759793424426,4039
37d62d8e-0c98-442c-97ac-83d65b4a38ba,Commercial,0.9227963401486526,49,10,592,1026,434,17.059794856440558,7774
849f133d-ad93-4eb4-b9e8-5e0bae287e1c,Educational,0.18866101711391137,39,48,325,1038,713,29.77160287353496,3417
a33c3732-b207-4e07-b9b8-6267c435a073,Educational,0.0050365168569854735,32,13,427,1320,893,86.08521419066834,9341
b7380be9-e227-469d-afa2-075607f6cc75,Educational,0.6300926409074065,1,19,645,766,121,54.148745680421555,8253
3f1895df-ab7f-4f9f-b123-de7f2c46d02d,Residental,0.4056709527515123,26,17,609,851,242,15.467864137460143,3190
9a497775-263f-4e8c-9854-e193fccef123,Residental,0.2256478291818026,32,7,569,659,90,93.57310577029497,2305
e66c0971-8287-4907-83a9-2f02758e66e5,Residental,0.8731832357051796,10,35,530,645,115,41.37108380542655,4677
9441cadf-9978-4edf-b5e4-a59b4192a3e9,Healthcare,0.6538169872886083,22,40,190,709,519,62.84909044543484,7030
f525ac53-7c30-43fc-80e4-57ac0fc06dfd,Commercial,0.5520991018257639,25,7,564,1244,680,64.35417731197829,8161
3c9fd4f8-13a2-4077-b49f-0c56ae203683,Educational,0.3716603325885439,40,42,243,787,544,17.38047419975817,2071
8552297c-0025-44e4-900f-2f32bafde8c1,Commercial,0.1368427956177839,19,42,327,448,121,51.228738195151415,9034
70337b73-a93f-46cb-8ca6-b35fd7b4b4e4,Residental,0.03835611579300291,1,41,257,661,404,91.96672262346142,8297
43bfa362-89ac-4902-9456-8121df5faa4a,Educational,0.33655616780192965,6,50,382,688,306,99.09967233666858,8170
50ef65ba-cd19-4a95-9ce5-c22f5c675809,Healthcare,0.5851876357112321,17,15,412,478,66,55.11031895830481,1203
e18bd5da-6ba8-4470-bbdd-5a9d3ada3104,Commercial,0.4957396326507538,30,2,451,990,539,60.06701401862074,3711
0675c18c-65ee-4a18-b98c-13675a2e47c7,Residental,0.3292959109228766,32,25,677,1434,757,76.03738577548258,3776
9098d190-4dae-4d15-814b-ef8dce888ee6,Residental,0.9926631738193414,11,18,41,1422,1381,24.152424785648016,8803
dd2155af-a553-47bd-8b1d-02aeb3b3d342,Commercial,0.8189070669597848,11,41,364,380,16,60.89434647047096,1137
036b4312-60ec-4615-bc3c-5c1e766bea2d,Educational,0.010275727917879784,15,8,703,1126,423,23.344834678353973,4084
8c855356-f7a9-4f44-bd71-cd3f5cfc68c2,Residental,0.024518237944326837,17,9,157,271,114,99.88963328697851,5988
9aa4e997-5d14-403a-929c-b01bd7e0ab32,Healthcare,0.09826637345649714,46,27,73,146,73,34.80033892599722,9568
e63c5ad8-71eb-48d5-911d-8b8af13a5615,Educational,0.092526848172239,19,31,204,593,389,23.515683785520963,8980
3f39d30c-e411-4228-b6ae-e988d3d4778d,Healthcare,0.8904189740843903,35,16,270,294,24,33.82320934392712,2103
dbb10e41-181f-49fc-a78f-901b78691925,Healthcare,0.7899452313303159,43,21,237,1066,829,39.19119312043634,3290
52455b95-a9e8-4757-8eaf-3ed3c6d6c8dd,Educational,0.04894812053646935,16,11,55,884,829,28.14239285978641,3018
c679c4fb-bf59-4227-aaea-63251f5398c1,Commercial,0.2920555328356087,38,5,331,817,486,89.5674416088052,1298
99b0b6b1-7df8-4447-b454-abf9e6da8fe0,Residental,0.1991347499300693,32,33,169,788,619,50.92906371068759,9072
0e790075-5938-47b1-a153-801183fba301,Healthcare,0.6226458960789695,15,47,613,969,356,95.3125976099606,2844
5ad6e403-8c5f-4da0-a806-722f9b19b1ba,Residental,0.16670949087875198,49,12,517,1009,492,83.89152689386562,4742
5804ff45-fbf6-4d4b-a0bc-84bf20c91b3d,Residental,0.10229331241897588,37,11,274,287,13,31.612683768571802,1325
e7467377-28cf-496c-932a-01803083ffca,Healthcare,0.6681378720727393,25,15,183,670,487,79.64438123598498,6908
f8af0b3f-c88c-4826-a153-49eea614e541,Healthcare,0.05929842485554382,18,20,671,1222,551,88.7126675168007,1236
de7faeae-85a4-4afc-b445-fb9b33d42ebd,Educational,0.37663576478706107,37,39,198,811,613,42.52461693815558,3171
f73542fe-f9d0-41e8-b1d4-c8010354d9eb,Healthcare,0.2618737981665159,6,19,101,221,120,18.349015684474068,5024
b0146863-4afe-43a2-afe7-7efcbcc68523,Healthcare,0.26018328599509677,34,16,356,1196,840,44.87864787174639,9685
61cbb67d-ae34-4e19-a31d-d9330630b155,Educational,0.14180327576823626,33,1,115,1331,1216,56.96899536978326,9229
42314155-14dc-4ec1-a0b7-5f1e5efb8cac,Residental,0.2372142453419499,27,11,654,735,81,39.591277383491786,1553
4f17679c-d05b-4560-95fb-c4a2b6173a4c,Commercial,0.15191696367775076,4,9,710,756,46,44.44895145830919,6133
1eca45b6-bc89-4ea4-9076-16ccf6f9af68,Residental,0.9242454463145252,20,24,294,758,464,62.85018016070379,3277
b3365b3b-1b60-4f63-bfb1-1982153f9217,Healthcare,0.504731582840687,37,7,616,1140,524,70.96850140033226,1749
af8b4ffb-f2d7-4ff2-acf2-0684a9fe0d0d,Commercial,0.49015456906958044,15,26,606,1108,502,90.17256070133213,7029
0778b877-8136-46c9-87e4-da404e4ed280,Commercial,0.22102723387677936,4,49,364,1182,818,47.719966712698586,7901
e1416575-2604-4365-a08a-054f927b3eeb,Educational,0.7861694236102409,15,29,652,1126,474,82.1183177876379,3758
7194eb76-3815-4b1f-be4f-9554dc406fea,Educational,0.5127366680276595,37,30,1,1072,1071,99.96054090430431,2065
3b09fd0a-41f4-43af-8d8e-4bfd2b2fda55,Commercial,0.6172959770096005,41,31,150,1165,1015,76.27631080272931,4001
3b79c2c6-12f0-4a6c-8f02-ea0784d55992,Educational,0.06401848904491725,38,5,261,1115,854,66.82281888655979,4357
baf84e7c-36cc-499a-8604-4f26203c1799,Commercial,0.14718229525030557,41,31,401,493,92,21.544982514721788,7346
f3e0a665-8a6c-4957-9f64-0c3f14b9e821,Commercial,0.5008976178030781,33,37,515,1279,764,61.69157912504622,3964
103fa276-ea83-4489-8ed4-b75ba41b9102,Residental,0.06194106629530982,20,47,31,649,618,86.9472709354484,9310
f963aa71-aeb7-441a-82c4-d906ce2a6184,Healthcare,0.9409177339767589,32,42,691,709,18,43.454308657444784,7814
04e26747-130a-4159-a828-d15328299543,Healthcare,0.5976129545124632,11,17,718,976,258,48.11786236269998,4268
d87a3d4a-18bb-4d5b-98dc-271b3ade2a10,Healthcare,0.8657213985429543,39,17,651,1259,608,21.962606432021715,7432
0bab800e-9be3-4c2a-8858-f5d6e04e3bfd,Educational,0.10612791923934106,48,24,557,718,161,19.82157640095208,9128
c0c6fad8-3fd2-40db-b491-ae68fb550d73,Residental,0.20962004080625396,34,30,296,770,474,61.32200242623261,3251
2295525a-f382-4e7f-b2a4-2900c65eed1c,Educational,0.6325584453238092,27,23,235,332,97,33.52912689121223,1149
9ddca79a-5896-4f9b-b4c6-254448cfa8b7,Healthcare,0.7858397093934749,20,7,576,994,418,73.86342054370724,6831
786b4444-1574-423d-a52a-9972b5bf744e,Healthcare,0.6030572277837696,36,15,610,920,310,81.83842368592767,4407
4b85ec35-56c7-4b22-aa81-30ed4310c928,Commercial,0.40904112762526057,15,16,604,733,129,45.610766260071536,9551
0c93498e-343b-4285-90b9-c293005b619b,Commercial,0.10058623429660085,38,29,246,855,609,97.67129588522977,7410
0eaf2ee8-4843-4c03-ad4e-d45c642467db,Commercial,0.6045913089562301,31,16,686,1394,708,51.035531852083345,9499
829f4e38-5bba-478a-ab82-bbfd887571a2,Educational,0.17665074150589288,5,7,65,777,712,65.07747599629916,9565
4143c469-a734-45b5-8f55-6888e498491f,Commercial,0.8542325112230897,50,20,41,487,446,90.44438650730166,3659
08e33da7-4d7b-449a-923d-80db30eb9195,Residental,0.9192437252089156,26,32,269,1259,990,50.08949797101487,5072
d364cec8-5221-4f47-be19-9702502e6393,Commercial,0.5983826466446922,14,11,563,836,273,48.849048125026485,2016
db44fa49-6320-485d-9d6b-ef3326ca3523,Healthcare,0.29442800059682506,49,14,368,1339,971,69.74992578726338,8166
8d67294b-4614-4b77-9f5d-32589ffe7f17,Residental,0.9767277156163388,38,46,406,837,431,80.9514809839207,7915
d9ee9c60-ae60-4e49-b5eb-7c45fa73bb95,Commercial,0.6152686280889321,18,42,341,996,655,95.69915616373655,6722
64fbe8bd-f7c8-4317-9be5-71a9dd2539d5,Educational,0.8525149999191931,29,30,138,1020,882,90.774239345289,2778
39af2b30-df1e-468f-aecb-5d3163217ec9,Healthcare,0.2832809011429147,33,48,114,795,681,35.586121655564426,2544
28f1358d-73ec-4141-bdc5-5f1a5bfc489d,Commercial,0.3596956774712109,5,18,134,959,825,23.40320391749914,7498
a7ca8a19-953f-493f-bc8e-0405f67d23ad,Healthcare,0.41688563414766555,36,24,592,1070,478,76.15311923194172,5908
a1c5b001-722b-4492-a1ba-571706d8b296,Healthcare,0.36107182876590127,4,43,597,1310,713,88.61942789398651,4282
0024ec50-6f94-4ccf-ab88-573074e81917,Residental,0.4511575057658167,16,40,119,869,750,55.58719368266103,5023
9a3415f7-3ae5-4573-8c1c-8c7fd5edf1ac,Educational,0.13028293492504028,15,24,238,493,255,99.04612264754043,2379
2211907d-ed44-479e-8142-6f6863de32b3,Residental,0.6322949209592762,8,41,550,774,224,98.95397923844725,4559
f10d8970-3cbf-47d7-a98e-721a49e5b72d,Educational,0.299179577982126,21,24,353,969,616,43.70261562339889,1841
145a77d3-5cbd-4675-8d75-9cdfe3500b59,Educational,0.8811993044179178,7,11,678,1126,448,44.71002926252669,2351
bb9da3b1-4817-4c75-b76a-7afd192e3e3c,Healthcare,0.9597656150366476,9,9,150,202,52,26.989911134953662,6925
8d8aec66-e991-47f8-9c10-c9b3313689ac,Educational,0.27191234245379803,6,18,223,745,522,29.499369147791167,7639
36d00854-819f-40a6-a687-adca921b388f,Residental,0.15197658605383446,25,40,446,466,20,79.35547940570453,8825
fcc87f5e-d94e-4911-b326-720f13ba84a2,Healthcare,0.3345525192379667,37,22,330,867,537,68.48704139348351,8876
99650dde-2a2a-4162-bd86-11b9af9d88f6,Residental,0.47921596457936644,23,4,385,654,269,58.27222572715024,4476
9cdff3e6-7731-4615-a3b1-292144e1c1d4,Commercial,0.39141193442478395,13,33,535,1372,837,50.651625311946866,5526
e68c432d-5489-4e09-87da-4f5497afc77b,Commercial,0.17830147123345175,2,19,98,133,35,60.915879660170944,8877
457dd802-36c1-4d72-93a2-0e1ebf6ba8b9,Healthcare,0.007931327096864838,48,44,226,492,266,11.499289304810565,6240
14a8e810-c921-4619-a85a-b03da0743ab3,Educational,0.9449642766059844,36,23,467,660,193,58.99697329523131,3705
4b4d6374-08b3-422e-9138-b1f726c48cfb,Residental,0.4415515192924344,14,4,91,639,548,93.36909147024922,3645
ad200a7f-fbca-4592-854f-67b1b653f22e,Healthcare,0.28154171487513224,47,23,653,1297,644,52.71140887554591,2114
5d98ecbf-ef97-4019-8f10-bf5d57c60936,Residental,0.9676513053630091,43,50,150,274,124,95.30862454808737,6364
0c2543c2-1b0b-45b1-9467-e7703ad89e53,Residental,0.04333617970042236,46,6,479,716,237,33.17290623879012,2013
408b116f-88e7-4676-8f55-c0bb22fd4a4c,Commercial,0.932999371225596,24,21,444,821,377,55.175697665441966,9888
9681a690-dbbe-4e07-bd1c-28a01bd9a285,Commercial,0.8013273270139825,28,20,180,582,402,77.46461165088728,9245
8a2d3b62-20ed-4e82-a2f9-15b0d59a6f25,Commercial,0.9650689269919241,28,41,461,1008,547,20.563736110787403,4372
fd3898b8-a6c6-45ad-8b20-3ed31c77b246,Healthcare,0.8274387749019406,46,46,79,1219,1140,81.2986641732349,8247
04e80397-bf32-48fc-8cbc-0809e44dccb6,Residental,0.11363912510046714,29,37,612,1192,580,71.91334790261051,8978
bffd76fa-702d-4761-8cd5-762ba7e91298,Educational,0.7554395543200728,21,31,277,747,470,94.90693630324245,3410
94952388-2a79-43f1-9492-0841de2a659c,Commercial,0.49964848372589243,14,50,402,1298,896,15.732407819520127,7647
5616c82f-417a-40cd-9be1-4550da413fa9,Residental,0.0139101568403317,6,46,483,1062,579,82.35108365360756,6038
293b2184-8ede-4848-bf07-644ef7dcab0f,Educational,0.8262105325621041,25,47,402,769,367,92.82395152188923,5769
e50d62bb-42b6-466d-a198-b168fcea1e1b,Healthcare,0.818602866420553,41,43,229,708,479,53.6533522833645,6704
d42bde1d-a004-4b6c-9475-a228c31aaaab,Commercial,0.9904221912592669,23,39,77,965,888,73.0407509400823,7095
5cb5467b-44eb-46dc-938f-24296b88a147,Residental,0.07809217747788211,40,10,96,1098,1002,40.33257334996004,1529
b9e03e8e-a0b6-4146-bb91-78bb3a159bb0,Residental,0.018301762952527056,1,16,179,834,655,96.30614358005731,5261
f6b6e563-1110-4669-af87-7a8ad8cd6265,Commercial,0.956073282692614,33,14,4,1192,1188,58.411021225622214,6037
390f84bb-d10c-4e67-a9b8-7adee46e3853,Commercial,0.15177257162921298,23,50,65,573,508,25.823626826506032,9787
f167699c-fa55-4f6d-a8f8-614db9ae3e46,Commercial,0.2152869927315222,19,23,406,1180,774,60.77973005132651,8500
6d5bc1e9-57ab-4bfa-bf1c-8507b5891e4f,Educational,0.3604341504770441,23,37,366,719,353,59.78299852149167,4628
4e9e90aa-e041-4ff7-8383-3091c747f76f,Commercial,0.43432984258677165,5,28,564,1045,481,35.49800041181676,1771
7ef8146d-f679-47e4-b117-c7e43a8b9ce0,Commercial,0.6560151959583517,6,23,512,1433,921,91.69118810942535,8219
c2c91b4e-036c-4ee9-9ebc-cd10ecab7708,Healthcare,0.02665188949431041,24,18,709,788,79,54.83459265517759,8749
facd194c-aa19-48ef-a251-843169221f89,Residental,0.04729365185362999,37,32,678,1417,739,21.704408776467425,2311
cd9ab05e-8cc4-4d5d-b881-490a01f1a76b,Commercial,0.9921820643280563,39,25,716,1171,455,77.37359003629763,7909
cc199ac3-0676-4761-afbf-877c5ef5e825,Commercial,0.6322275643182504,5,34,85,857,772,93.73282806650582,2357
9e6f608b-dd37-4582-8074-3dd5ba472d57,Educational,0.9848990657867136,20,38,414,585,171,94.53819571960702,8870
c02b01b3-e278-4e77-bc8f-74871deb9609,Educational,0.7678752427873777,5,31,522,822,300,37.19881399499437,5495
f4939f8d-db1c-417b-87d6-8fc70687185e,Residental,0.11584502364173721,29,44,202,906,704,28.95206095104502,1782
a10f7e2f-706c-4bdb-8c00-4d9eafcefe25,Healthcare,0.6662308662216297,18,35,313,903,590,14.538970706887895,4364
e33bc72f-cdcb-45ac-800f-0a298551b6a6,Educational,0.4304446982125133,46,34,521,823,302,35.28341015452867,1110
6d05e15a-38a7-4a2e-abc1-9b7372d491a7,Residental,0.76291725214352,8,30,206,782,576,94.746545081375,5449
87cb174c-9aa5-46d5-824a-fee35cec7719,Educational,0.7754507127883744,10,11,231,420,189,16.78862950225119,9567
0ee367f4-3f25-4a31-856c-76c2873664af,Healthcare,0.06589720111297348,16,15,91,1009,918,21.954983233036636,9712
23fc5c5f-2f0e-483e-9cbf-d7b9bfaa8ac7,Commercial,0.8396892421755048,28,23,555,762,207,47.63003817667555,2956
d132582c-771c-4ee4-8a3e-424336c30bf9,Educational,0.1408726974219685,8,16,653,876,223,30.944276156786486,2016
2365bbe8-397c-4770-a7ac-f0eea83d2329,Educational,0.5094446316039632,31,45,506,887,381,55.44304453812123,7046
c7f23d3e-290d-482c-8b9f-de0c8f5b40c3,Commercial,0.007648975422898663,34,14,57,846,789,60.65711342547328,8166
b308c300-4363-45db-8359-c9e22a85a3b7,Commercial,0.23617483897683367,33,10,244,1012,768,42.74189392638973,3303
b43c4fba-d665-44ac-a090-7d15446b7e7e,Healthcare,0.8210799275119663,28,9,379,436,57,93.95657339562761,1026
c04e2b42-778f-4993-bcb4-12f38a2cab68,Residental,0.6142021048675678,44,7,507,1114,607,23.3306691136686,1455
4e77b598-eabd-40f8-9067-745585ffcfe5,Commercial,0.13577541012785876,17,16,72,725,653,88.34668720689801,2688
fb11ca0b-00f0-43eb-93a7-a0d4986a5537,Residental,0.892032077076843,46,50,96,767,671,26.934918998652194,4372
b617a079-f45e-4185-af0b-434d7fc7bb6c,Residental,0.4225741964184032,21,33,264,600,336,77.51975578489944,2134
0d058188-ca2a-46ff-83eb-60f5978350c0,Commercial,0.9818409382290717,12,7,150,1041,891,89.28784362623679,2954
2869a224-103a-489b-9e12-481b4fe900c1,Healthcare,0.45683723456603753,25,50,617,798,181,30.96561983106646,8126
b3bdbe65-ce0d-443f-b143-76510c6d7f14,Educational,0.376712620061304,41,43,151,178,27,88.63427199807931,5169
50af5f66-4b2a-43d9-ae87-204ff0b99b10,Residental,0.7696780462317838,2,30,29,199,170,45.45604004359714,6533
a7f849d5-a92b-4053-a543-48d2e0f52195,Residental,0.1259655427491163,29,46,48,1033,985,42.16851483239954,8287
cad33425-4080-4a35-8c31-cb00cceba9d1,Healthcare,0.5325663023323997,12,43,415,1079,664,65.88668748790202,9390
7bff3928-6edb-4658-bf10-38f9653f1831,Healthcare,0.38031741729693713,38,13,592,900,308,99.47874301835124,3810
b440ecc8-55b7-494c-96e0-e7d2330b3883,Educational,0.8417814762672914,35,15,70,1096,1026,37.59506889512819,8740
67b1bc3c-6968-4411-bc89-3ec8ec6b8c30,Educational,0.8142019049747145,28,40,201,1213,1012,20.288920043229297,6192
6d1986a7-a6c9-4ed1-8457-3e95a12d289a,Commercial,0.9407782528529096,26,4,219,252,33,82.38891302773746,2074
f6142c80-0b03-4ab8-9ddb-e43c6af31969,Commercial,0.5795843072155319,32,49,272,1209,937,92.9872235871557,6262
098da3a4-2437-472d-a4e1-2a2918df2e56,Residental,0.33328810919215546,45,8,432,648,216,99.12144533601543,9321
b57b71ac-f7d6-43e1-99c6-35d34fba4585,Healthcare,0.8268927867594417,37,12,268,875,607,61.57858965637074,6072
2f4d29cf-bf4d-44e3-8717-85e95a3286bc,Educational,0.07736816951205971,48,25,202,1298,1096,33.578531942183574,5140
ba1ddd85-7316-4bf5-8c7f-38d7fd823661,Healthcare,0.6898252181137133,31,35,244,1177,933,31.206820253055053,4985
d873bf44-ebc2-44e4-8655-077f5b909858,Healthcare,0.1106741653380997,50,32,194,481,287,37.98336471152507,4648
0ca37516-cd4d-4cb9-af03-1180643d154e,Commercial,0.03737726860167767,25,22,244,1019,775,28.84853849941875,7136
a51e3304-6052-43d9-bf9c-3b22e41ab5f7,Commercial,0.4624955032364356,49,24,536,1276,740,87.55776457082436,1233
c7035b46-cee5-42c0-a3e5-a44e4968fc4a,Healthcare,0.7747480000161323,30,25,98,548,450,85.10810540476184,5379
505c983d-d4fd-4a84-b521-2c147516e042,Educational,0.1421764594748125,8,16,717,1129,412,62.779026854878744,8052
9bce1284-5e10-4532-a7cb-b92351d473a3,Residental,0.5138901560025203,10,2,597,1359,762,15.109532583056033,9364
b436cace-aafb-4593-b85a-8722058ec440,Educational,0.17754867428634713,48,36,343,1219,876,91.14392144511943,1366
28e375ca-18cd-4479-9453-d33490087733,Residental,0.9495396022253912,1,9,37,1321,1284,74.04543217106973,5214
7ce67f16-6f46-419c-b1a0-719a8eed9d94,Healthcare,0.8893339419767593,27,13,118,1218,1100,50.04374286687016,7674
db99a816-4e81-4629-b158-4bdf6c609f00,Residental,0.43277871356794717,44,35,482,1355,873,46.29714630508378,5686
f98e96dd-7f7b-4587-abc9-782f3ce14e8b,Commercial,0.3092764763298076,27,7,635,802,167,40.3845110972436,7302
f3572a4f-61e1-4a46-9ed2-26c20eed68ef,Commercial,0.8174708649737052,32,6,272,1307,1035,74.7630436434855,3144
0ee140c5-1d6b-482c-8f5b-eedc95f92ccb,Healthcare,0.5997835290569918,26,30,111,826,715,73.90882230498573,3605
c6db787e-96d2-4087-8f70-c22782f701d7,Residental,0.8964457305175957,48,25,521,637,116,27.452462053645007,1339
2aa52e90-4b1d-405e-8c63-2e5896e1d662,Healthcare,0.4219839385750195,30,40,483,616,133,68.98261755990396,2905
9065a244-0314-4c58-99e7-3bb83aba8376,Educational,0.6977609844206113,44,30,608,1208,600,15.415858336782822,4856
2943771a-90c3-4f40-84e9-be90d2ec01e1,Residental,0.15876475357766806,50,21,263,284,21,32.52305235404364,5220
1adbf784-8c9f-43ef-912c-a81a558d8d8a,Residental,0.8426687290774135,50,42,53,787,734,87.36888751799022,5238
a4e507c3-cabe-4ad9-b23b-48e99f53ad11,Healthcare,0.6652501901911995,19,24,329,948,619,99.90307429948336,5869
fb365906-d6d0-4273-a4f5-a45d46720bf1,Educational,0.9362016938511379,6,41,192,1386,1194,19.642179336463535,7313
dd4b8e9c-cbc1-4599-9d16-8a06c1dbd807,Healthcare,0.6432297749852371,9,5,511,977,466,30.455369050520865,9111
0db695e4-4289-4c1a-ba86-c315fe7372de,Commercial,0.6207978905897635,16,1,161,656,495,44.50668790210996,5194
5e7d5b0b-da7f-4e0e-9f69-882d7024918b,Commercial,0.5088020007161174,5,21,184,1175,991,75.95053750849732,9055
6a771df0-4d77-40fd-a1c6-355140c2293c,Residental,0.5228586407766758,46,24,451,595,144,70.88858933990895,2547
1925c327-1acc-40c1-a171-a9b2d282ceca,Residental,0.7075216827613037,7,4,258,1160,902,81.05175788251076,7015
7d62a948-ac22-461e-ba04-c5050983cf45,Healthcare,0.9609381654004621,1,26,452,1231,779,69.35195044123753,4397
38f900c4-4009-459e-ba8c-0ac4b48798d1,Residental,0.6084404278822184,24,2,229,251,22,55.7970852422752,1705
4f873442-06a8-47d9-baa2-b5617a46f570,Healthcare,0.9829079274505946,27,11,295,1321,1026,20.57089086072333,2608
1faa08ff-2e96-4d36-ab3d-5983a614d338,Commercial,0.4545519825565484,14,29,598,690,92,76.93335704019721,4368
1b9b89f3-fa6b-4f7a-9d4d-74ad0d8d84e5,Residental,0.9082074370531051,28,17,432,959,527,29.53729846149747,4905
38876efb-41e2-4651-b3a9-0ae52212b820,Healthcare,0.22104785945828476,38,32,483,669,186,82.87194546773063,3053
2baff09f-367b-4a2c-8fb1-0756fb9240f0,Educational,0.0017216683558959334,9,1,65,979,914,89.46729710553757,7141
74bcba6a-e101-4431-95c8-8ac23aa5f26e,Healthcare,0.586204655426429,22,6,323,1260,937,83.72583920882514,3398
3a012a0d-0eb5-4dc8-abb2-d610aaf5418a,Educational,0.47324390908451497,36,18,582,899,317,72.56987653776318,2479
b7fe8f19-347f-4f1c-b62a-7679533b1fa4,Commercial,0.712867118526179,25,2,86,235,149,11.43035347950626,2125
6206c414-bdc6-45f3-8e5e-6026f374daa4,Commercial,0.47097151175474605,36,24,453,559,106,83.41586165935786,4170
46236b9e-2c18-4f69-9966-70e3074c3dc6,Residental,0.8767281803019168,8,23,587,820,233,41.883890001395486,8671
a1b16b3b-d088-4780-97de-e4487656cc52,Educational,0.15384836954758485,15,47,333,459,126,78.71015960115245,2852
62fd17dd-79d7-46c9-baa2-3bd019be21f1,Healthcare,0.10132970205087977,22,37,715,826,111,32.263797255731276,2570
deb4c82c-f52c-4737-bdd8-37212735b236,Residental,0.5642695161692006,32,31,237,778,541,77.56763411136909,6652
8a046534-e71c-4061-8294-701d3ca607fc,Residental,0.569870380634346,15,8,700,762,62,41.88776890943525,6011
7f2abb49-63de-4faf-b06d-5b0035637bca,Educational,0.27936493889120506,40,29,677,1206,529,81.19217470679229,2796
0dcd6221-0ac7-4933-8d13-6acc40ecd491,Healthcare,0.6456503636987694,14,29,650,1307,657,95.11916462637335,4362
9e3a7088-dd10-4a2e-bbd8-b4e1001085b5,Residental,0.5530655164454154,34,14,391,973,582,67.56794290332962,1814
0511e881-0580-43e3-9a8a-5134fdf10c17,Healthcare,0.6631733019713612,8,23,28,44,16,65.75151409588321,3716
aba27e65-7bba-45f7-b709-17ded54a418e,Healthcare,0.7493171824780662,49,40,318,1342,1024,82.24940757606291,1162
88a1b055-22cd-439e-a207-8325d3232b5f,Educational,0.30031180388511314,15,47,496,705,209,46.6212361627111,3432
38ccf37c-604f-440f-bb11-c4f9e5e273c2,Commercial,0.06427479670959835,39,24,600,1360,760,17.405952782170072,4310
b8722b99-f178-4e12-b99d-72c861f8dedf,Educational,0.9587721001842076,34,28,256,364,108,70.17117370928392,8227
fa4c5094-cf83-436a-b277-ca7b4bb1bbcf,Commercial,0.48574673035564,35,12,442,1412,970,35.821715556502554,1260
4dab4ea4-0cc6-4161-a723-52517e294767,Healthcare,0.7168998233606122,41,32,193,1216,1023,53.051825007712445,5538
81f0a2f9-3c4a-442d-898b-a7875e34e259,Residental,0.46163250417750057,7,36,82,774,692,71.50287755690063,6490
a86ddb3b-04ac-4dde-9b0d-6d15400f8306,Commercial,0.8934958296799146,22,47,629,1202,573,37.91654462122643,5926
bcc955f0-8ec3-43f3-8975-54f554fb1d08,Residental,0.7022966883206351,29,11,660,1002,342,16.425558166962716,1107
9971b2fe-ef69-47c7-ad7b-5beeaba0ba1b,Commercial,0.365714144273665,43,29,74,827,753,20.565235174709628,4663
b7e85cbd-0480-4701-9838-84eb6198e034,Commercial,0.6360451176210771,50,35,113,114,1,51.45362305878163,1482
9863ed8f-8673-486c-9304-b7eac5e65d10,Commercial,0.6199905317783938,8,5,140,882,742,89.75214887681031,4854
42f6436e-f701-461b-8dd7-538d06ccd6b1,Commercial,0.4037820630171639,44,19,246,773,527,79.06679378829408,4825
1c6f8248-0dca-470f-96d7-1eef6b76e18c,Healthcare,0.8500939319857189,24,32,486,756,270,36.75300802376508,8868
66ab6402-d6af-4e00-bdc4-2ae4337349bd,Commercial,0.02861942382002247,23,2,633,1374,741,44.40565259333582,7552
d7a36138-3063-4346-ad35-f09309b623dd,Residental,0.19190670803852594,20,15,154,473,319,71.9363510273763,4938
4517f4dc-6160-404e-9fbe-134bde56d182,Commercial,0.32517955216023176,41,13,18,456,438,39.43152753203126,6160
819da41a-fa41-41ce-86a7-261c79fe8809,Commercial,0.012666047076937748,23,35,21,1075,1054,12.196079606682394,9324
5396faca-7a08-4135-9c9c-52d6eca41368,Educational,0.37026782143626513,13,7,153,337,184,19.197777130184313,5819
a353f496-be08-4fb0-8e64-4e9de35ecadc,Healthcare,0.19790912506800962,47,10,663,1388,725,82.81778793462875,2261
19923a1d-51e3-44f0-89a4-396f27d7d5f6,Healthcare,0.6018103337838486,25,2,666,877,211,94.96277613129688,7332
7e957c3a-4fe3-4f31-8df0-a7bb4005ddb0,Healthcare,0.32022820520422357,10,25,263,424,161,37.53078651006956,3691
da9cc73b-81ba-449a-8b6c-92a98e726037,Commercial,0.9500007612648378,36,39,14,1430,1416,65.05599336208778,7725
03339aea-fc12-40dd-9d44-ad0a0e2cfc55,Residental,0.09348569631553694,17,16,581,1142,561,93.48316247755854,7472
89ca5e46-c932-46fc-984b-9ad92cb3c2b9,Educational,0.9165193374113685,27,43,585,1201,616,55.505806881672896,3655
6dedc543-8268-4b74-9386-0b64a2845387,Healthcare,0.859750210995389,35,27,536,997,461,41.55187934559899,1017
a1f7ec25-6b97-4df5-ab6b-da167176e288,Healthcare,0.922512135314753,22,17,3,1286,1283,80.57600033359407,1328
ddf51ec2-0fcd-46f2-9887-d30e7784768d,Residental,0.24843380880431154,39,25,565,730,165,80.93931432966184,1062
df79212c-2be1-47f2-82ce-27a04811f436,Educational,0.5512617080960807,46,50,363,784,421,24.818566828259353,2624
2dd26e52-1002-4f7e-b0bd-c6c1eec6c198,Commercial,0.21290894082212874,49,35,9,389,380,43.08174747884101,2885
b6da5a6c-3011-48b4-a519-2d3b62e315bb,Healthcare,0.4024013363665355,6,41,200,262,62,16.021248056102266,5074
17058bbf-9b22-4f0c-bfb7-d48c2f5b1f43,Residental,0.534201640270562,21,17,286,1365,1079,87.17315599437903,1775
14f96f0a-c6ed-4287-a1b9-91e8025a22ba,Residental,0.5704048268903045,43,13,325,716,391,18.225492608849837,3833
3e44c4a0-dcff-48d5-a9d3-6fccb2074f02,Residental,0.26038692488570536,25,47,579,1433,854,79.92145808952833,9533
ae4640e6-c7d3-4a65-8737-7e85c893558c,Healthcare,0.09772433506892308,3,22,241,1323,1082,55.05160514882144,4032
e32db081-8711-4ca9-aa1d-2017fcd81bd6,Educational,0.6038041537831299,32,31,710,1375,665,15.644429800795539,7207
9ba0f214-5897-443d-8ac4-6cc837b89e98,Residental,0.987471584618587,6,24,706,1372,666,36.36788242881111,6657
c37f84fd-ccc7-4e18-867d-bf961b0ef9f3,Residental,0.38360011000550986,26,8,461,988,527,83.03319506325502,2257
03a03714-0ba8-4537-8d99-157b7c6d2952,Commercial,0.3767833298310056,46,28,445,531,86,87.23940120463621,3507
ff37a552-d09e-474c-9cd5-47139d4ef1f2,Commercial,0.18588689164156924,35,10,508,1074,566,11.818748315123905,6935
729d9661-1349-45ff-860b-6f44b93c022e,Commercial,0.5756100717012288,33,36,492,1274,782,22.31092375810383,1328
a7039a57-1ae3-4582-a4e4-4e56f4d954f5,Commercial,0.45525899611293175,24,10,296,328,32,45.781514900711336,1637
bba37e92-e609-48c6-878b-4815b70ab40c,Educational,0.0773941507189887,31,39,427,463,36,97.98625431244432,1873
31046893-9a15-4b84-b3b0-ac85f8866063,Educational,0.38465837155703053,24,31,593,893,300,14.297391767713613,5334
24b366db-2797-4735-b0df-cfe645e8c9f3,Commercial,0.07568331665954964,21,48,528,1046,518,42.15251806381899,9674
a589db1d-af87-4410-9ed4-af1b5a94f352,Commercial,0.30040604165417784,31,33,510,1337,827,51.45237512421912,5766
e4394912-a564-4aa0-bc71-44709546e8a0,Residental,0.14377721944306165,44,43,640,1408,768,62.87228506009601,8823
d47c6a41-07fc-4eda-939c-b7acf69b86c3,Commercial,0.17868229966614446,50,49,472,921,449,88.60106220292417,9543
e039a5e8-8b6f-459e-a984-2fe56d2a0571,Educational,0.01439443394898865,33,36,298,1250,952,63.192016810172845,5552
fefa649e-6fb4-42de-acb0-2147e7054149,Healthcare,0.6536487158260731,29,1,673,1280,607,98.50918254713577,2893
7768717d-b1e2-4b7a-80df-7f4bc946af66,Residental,0.42929526699775766,2,18,438,1068,630,28.950579816370702,4998
3ada724f-f079-4225-9dc2-e4a202237448,Educational,0.5769136996422677,48,40,653,1151,498,59.774597331158695,9595
844f66bd-fb94-4298-9c4a-a5bac20558c4,Educational,0.6633702574926706,49,50,147,911,764,70.57134639935903,3444
e7418fd6-3ccd-4ae0-b855-97bc2e97f2a0,Healthcare,0.1975525694890814,44,24,368,443,75,98.96187457293586,7397
97966131-80df-4a44-89a4-0669ade9cb68,Commercial,0.3856951057594945,39,47,508,585,77,99.59375207998669,2255
b4a83a2f-dc60-4def-8b5d-fb11b23255d8,Commercial,0.17238251577622365,25,19,249,1242,993,54.27114735315445,1426
6ed04899-f6a1-4e51-967f-7b7747e530b3,Commercial,0.23865486606462816,17,3,6,497,491,74.64877931784875,5514
95877351-4c46-4fa2-9ea5-7d7d76834b5f,Healthcare,0.0004465459029362462,43,34,276,744,468,34.537906463280564,9723
9ab2f24b-a320-4d0f-96cf-07a23a3be87d,Educational,0.7949475578636191,17,29,40,630,590,83.55434717264727,6908
90836037-b1ef-429a-b524-d81906a2081f,Educational,0.011502711607468852,21,48,57,927,870,79.90231473476666,6632
7e9fb80b-daa5-41db-b99a-1e448b610efd,Healthcare,0.46875783869282106,2,34,527,628,101,90.0033775781645,7336
373790d5-afc9-46d5-b410-163a0cd364ac,Educational,0.056043758412976485,5,1,590,1417,827,87.638131452908,7412
fec10fb7-9921-4992-a804-9377b18617b6,Healthcare,0.3125338382484506,43,6,303,1209,906,67.51485829133608,9590
e48d3266-cade-4534-8706-35e29400e4c4,Healthcare,0.8229291053446269,17,7,11,934,923,28.673265553261487,1684
554cdae9-7467-4826-831d-d8fb224fd1da,Residental,0.2217371248093859,3,32,463,748,285,89.37552345836296,3549
2b42ffab-0842-4c51-924c-55c64e5a7dc9,Healthcare,0.4747823058686582,27,20,43,919,876,29.71502781778244,3796
3d9b3380-4de1-4ff4-9db0-2ef9d8cc5477,Educational,0.9542531231584994,6,13,504,1187,683,11.417763822279186,7076
1dc7df3b-a079-43ad-a6b1-0eb2abf520db,Residental,0.905743057840444,36,28,495,602,107,57.39988269083764,1368
3483b89a-628f-4aa9-9f0f-ea32d589171e,Healthcare,0.3424301744746173,4,38,277,1248,971,91.53240365128556,4372
c9e15f56-f862-4e2a-991b-9b6989b70476,Commercial,0.19803211272793075,47,15,188,404,216,91.1725940143522,8778
75c00d44-ea2d-43c3-ad19-6d23539b5dec,Healthcare,0.17095690401965036,9,31,346,1430,1084,86.21821645258339,8842
b7fbb07e-6d6a-48d4-abef-bfd7bef41911,Healthcare,0.5171117707917338,43,41,456,1175,719,62.56872455530498,8416
4e66136e-3b2e-4224-8e55-d43628674637,Residental,0.703418408473278,19,50,698,1100,402,97.70685415262186,9376
8807894b-22c6-4c5d-a713-0e067414e90f,Educational,0.15643348439994653,45,9,149,1124,975,40.14202867895708,5213
e55914df-fb52-49d5-940d-74d8baf05149,Healthcare,0.41059141587886083,16,20,431,987,556,30.091200375104574,1183
0f9d32aa-352a-4318-b9b0-7dc49613a447,Commercial,0.20974120211228042,6,5,720,1016,296,84.22566880421726,1989
30fe4515-2e05-4556-83cf-10d3ab3ab304,Educational,0.37111767881078184,15,30,285,1291,1006,49.84671300189668,2220
3fd4a01f-d7b3-4d7f-b890-a35ecd15ccf5,Educational,0.06357235104416104,9,2,623,862,239,44.12352615256489,8618
86346746-d242-4541-8f71-4ad03749eec1,Residental,0.858160449073704,12,9,432,467,35,43.077564718707315,5827
9568ad9b-e0b1-4411-8aff-e73dc4b75cc5,Residental,0.9398404599815166,27,41,140,314,174,65.22317374281552,2919
dea6d373-3c47-46e3-9008-1815f230899b,Commercial,0.2932554699204223,19,4,48,579,531,46.180460386403276,1868
c160e39c-509d-49e2-b48e-fb42c89eb43b,Commercial,0.25824501970908487,17,22,230,1124,894,83.67397816749721,9209
1c079d96-0531-430a-80f7-563a1b3c69cc,Educational,0.006957041824765642,38,50,496,841,345,78.94927340446769,7744
5045777e-01e1-48ad-965d-346500ffb1fc,Commercial,0.13741103256036857,28,9,58,681,623,37.0798458791687,5779
ac47907f-846b-4d26-8f60-a05eaa4d98b0,Healthcare,0.4266449122706485,3,3,349,825,476,97.00029903813676,9256
5548609a-0e30-41b5-a1ad-e6394db15189,Commercial,0.0904946775259744,34,50,715,1113,398,34.18476411625841,7451
deb5f264-3e6e-438c-ac19-1de1db21d0c4,Residental,0.4906554911518808,4,50,497,865,368,37.01330851272088,7749
86bb7c68-cc6e-4813-9ccf-80c3de91a595,Residental,0.09233814787146755,27,22,279,869,590,73.09736971763144,6993
e2fd7d44-a6b3-40b2-82f2-afa91912c9fa,Healthcare,0.9455427048687602,37,7,162,448,286,15.705427746150674,3268
787e857f-e5d3-4635-a036-0b0ff7c40ac3,Healthcare,0.13418318904040927,14,12,673,1122,449,79.26895686999897,8583
15afc17d-77e2-4c80-b3c8-ac41f8885e9e,Residental,0.1527494190324573,4,21,656,821,165,88.09778644760209,9306
3de5ce25-0535-4cb6-b427-4bdaf1d07ba4,Commercial,0.06582645849703417,12,47,192,411,219,75.22469265148999,5208
28c527cd-26de-49b2-a263-db8ec1efa74c,Educational,0.7448380466976444,1,47,633,1244,611,32.346206701939714,2444
fcd5e99b-9c0c-43ba-8d99-a58b45818e2c,Residental,0.24487223726247265,15,45,122,765,643,16.326288768944732,2893
912ba5e3-0efb-426c-aa3d-55b7438bacb0,Educational,0.29597316085206304,23,37,38,698,660,80.20314615107145,5571
ac0b1f1c-ec56-4ac9-981d-d6acae40310c,Healthcare,0.5423413769342168,32,34,474,1140,666,44.88723114682098,6470
5864b981-6a6a-4dc0-920a-83586c9637ed,Commercial,0.8192199272266957,17,16,323,1362,1039,25.282457973292075,7047
5df98725-923b-447c-a127-9a2e9f10153b,Commercial,0.35853431895417864,30,29,237,518,281,56.86037143039079,2096
d61a59b5-993c-422a-b2b7-fcdec80eb27c,Educational,0.2695830081994016,44,21,160,1015,855,35.43526818304177,6312
ce50b882-3751-413c-9958-4f85a4da3689,Educational,0.7477344429549139,2,29,161,810,649,16.537544622018803,8704
978725c0-c0ad-4b31-8754-66efde7f090e,Residental,0.1936893608140985,16,48,8,974,966,57.33152031992456,6735
8b18cfa9-0cf1-4728-9c02-4b4e308f13a5,Educational,0.22664494934718815,15,40,611,840,229,76.6436145023822,5100
c3b3dbb1-213b-4ee8-9e14-0423bd5dfb75,Commercial,0.7169663016327933,15,44,521,600,79,39.47682655716534,9841
c803373c-772d-4415-ab12-a0ecb87ca969,Healthcare,0.8203750305065782,25,19,403,691,288,26.450529136271342,7973
3994cb70-956f-4b7f-a3f4-96e4a55f663b,Educational,0.12484688961316437,3,46,197,680,483,62.035912065333754,6240
aaf2c830-e0ee-4aca-ae9c-df4677ca2f6e,Residental,0.4494243757384011,31,9,525,605,80,50.55476519546783,7340
daaeac55-83d7-4b69-b7f3-148edcf1c507,Healthcare,0.222852597090477,17,40,509,544,35,18.546857515006096,1045
588e2888-8816-4431-8a19-82fb60b730d6,Educational,0.5819649298691607,16,30,427,1191,764,91.5613089067495,7184
4c2fee85-32b8-4863-b2ad-3713c7a92ac7,Commercial,0.04686426424335777,6,31,345,1068,723,18.66462331316055,9133
6b6a2dba-ece9-4755-9131-28a3c9121cc1,Residental,0.7679589653473707,28,48,324,838,514,20.727731796152046,5972
85bbf8c1-5340-478a-8bb7-e37576b8f2e9,Commercial,0.050518947701084005,33,25,86,882,796,18.268575070118843,9868
0a257544-7d79-4e22-95a2-40a2fc7b9603,Educational,0.6970878227541211,37,20,381,837,456,89.12683848410727,9613
b4620ba0-4a47-4c6c-90cb-a8ef69d8c42c,Residental,0.10393633892187715,5,36,27,427,400,19.592112019114396,7855
b612d564-f1f4-4f1a-ade3-0a3325538df6,Commercial,0.7844730932646201,26,33,544,825,281,75.42504351568665,4826
cd52707a-17f9-481b-af4e-2900406f4fef,Healthcare,0.11922451340343088,40,38,384,1437,1053,65.79588911700196,2604
04e27c7a-97d3-4f8e-8931-17b00a186c05,Commercial,0.20202889928460743,35,46,231,877,646,56.81158281050517,2180
b1f0619a-c90e-4997-b1d1-06f03264d536,Educational,0.4241800371603881,27,43,257,960,703,59.91244609002058,3094
99e02126-2bcc-4fbe-b450-70ab85443174,Commercial,0.5050151914011936,49,31,132,1005,873,97.71679085660286,9288
8c5fdcbd-8a20-4de6-840f-6423c1095deb,Residental,0.28396212455352776,15,6,24,715,691,87.73704986409724,9693
19dfa943-aa19-411f-829d-d4325d5dee76,Educational,0.1448806007718273,35,8,362,1364,1002,55.85449288206331,5839
c79a8daa-4ec1-4395-804e-a30f8a58df8b,Healthcare,0.4991805230412477,15,20,572,680,108,85.98802189408971,4417
7a94e1fe-e883-4d5c-ae35-e96181ed2693,Educational,0.7017781913170175,24,21,528,1250,722,55.52371195897039,3802
8b4e9532-39a5-4055-acba-5f4f01a2bc9c,Healthcare,0.0716767641810887,2,48,144,1050,906,74.53678106803355,4788
484ae22e-166a-4432-aab6-e65a26973ae1,Healthcare,0.6768326933806327,36,23,515,1361,846,57.30728077072737,7747
8f31c105-f476-4d4f-bf9d-437ae2696617,Healthcare,0.2046269384703997,46,9,548,880,332,70.11247465997204,2186
f388bdf0-6e5d-49c9-a353-1aa2c6fcda2a,Residental,0.8956226371322238,11,21,462,632,170,88.64316994123716,9529
72fe8aeb-50e4-4399-8d25-218d6811f099,Educational,0.9232597216903513,37,8,562,1093,531,18.377762696557554,6251
0a2eb545-6711-42eb-9559-800f958ecbaa,Commercial,0.09653124374146815,22,9,64,1256,1192,50.84586008095812,4365
2699da24-98ba-4d38-8133-3741eb438f5d,Educational,0.5391558060315682,19,30,366,1417,1051,54.695799860230906,6480
2fcbda4e-8592-473b-ac2b-ac333aa7bd93,Healthcare,0.5544384967434092,2,3,286,1005,719,34.52628296676167,1809
86c8f7f6-e4cb-423c-9006-28337033dc51,Educational,0.8678909810947028,41,2,421,505,84,44.18808368979752,8140
71fd591f-4b34-4a02-bc21-ed43f1f616b7,Residental,0.9380329491240679,36,21,616,1075,459,18.76027485197856,6025
611854d6-b03e-4b8d-9f56-08c90bf9540f,Commercial,0.7024208641351549,30,31,189,388,199,36.93178845954856,8598
e2b15a0d-5c6e-4b65-bb0b-85e1d323fe10,Educational,0.7196385875066489,28,39,607,1258,651,19.28925229116706,6784
94ed812a-4317-40a0-b91b-c4879ef4fb06,Healthcare,0.49864483718079855,6,50,100,208,108,11.792183483674323,6120
64b78c9b-8d31-40fd-bb62-d6b3b942b1da,Educational,0.2628318108561727,50,3,17,287,270,27.23288484976392,4151
0f33b4a4-c2eb-4506-85f1-94e973c049e2,Educational,0.2074597819474986,27,6,532,914,382,20.76650713077584,6391
bd7117c7-ad38-4d26-af9d-31a7204f6212,Healthcare,0.02535331226114712,13,32,395,611,216,76.23293437655911,9418
59bc0091-12d9-4cb0-92bc-22eba50e8ae7,Healthcare,0.5736026180163668,34,9,619,882,263,64.89653705369452,5312
8bb04ea6-7f17-462b-974f-03ee71935b28,Commercial,0.5309952425878386,37,25,418,1368,950,59.4059145374215,4800
8a2498fc-d887-4b67-bb3c-44a07dfd7d4a,Healthcare,0.14719411595812004,27,42,605,1374,769,33.101329104291054,5213
a41d9ebb-3f6f-45d7-87e1-4487cbab56a1,Educational,0.825766570588127,32,47,375,861,486,43.33198033663882,6042
9b3e0b2e-a352-42ad-ae10-e383b5ad21fd,Healthcare,0.36680450154080324,42,16,418,1264,846,79.87657732335444,3814
8b652ac3-4ca9-4783-b0fc-7c76671f6c2d,Healthcare,0.08863496158735917,11,28,125,1126,1001,72.18887082179032,2820
851f1d89-4136-43c1-a6fa-186e500a849c,Commercial,0.49428333654529244,27,21,499,798,299,10.61927248827722,6227
fa6e0021-19e8-461d-b3d3-6beb5b60ddf5,Educational,0.9125628983466898,48,47,152,1277,1125,51.245584610027635,4520
3265bd96-995e-4bce-9361-b975d9d1daaa,Commercial,0.7895014426110685,24,31,34,503,469,36.019987633836365,6927
36e132cc-8abc-4747-aa6f-4972885cec32,Residental,0.6006386780739305,35,18,75,1198,1123,15.866873513626901,2068
17b0f224-087b-4baf-8ed6-e03749c618c1,Educational,0.5258719786353513,31,50,149,1120,971,94.52494709162676,8981
f8e2e613-7519-4ad4-80b0-d8caeb757b0f,Commercial,0.07319684319861963,47,21,5,1395,1390,70.51382827358057,3653
27a879b6-0408-4107-93f1-e5fea168ec01,Healthcare,0.3123199036582721,33,3,531,1373,842,85.45640693892298,9605
9fc737d3-fbb0-4910-af73-10aa397a6485,Commercial,0.19411887956631502,15,37,160,523,363,43.57861019948118,5811
d27bea68-d7f1-4402-8133-7d1f85c7d41d,Commercial,0.5689839895653408,32,46,463,902,439,50.5984442509814,8481
8605a4b3-9d13-446b-8c2f-f9bfd9fc55fe,Educational,0.3252885609735158,9,11,379,693,314,87.92875237842686,2354
2b461cfd-a6ab-4393-af5d-faaf3b4ea2d3,Commercial,0.2944466308663848,48,35,163,1197,1034,55.33573517218485,9496
01324edb-608f-4506-8244-60b2dbb65fa9,Commercial,0.8360838090756557,43,11,476,1227,751,60.011031645515516,2418
c2fe94ef-dce2-413b-9a9a-27e65261315d,Healthcare,0.9958078413601625,22,6,26,1300,1274,19.009815808572114,2793
0f6c5b9c-a254-493d-9395-d4abbb0325bc,Residental,0.8642326493214607,19,26,385,1115,730,11.554858434533985,4875
dfedd17c-7574-4dc9-8964-4136623c0b38,Residental,0.8402946462181323,37,14,372,492,120,10.956206283970882,6279
41147830-3b6c-4976-9966-ba35d84469de,Healthcare,0.5895974161804483,46,17,162,474,312,24.489978414231658,8241
0c999ebf-af49-40f6-8f94-1b197990bc7c,Healthcare,0.30479255196931665,4,35,686,1246,560,51.02730040178047,7978
8f93d392-8189-44e1-b73e-db9b5ae8473c,Residental,0.008727995804358346,42,40,422,1287,865,61.65221143482827,7270
1805d028-f1b9-4bc5-9a6e-16c51c7ac8ee,Residental,0.34031883155215104,16,18,594,827,233,66.18434897191865,3692
41462763-884a-4dd0-aac7-915712578008,Residental,0.7001638202480508,36,22,719,1023,304,64.87550375685078,1770
ed0c3156-414d-4094-a95f-c59f12e053db,Commercial,0.3085142813492795,49,4,149,226,77,29.171347423543526,5841
1aeb5aeb-3787-474c-bacc-a6b809aba8ba,Commercial,0.4345918252322749,39,41,459,1384,925,81.9096918944006,4084
ce29c559-7a0e-425a-b90c-5ec5cf73b066,Educational,0.47262057858915907,20,47,378,1241,863,27.60108589559122,6050
2bb0d977-b4a1-4dd6-bcb0-54a4f9559e7e,Commercial,0.15284252467576065,31,40,87,647,560,36.033486151562016,5106
6eb5615b-9f71-4222-872a-3df88e903ea4,Healthcare,0.32468516447315876,36,2,399,1023,624,49.35325748091643,4790
b01ebe95-c5e1-4df1-9d78-c306dbecdeab,Educational,0.881884218117088,22,24,179,287,108,77.13919468812597,3053
0602f157-62db-4bfc-a6c8-ecb0a756640b,Residental,0.6373151602901552,38,16,125,1204,1079,76.5910395530353,5195
d3718257-e734-42ad-b41c-61ceb4d431b0,Commercial,0.3981524335803043,4,34,489,1398,909,89.63693971880046,2407
01cb718f-63d7-4455-addb-2e4d2a879ac6,Commercial,0.5721313809729822,4,13,142,1267,1125,50.743506702517585,3285
5664566c-be27-46f9-b19b-e6f6812ca7c0,Healthcare,0.8173306425337964,14,5,573,788,215,86.96636494296875,9310
4cf16aef-4d1e-4fe1-9421-4663f2610060,Residental,0.6580252253825344,8,9,498,1302,804,91.96534415551996,1494
6c05df8f-8d13-4238-a2d7-74fc739b2c29,Residental,0.6992140976899159,23,9,236,1409,1173,32.280764168845295,6754
6b8f5dd1-21a4-4d22-9321-1e56d5bdfe59,Educational,0.9435873761744105,40,24,351,1048,697,50.806246303540135,9992
a53ec364-1408-47cf-9620-ffcfdb52abae,Commercial,0.7797796822866105,3,31,110,570,460,36.42347791902374,9373
ea33fdfc-9160-4584-ad08-6e54a9e77d70,Healthcare,0.11681068013090401,21,30,507,1103,596,80.10466812652751,1660
6c6866b2-a1e3-42ca-a382-8e35edf731c4,Commercial,0.0450443231291775,31,30,255,668,413,24.337005965297024,5874
5e7763e4-5b8d-498a-b97e-27e3e578d06b,Commercial,0.3478463569757697,19,32,590,762,172,46.408702863466566,2620
c44f6361-3f1b-4715-9d42-1e49a9b2bc0a,Healthcare,0.7699863235697083,40,17,346,1164,818,35.378098011210724,3357
67c4f1f0-a0d0-4ca5-8cca-6a8643ea7528,Residental,0.7681997030405002,27,23,64,1295,1231,51.82165682645541,6920
97d2c73b-cac2-4c78-8e4b-76a70f7be963,Healthcare,0.21825488172376362,22,19,296,1169,873,16.46077085517892,2240
fccf6145-7f6e-4b96-a000-fe5c24a59ad5,Educational,0.33826306012796326,20,50,36,1367,1331,84.4064316102031,2078
90999af8-d773-4c6c-a6f6-b0667e3932a1,Residental,0.5307220038153728,45,12,236,348,112,61.033417134417306,6283
cae54559-b3ff-4698-a3ec-004e06a33329,Educational,0.8831865098737414,10,45,243,414,171,66.23126178719782,4448
dce378b5-270d-4bbd-868f-224283f21c1f,Commercial,0.2037666634707177,27,10,669,1345,676,28.671843373033685,2848
64f54506-fcb5-4ffc-90f8-cb87d0dd129b,Residental,0.2015808592026569,44,13,446,843,397,12.493298825274561,4939
b07a53a8-b77b-4fde-bcea-08ea2085de95,Commercial,0.07257021506363881,17,6,301,957,656,51.63639512932638,2286
c60ec47d-91cc-47ff-9ece-aed1de593e3d,Educational,0.1135538765069436,29,31,174,1119,945,31.092612207194787,1429
3276453d-090a-4b7f-bfe0-df09fa809a08,Healthcare,0.8341522254337461,14,50,158,575,417,74.95997272057494,7278
7a2671a1-b639-479f-9ac7-8a8b10cfd892,Healthcare,0.23270053284525616,30,15,196,563,367,72.30497676620163,8448
378b7a5c-b0a7-4157-b00c-0a48ce7843d7,Residental,0.7462875412966126,3,48,143,692,549,16.38508254566088,8302
ec892a8f-9b08-410a-8dc4-da5d3cdf5a6c,Healthcare,0.20380768917804093,9,43,514,1149,635,49.12427389808185,8500
07a8e2df-d1f6-4e5e-87cc-461005e1c078,Healthcare,0.735440763028951,19,4,327,348,21,14.677671473528555,8476
392de6eb-980e-4235-9369-103c1b2f6120,Healthcare,0.3585100691525003,4,37,522,1018,496,96.04098651758173,6686
87ab9048-dbc1-4307-b6b7-26ade87007a6,Commercial,0.23173906957577162,44,20,400,1296,896,13.402073630131856,9951
eb41f086-2689-4036-b3eb-a8661b8a3900,Healthcare,0.8858167909411271,10,29,41,744,703,82.93494775011825,3998
27a89a31-d570-4413-8688-0d1632e6507a,Residental,0.2809825878951362,27,33,393,1376,983,40.23982065184205,8797
d81b973f-5987-4fc8-bd80-5837dd8979a1,Healthcare,0.6949945997591124,11,24,456,1403,947,45.47912905582017,8102
93058cde-bf95-4550-a985-97ef0ee4e711,Healthcare,0.8592079737191262,8,35,349,1262,913,43.99467944090408,9519
8e6680d1-112b-4005-9906-eb5da17f84a2,Commercial,0.3961814891351402,45,15,604,861,257,13.778623927924995,1856
0042fda7-2d17-4f31-9958-5119fc1207fd,Residental,0.55968851845293,4,43,290,502,212,49.350147720268026,2962
2542e979-999b-439c-8c91-2288897ad05f,Commercial,0.7828562568541245,8,3,330,545,215,21.334435196001877,3809
a69df004-e0d7-4c3f-babb-c57772968186,Commercial,0.8321223197137251,47,48,320,565,245,85.52587060202475,5454
97f94f59-a5d2-468a-a1cd-cfa8262de519,Residental,0.45659274642657977,13,15,674,1000,326,90.18536775066836,2959
ce806b8f-1cb8-44bc-94a3-9fcd300e1276,Educational,0.18408439796787401,35,20,141,1190,1049,16.737180842279244,3745
60a46381-1441-462e-8dfa-8eab84147838,Residental,0.35904249154370216,3,10,641,706,65,87.8312007913399,5730
5f8f31cf-d61f-4da0-9085-840cdf304004,Healthcare,0.3300171510657175,11,21,219,459,240,52.28676067152177,6172
3952642b-74d0-4e69-b96d-a518c64dc313,Educational,0.3008826265349377,49,20,464,1350,886,33.939276656671346,4350
c8b3655d-8031-45f0-a4c5-9abc778a8822,Commercial,0.7186898303969056,6,32,352,735,383,20.714371498791174,2932
f0d77a91-01b2-4153-9214-3c0523580337,Educational,0.9218214589051948,25,50,323,363,40,86.74362749875665,9565
f5887342-970d-4054-a5b3-1bb01e5e5dc6,Residental,0.8241022640539641,21,17,385,882,497,43.92366673993944,5269
96217570-2315-4e52-ac63-6d7fb355edda,Healthcare,0.06588110792189039,44,20,288,632,344,45.8819475659851,4636
a017ef83-ce50-4034-b5c8-a4d308f1b287,Residental,0.010821923018198065,7,24,275,1434,1159,26.281295770280234,2034
d785d116-2efe-4b8e-a558-505612ac29b6,Healthcare,0.8955391089059632,29,36,500,564,64,57.26717624078992,7747
fc821831-7d8c-4923-b179-803d70a73004,Residental,0.15645561437798983,41,34,328,635,307,32.624002493868076,8499
490a6f15-3cc2-4c82-94ef-3186a0ca5f2b,Educational,0.9461777234785835,3,23,167,1336,1169,38.631514893183535,4690
8e7baa7e-3df1-4d30-bd36-30b4754dae0a,Commercial,0.22784668878073566,29,22,190,928,738,44.23032860595998,9285
f0dd5616-460a-4361-a630-9ce4cbc90ad0,Healthcare,0.9085847613845306,30,13,272,284,12,46.32098910035566,5617
8a2e48b5-cb52-40fd-8ae7-7ca7d414215e,Healthcare,0.6439912045413064,15,15,703,711,8,82.60040896974506,5243
b594a485-8d66-48e0-a750-9c1279853d09,Residental,0.1091950429997699,3,29,205,979,774,79.47890146504734,1079
ca3bade4-c348-4a75-b651-ed8f3bfa7806,Residental,0.18322427811587771,27,27,341,353,12,34.41967611956394,4381
4510caa2-a043-4420-ad73-df56324b92ca,Healthcare,0.33163615763057464,50,28,188,1333,1145,58.76709787972699,3007
df870ba0-782d-45b7-b6ee-508a3d3ca0cd,Commercial,0.13090407537346038,4,17,435,1437,1002,88.15569958567444,1551
785fcbcd-5067-448f-8a0f-398901553a1b,Educational,0.15537274709003168,32,43,185,403,218,45.018900174811826,9396
ed78b1ea-e634-4b93-bbd1-b13564c7e931,Commercial,0.43194909116796476,30,49,10,16,6,82.36715660553621,4895
2d4df801-af01-4cf8-aa0a-b87119f16f2b,Healthcare,0.1650102948474923,10,45,422,926,504,94.84427197024539,5263
7a3c3db0-4c79-4064-868a-afea56c4c555,Commercial,0.39872308368758747,47,29,589,914,325,79.99952694179267,5207
aa403df3-fd65-430d-ad71-cfc98e7175ad,Healthcare,0.4430769119036979,46,24,22,1000,978,73.87896805382594,3804
eba1a709-b0ea-484b-8aa4-bf3ec2e56d69,Commercial,0.8230247725499369,30,37,527,1045,518,89.9486546720326,6995
6f0695f9-a0f9-4f71-86c0-44f841788275,Commercial,0.6263904514770952,17,41,546,1331,785,78.3965687448827,9393
66959883-5e03-41bc-a861-f92525c83a7a,Educational,0.5895770296651848,43,24,65,1355,1290,37.68055784826579,9928
124e1035-6938-4d1f-8e7d-4e486890372f,Commercial,0.5705447601990852,47,7,602,842,240,23.04819331934768,9476
7a3f3912-d3f9-406c-8c17-47ec00af7543,Healthcare,0.8542315490013703,29,22,183,442,259,74.50286639691076,6852
f801effa-fbcc-4efd-8105-fbe9e0178494,Commercial,0.5783880272382323,24,5,681,782,101,81.13395950322257,5915
74f79f62-61b9-4773-8a70-21349b4039af,Educational,0.8705101233419171,43,45,541,615,74,83.67065750410919,2300
1274255b-0f2a-446a-9f2e-474fc5d5f7cf,Educational,0.6700747829982894,41,9,544,762,218,69.98147070733125,8018
2616b832-7726-4447-bd2b-0d67d9c3618c,Residental,0.3138822047556552,23,38,557,1122,565,83.0310962221262,6547
9925ec3d-2241-4c67-ae48-2176e3ff3bd1,Educational,0.7444592733608972,1,49,325,1028,703,83.53349721421847,7797
f43b2997-1d40-4738-a47a-c64f76f495d5,Commercial,0.5562201485987173,46,43,155,296,141,13.967715423116609,3472
12ede03f-4001-4ffb-99c4-6772fbb8728c,Commercial,0.42191989881588166,3,21,347,1086,739,61.67321895516443,7634
1cbcc095-a1ad-49d0-a968-0377a6c318f0,Healthcare,0.7304085133908662,11,15,144,1033,889,61.612024800971994,4942
4f770259-1904-42f8-8000-567ccbdd4b60,Commercial,0.1449551642636444,30,19,431,558,127,83.9603734288229,2733
058c6428-53c7-4adf-ace1-77d6b4e42fd1,Educational,0.08146659905534437,40,40,81,277,196,51.60979306681759,9182
7310465b-2fce-4720-abb1-1a509c8e36b6,Healthcare,0.7046101876403995,14,38,412,436,24,53.018459824458986,7596
46ae7ae2-9474-4758-80ab-1792d78b3b47,Educational,0.032715726729687256,2,2,548,740,192,47.138452126984355,2221
62032b43-702d-40da-a63d-c8d244352b03,Educational,0.00954067098303879,25,23,136,833,697,39.70674050104598,6266
fe0ba4a6-a8a6-4f48-87c0-a080e2606ec1,Residental,0.19865388525738936,34,24,231,636,405,35.261516903311595,3910
51d4c089-4a03-41e9-9dde-851184160f2c,Educational,0.07737541698511896,20,7,335,1069,734,23.627343438073606,3019
2897f619-8af4-4744-b336-808d11c5f34b,Healthcare,0.601044692503483,28,8,82,425,343,62.834202175689455,7964
fdb3e326-235d-4483-b3b7-16d8c7a92f10,Commercial,0.6264879352653419,32,27,559,720,161,97.70081930819492,2392
36441e34-57f4-4e27-a4fe-79183262a4bb,Healthcare,0.7826399082085692,29,30,657,1355,698,15.137849689594365,6270
15d3fae0-3299-47f1-af99-eb4b6d2e5a67,Educational,0.3770172528690904,38,15,302,781,479,66.62199194547486,5296
2a9c54a4-8f63-47a4-8eb8-a5382082ac4a,Commercial,0.6418908092343844,50,25,636,713,77,29.177388050905712,4023
f5651faf-7114-4a1f-9f00-d7183fc8a698,Commercial,0.04524209704331417,43,8,136,314,178,16.462130826605488,1515
bf6eb6ce-00a0-4753-ad62-19d5c10a9c03,Residental,0.5071058120203402,11,33,475,513,38,72.73517737021061,6164
b353a464-74f4-402f-a111-f90040111b43,Educational,0.7228521969223225,8,32,216,780,564,72.16813748996982,5786
79d4dd2f-4c70-43d5-9488-40468e6e9d85,Residental,0.30022796543942176,1,10,95,333,238,59.433357381680935,3504
66165628-5195-487c-9179-a69598a5c6a2,Educational,0.5872900174399656,36,26,637,973,336,24.529663517276553,7282
78f9fefd-026c-4863-82ef-66970c3f5918,Residental,0.14973771377415812,45,42,122,291,169,36.40973644520557,7267
26efcb85-dcea-43ea-b3aa-e6cad1a031fa,Commercial,0.7977498788694313,28,2,486,847,361,61.6824608941385,3941
a378a3e2-41ba-4931-b99d-ff7d29781bf5,Commercial,0.6412706196951753,32,45,589,1335,746,98.05776097249385,8977
9c914623-e89b-4700-a499-2a54933a02fd,Educational,0.6979277033955207,33,27,680,1212,532,81.62146541655181,8838
334f7e4f-3775-4e95-8690-3a3a72fd12b2,Educational,0.4315049669025104,38,33,53,1313,1260,63.41388581666726,3546
3834e73b-c9c6-4195-955d-a41a5a780e88,Commercial,0.8914611188201345,28,20,61,345,284,79.53400941390551,8584
07fe3f14-204b-48d4-b2fb-25ee1c7133c1,Healthcare,0.8978378652483768,14,28,423,1031,608,25.169249540832322,9375
3582c5ad-e001-44fe-b494-bec730bbd99d,Healthcare,0.21394661696551565,6,17,620,1304,684,59.320673174876696,6836
7b19d156-d391-49e2-aa3a-8642dd158038,Residental,0.49744567517101446,44,29,533,1152,619,97.39108237485583,7987
79670ac6-51f6-4dfc-ab03-9499e38d1932,Commercial,0.19303542234006388,34,49,612,1032,420,54.969628110644365,7900
94ae61de-df08-4207-9619-9fe5259adacc,Commercial,0.016556470637807186,38,40,698,788,90,94.9988918189031,7216
688881c7-be22-4142-a22a-e79dcf9d4512,Healthcare,0.9146370752573839,8,38,123,759,636,28.589069769263325,3570
ab0098d9-746f-43cc-a47f-c90981babcd5,Healthcare,0.22479485289147105,39,33,490,876,386,70.99089938450408,3720
ac1de693-f87e-422b-8aef-993785b6cc5e,Healthcare,0.601889682941932,34,31,206,1365,1159,53.94426379736662,2711
7f867808-daee-4698-be6f-925a49066cfe,Educational,0.7146839120749031,43,47,14,1110,1096,66.53006493624744,3723
cf15ca8a-d46f-4d2e-96f7-78feae6a225c,Commercial,0.7935601855065761,43,33,697,1376,679,32.51985156709202,8474
45bfe9ee-e242-4cf4-b03b-ce3e0b4c4322,Educational,0.983171552019523,40,38,530,760,230,72.55849260919138,8223
04bf0b82-ea55-4ae1-883a-3550307bf932,Healthcare,0.14009449577430977,10,17,267,577,310,69.0524455758943,1087
1b190c48-2b64-47d4-9e21-075493c973ef,Educational,0.5160837079619824,21,42,538,1273,735,54.3511220211724,7899
f9513edc-9652-4f3e-b669-6a64d71ab29f,Healthcare,0.6974064908645234,6,42,643,669,26,94.81272047771019,5569
9f88a308-975b-42be-977f-ad306ec0c631,Residental,0.45831433855628123,21,28,249,472,223,89.23953109871466,5264
55d9aa6c-d059-49bd-a823-c5de75fbdfa0,Educational,0.31411354839550365,43,30,265,915,650,89.16179669787579,9493
1c6a8812-b25f-4123-accf-0176ef45837d,Residental,0.43649519399213377,39,6,53,819,766,58.27264211305836,2266
b6a5e7a5-fd6c-4895-a7fb-cb7572ad7fac,Commercial,0.11227338434747136,5,19,130,973,843,19.04345140894926,6153
baaf195f-fc99-4e2e-bed6-08a7def3dcd8,Educational,0.6063698209493376,27,3,155,766,611,84.86822410942295,5606
fab2f5c9-29d7-439d-a588-22a02454577b,Healthcare,0.4927583030440229,2,50,20,167,147,96.61224769249621,8099
6c474244-c32d-4f6e-a3b0-3f3ec30b71dd,Commercial,0.7711717777600532,49,20,668,1355,687,49.675602391358915,8696
b3a2bb6e-e1db-4269-b25b-c9d38e684472,Healthcare,0.08353991338546418,32,35,614,861,247,84.16417213575538,2920
cb043339-ba4a-470a-8bfe-9c5be4f77988,Residental,0.030237004580829674,47,5,334,1292,958,23.38631160269729,9318
7e0e8d51-0ce8-4ad1-b21c-1365f10f531b,Educational,0.3637619991471648,42,35,557,785,228,76.44015121858503,9453
0d4bde00-e1ac-4630-a15b-375b95d4bbfa,Educational,0.3760414050469332,27,7,16,1226,1210,36.51747347305578,2540
8c764d02-2a6f-4a31-a6a3-f79cddb1aa4f,Healthcare,0.02945898370232214,49,44,365,689,324,80.30241421880162,3768
62a5b798-c0c4-4864-b8ce-1fdbf5a646e1,Commercial,0.8442028919478344,37,42,552,1413,861,64.40058274246601,8017
662dda20-f9fc-4fde-a7c5-6033d06a226c,Commercial,0.2659175626688143,5,5,185,622,437,61.94618504433037,4648
3debdc49-c69c-4f44-ad62-6100a521b005,Educational,0.8475588263897077,21,37,217,940,723,22.780815718184,8164
6027f796-d66c-4ac7-bb9d-65f720d227a2,Educational,0.24122145525261796,4,35,16,448,432,71.11111840675017,9614
7a1dddc2-1a04-4b7d-a35c-ba07b34899c2,Commercial,0.9061521407000672,5,37,293,901,608,74.74112673393574,1323
88537bd9-79b0-43ea-8edd-23c8b5e136b5,Healthcare,0.3771639487257826,33,28,521,682,161,64.63857599812239,9052
6dffda65-ede3-4d94-8436-d5a1fd76b45b,Healthcare,0.8973082066607814,40,14,398,976,578,97.70827796909747,5585
d3c588f6-d501-48f7-b2b8-d5d44cdb522a,Educational,0.33431524746776886,17,49,458,1292,834,69.47950035657936,3638
edbe5ea6-e395-4036-998a-951d857b00a9,Commercial,0.608684952563329,30,14,644,1299,655,89.88043378204937,2026
5217cd36-df01-4f12-9aaa-c6b58abd209e,Educational,0.6059459237432155,12,29,286,890,604,70.98883556206417,8753
97bfadf3-e80b-452f-9902-52e4c73e9a99,Commercial,0.4273485836966001,27,23,321,924,603,81.25037976702222,8401
88896c6b-4912-4bea-b287-b7414c4ad232,Healthcare,0.4729992579290455,37,34,432,526,94,61.11786907425195,8358
6cc2083c-3319-4337-a253-a34742692bc0,Healthcare,0.998100743509229,24,14,3,1426,1423,63.22963089266843,2865
ddd8ea78-6e0f-4d65-b66e-19e61c93c92c,Residental,0.9106045877595386,5,3,623,1143,520,16.425925339839818,4610
76074e58-21e4-4999-9c05-83edec955dcc,Educational,0.8966601167382134,35,18,539,839,300,13.798434925097247,3415
063f4478-4226-4b53-bb88-0a06dd82c303,Residental,0.2733393696069778,2,14,679,1029,350,64.68523674469901,8014
e7bf434e-059f-4a69-bf0f-5faf74e43164,Educational,0.2448289744193184,4,39,491,499,8,99.78508914397344,7354
19084795-906f-42d2-83cd-85e6be56bd54,Healthcare,0.16638040400188414,17,49,222,584,362,41.31362634494549,1846
ecfbf9f9-637b-4afa-8bb4-186f7e1fb7c8,Residental,0.5729318084971423,1,29,198,1382,1184,59.12652672245444,9149
71bcaa64-dc93-4f68-826d-80a350d010c6,Educational,0.5946297395595097,49,10,706,924,218,97.2427888732549,1688
c630b5ff-7f9f-42cf-98c3-085b12117434,Educational,0.06474309522137522,1,45,489,838,349,71.88018064404716,3753
bbc02ce8-d5c0-4fa8-8555-d55e91aac9d6,Healthcare,0.9686203722939603,24,3,536,544,8,64.30475947587014,1428
10daf47e-0394-4230-a647-99607040318b,Residental,0.582581914677074,10,41,167,1383,1216,93.71406124430584,1062
815dd916-f1af-4c8a-a782-0d2edef70ab4,Residental,0.05503879615584062,21,23,149,902,753,43.725890635603164,5442
2bc416d4-758d-4c53-b2e3-ec16fdad1369,Healthcare,0.9789235584911391,17,16,27,98,71,45.94231756923316,8624
14b3819f-d15c-44f6-8b9b-8a7fa95ec12c,Healthcare,0.18098051952912164,18,34,444,959,515,47.78471098028392,8475
0a31b818-39d7-422d-b630-d5e3081333f1,Commercial,0.45263953760206554,48,50,165,688,523,24.952443119347876,7035
7ac3de99-d47d-4e3e-944a-22722713d262,Healthcare,0.11320439262249549,8,33,230,1273,1043,68.4682665254069,7168
d49438a3-9df0-4425-ae3a-ba7f6c12f1ac,Educational,0.3851477120668345,27,40,83,1335,1252,66.98980663373129,7822
b91a65c3-6d61-4479-bf0a-f7dd1f7c470c,Educational,0.3135781556553958,25,40,112,1395,1283,30.212819648959226,1400
6363a617-1627-4800-9df7-ec479739fe0c,Commercial,0.9510466730962058,36,48,327,773,446,54.74884259157434,8516
626bd623-12ad-4900-a709-f02ade3b5c2e,Educational,0.6523264006160521,31,34,486,648,162,78.40622993701824,1345
9e589bda-cd2e-46b4-893b-a512a4be76ae,Educational,0.4694783924628333,28,38,567,841,274,47.52985733750087,1748
65a32c0a-9f0c-441d-b4b9-e4f76796f870,Commercial,0.8309208655691315,34,26,259,274,15,60.26351205102593,3607
4ceba424-84ab-4412-afd4-7756618a9696,Educational,0.4235244403096107,21,2,448,968,520,37.16010154908399,4108
65d781e8-fadf-4810-8549-00190fca4002,Healthcare,0.4410146418945391,4,20,466,1356,890,83.32125525422053,3641
a555816d-b1a5-4e08-8e8e-4184279811c9,Healthcare,0.7676214488227913,49,38,598,1128,530,55.83582401857789,5655
d0b52caf-73e7-4cd1-9de3-48ca5e7b3820,Commercial,0.7524201162194315,1,40,52,1146,1094,49.87249620210688,5554
94d8ee2e-7ae8-4101-a3b6-61a578741e1b,Commercial,0.40511089872066663,33,29,369,410,41,26.328988756596182,7617
f7786ccc-5835-4ea7-9efe-3e3430d0af46,Residental,0.9505925495462493,10,18,183,1402,1219,94.42370778628931,5288
e1935c32-226d-4b90-bff7-8fdaa04daf45,Residental,0.8217139439873903,18,8,86,1001,915,84.20325537477507,5309
d4802b8f-f88a-4cbe-a824-d44f4c0b5c2c,Commercial,0.4093017080681427,9,6,108,1065,957,26.248207967259244,3359
32408e6e-02ed-4640-ba8c-174c8fd88ae1,Residental,0.24025268171038594,25,38,73,1405,1332,46.36968396902578,9761
3821edda-961c-4c20-9a5f-a0d8e429122c,Healthcare,0.39218922773459297,3,23,311,1095,784,91.14226873136239,4346
79e9b7e2-f1b9-42ae-8118-cc209a3c48bb,Residental,0.5480215233628783,30,28,469,662,193,75.11614111995081,5529
973ace24-4ea2-445e-83c3-2ef0cc028ed7,Educational,0.15864835654496345,48,44,663,834,171,61.73262664918247,9982
b8b351d9-5576-4688-89dc-6a71f15f3490,Healthcare,0.6613895187019937,4,19,395,471,76,21.397460877729515,6478
c67842db-1de6-48db-b819-8966b37019db,Educational,0.7837238546438234,40,38,527,1335,808,82.8582114182467,3377
afe51e8e-b21d-4145-b81e-c929c7e42c84,Educational,0.2747016654628892,22,34,246,717,471,27.23970539159818,7966
7c632667-889d-493f-9e44-fa31126dc564,Residental,0.5645213213984236,13,32,58,737,679,47.30257802847954,7923
fb577b38-5aec-463d-acc4-1f6eeb47d682,Commercial,0.8473305604734677,31,7,675,1060,385,69.66440563100534,3296
bc6523fa-b5e4-433d-a3b4-0dc2ff302de1,Educational,0.528266054457193,39,36,606,1276,670,26.613855904225055,5005
de6ca314-d606-4fc7-8f9e-e2c46be2fcb4,Healthcare,0.3216169337000736,47,31,493,1063,570,81.13301076643172,5479
d6d71569-7c13-44cf-a655-6ad9a6898c5c,Educational,0.9742639244487602,28,49,71,174,103,67.80641631334032,5998
a10b22b4-13f3-4c8c-9c9a-6829473df3b8,Commercial,0.2257109864127984,43,14,505,1135,630,66.61593623551073,2826
576d67bf-d3f7-480b-bb67-a7a631664612,Educational,0.05723905058442569,43,28,648,1002,354,50.57761685915126,6135
742be225-a74a-4d2e-8ad6-5c595c2ab260,Healthcare,0.12110048338985369,28,28,531,668,137,15.206685265425817,6469
4493af1e-a519-4205-a7e3-b4e7e0ba80bd,Educational,0.15028746170330098,48,9,707,878,171,81.61037529371254,3894
e6dba3fa-e51c-402d-953d-bac7274dd9a2,Healthcare,0.8780436250146821,17,41,488,934,446,65.70156139285262,5361
3f09fc3d-b57b-4705-9929-738d631d443b,Residental,0.8001482225393622,30,50,683,1064,381,40.77167438969822,2222
2741f17f-d7b4-4044-b915-67d28209d117,Educational,0.8218747545374345,37,25,513,888,375,52.03936890981265,3331
cfbcc238-eda7-4809-8249-c7aa5ee09946,Healthcare,0.8496355802982015,26,30,676,822,146,19.3767136433605,1590
7057c4cd-8f07-473f-b48c-07d4254505b2,Residental,0.31274078714065945,39,28,453,732,279,54.53233471358242,4210
2e662878-1b57-4784-b60c-ff3d79de7ec8,Educational,0.6991950706218567,43,16,128,1247,1119,64.14216121814982,4103
01b2e40e-33c1-4233-a433-e811d1a08c6d,Residental,0.5816759126315427,32,8,490,785,295,65.27595338445619,5799
cdba635f-fef3-4098-ae93-76ff4bbe45f8,Commercial,0.5119284314418285,40,28,504,1147,643,67.67065446611178,7038
77dadc25-c193-4b6c-92c4-47ce773bc14d,Healthcare,0.3248578878941697,31,2,427,636,209,40.46129115993976,6124
b8a46da2-e84b-4697-805c-11dafb5f04bc,Residental,0.6736604152744397,37,9,337,1346,1009,61.60804461552351,7697
60c6bad8-3dbc-4a6d-bd86-f27bad9f24e7,Commercial,0.28241557617603885,49,46,387,642,255,18.27776057857711,1774
157c5da2-d2ae-45a6-a4b2-0cb6a17c935f,Residental,0.7653962153573761,36,16,84,674,590,54.16184347080265,8379
fae83d7c-5be6-4d9d-96bd-51e1e1d27de4,Commercial,0.508577486474223,15,35,278,1337,1059,93.67423582063253,8916
972a28fc-ba57-42f2-9518-92aece3c7407,Educational,0.008366467377377007,39,48,287,1403,1116,31.868304634632846,7991
b18619dd-9c4f-4365-880c-2b0d4f4b0510,Commercial,0.9984414046658057,43,19,425,675,250,18.753325370846973,6680
6be01ac8-cf31-46eb-be24-3f26a41a8b53,Residental,0.22612648018182624,31,43,59,225,166,89.65067266087317,4400
53f5c291-0df5-4f8b-899a-01bf5a48a5bc,Residental,0.3876394260742383,2,10,542,1390,848,51.28957472570768,6456
46d8cd43-3973-4450-a8ef-153f4503ac60,Educational,0.02632980604201718,29,10,376,1188,812,65.67135461568387,7430
0d3c1f7c-0430-4a97-a887-66cb93acb47e,Commercial,0.9427812475196633,34,43,240,928,688,29.710669120953764,1854
8fd2b6c3-9eec-4956-b3a9-e0997924fefb,Healthcare,0.92674602266873,32,25,8,735,727,15.764361557903769,7562
7a188204-d940-402f-8a59-14ea4f2f813a,Residental,0.11622644008822691,39,6,535,865,330,28.05939275399418,3449
14771dac-524d-442c-88a3-7d97cdf3baf2,Commercial,0.22827701568629144,29,22,186,260,74,74.39312087844755,2174
a06cb922-6d4e-4842-a1b0-335b86e49ad0,Residental,0.030536339673466806,19,42,679,805,126,76.62797184388913,6064
3d9369fc-dc41-4bfe-8bb1-5698ee9f11f8,Educational,0.41198890910828057,27,10,677,824,147,66.9684585773847,2098
57bce188-c53f-4878-95d0-463dfeb5a353,Healthcare,0.2074860479874201,16,25,216,1189,973,65.24096143922873,2782
d1095cf6-34a2-4951-8081-2bf446a38dae,Commercial,0.8300893981402587,19,44,499,980,481,99.85268404739001,8410
aa5f7095-0d25-43a0-bea4-493581817b05,Commercial,0.24982372602652947,28,17,612,735,123,96.36670702403997,6849
b4ec6159-13b2-4158-bc53-48779bd3ac3d,Residental,0.6760242485802923,33,30,476,552,76,66.9309053823177,5645
74595793-2253-4f8a-87c7-7e92b313d199,Educational,0.23780835636390396,7,16,418,988,570,34.93802134937296,2677
d9d06dea-15ac-4d00-b8d8-334e7cc385a4,Commercial,0.003153631723974093,38,37,88,1057,969,81.86405471296048,3546
be533bed-6fa4-4919-b93f-4508a5849240,Commercial,0.5115636934205522,11,5,355,1165,810,23.608050434663376,4599
a7a07fc2-5e4f-4ef1-a59b-a09a1119c843,Residental,0.1370620756446711,47,7,641,1300,659,81.30007581744135,8322
8bc4101c-6ba1-48b8-b6b8-07e4d622d6ef,Educational,0.5699552920176352,30,33,153,979,826,26.373804460507216,1949
1589a0f8-fdff-4629-8eb8-a9ba5c7cc2dd,Commercial,0.7985047102771683,36,26,308,883,575,51.96803729792465,6989
cf617467-c7af-421b-b376-238b857bb736,Commercial,0.4322430927219896,23,11,611,1324,713,67.41469412318999,6605
d4ed76dd-4ca6-4e29-aff3-c25cee69ecb4,Residental,0.08146470009992612,18,28,196,551,355,52.592786161160475,7219
268aa7f2-4d8b-494b-925f-11e1b15f4d20,Residental,0.9777003383228258,6,10,678,714,36,83.42398514353181,7316
12ecbe8d-a7a5-43b2-ba83-c1daf5c25a42,Healthcare,0.5439212434612027,42,23,212,1217,1005,87.52988038796207,1927
063ea8d0-32dd-443f-a81b-61894957ab5a,Commercial,0.3788540267281645,46,48,64,109,45,33.32633086150591,8174
6321337b-9c62-4374-862f-77ffc4f1fde1,Residental,0.18319378672970665,19,37,199,846,647,80.680343830871,2402
cc5d8171-cec6-4075-93b1-21a77dc754a3,Residental,0.2558354114494098,26,13,152,738,586,66.01101590062947,4640
243a377b-999e-4b1d-bab8-5650d8f6e6c6,Educational,0.3312587465325765,23,3,256,584,328,59.5977995534914,4540
5d0c8adb-3e58-4b20-b9a9-36dbcdc66b4d,Commercial,0.9995101857823923,18,12,232,389,157,70.2447739903177,4767
184a3593-e913-4fda-989a-eec84ed0759b,Commercial,0.4310089553369243,37,24,242,1321,1079,48.06004747073654,6098
1cf2a78b-b69d-4755-93d0-ad2fdb7cd8b7,Healthcare,0.7813210104286424,46,5,183,1239,1056,72.64792240181274,6707
ec4d1cfa-dc74-4125-bb6a-b5adb21e4d12,Residental,0.24543574416921898,45,26,234,1344,1110,15.469260882578578,7243
bf104fb7-a9ce-4feb-8597-be99ed21c6c2,Commercial,0.8222052114502509,5,25,143,1025,882,64.48698786148674,4239
c4f00014-dae5-4493-8e55-27889aca0331,Residental,0.31723517955240943,23,49,658,849,191,18.828167932114955,8256
76deaaf2-6575-4d26-a4fe-3973093a2c54,Healthcare,0.32128819905900874,18,50,48,1117,1069,54.427990824940046,4098
85a66f2a-9a4d-418b-a4c2-05832bcdc571,Educational,0.9572191658844136,1,34,328,1287,959,96.1755066655621,7559
0c7802f0-7650-440a-96b2-5ebef51790b7,Educational,0.2768770002953601,45,11,410,867,457,62.58257761255768,5167
83cd4078-e50b-4748-a95e-c350972755c3,Educational,0.9076341176753185,28,4,163,1384,1221,16.7676577587536,2417
4d408c31-71a0-46d3-84c4-e5c282323696,Commercial,0.009784004499773125,31,36,519,730,211,72.47154936442786,8296
59892829-245e-4065-9826-1ae4327498df,Residental,0.2500907150813626,48,43,373,977,604,62.39148292138666,6083
d38fff37-182d-490a-be58-08f43322e2f0,Healthcare,0.9698702988367158,5,30,434,809,375,89.33303208027301,1977
b2fc9865-0c4f-46e3-8e0a-9dc7a8acad9e,Healthcare,0.6315736442663435,25,39,435,855,420,47.38375150072372,8248
a7f858fa-defe-4d21-a776-4f14469d4d0e,Residental,0.4934796438656194,50,41,569,1297,728,43.0689372207764,8988
f2a09a8d-8831-4ec7-b50a-f8e0a6e80c01,Commercial,0.10299591105453232,44,18,177,760,583,32.93190328618316,9826
f11d7f8f-1ce1-42ac-9dfd-eb3abc9a2fea,Healthcare,0.35117164575339443,1,6,209,1438,1229,85.41342260155828,1769
c408b6b7-61bf-4da1-b30a-bbc49286a106,Residental,0.39520685657351273,14,46,378,1440,1062,26.102917667471054,4875
b08a27af-7b80-40fa-9a49-b07fa037f6dd,Educational,0.7682228873381675,17,18,101,285,184,84.85076527129841,2794
7ed9b055-3560-4fce-8558-02a4094013fa,Educational,0.6613973332127964,49,27,272,759,487,12.83224443546181,3442
59d91bbf-5420-4e67-93e4-4d5c49627b71,Educational,0.3297448685215495,25,15,601,1380,779,96.39437665245813,3952
a5ce2c17-cb9d-4e77-af62-5b46ffdfa624,Commercial,0.8470260830809498,1,25,122,1011,889,30.80902849706919,6442
9d34eb40-80b0-45aa-ad51-07a9066ce241,Residental,0.03064226981819651,49,42,92,920,828,74.02376855197231,4790
3f5d17de-5a22-481d-a961-0c607e4af2a4,Residental,0.12091589848531437,40,14,622,841,219,89.11326850046434,2425
64ec3445-bed8-43ff-8f02-f96ff01e8729,Healthcare,0.565660443950457,7,40,605,851,246,64.26273183382943,8111
bc0e8c47-65b7-432f-a0b3-07322a6ded10,Residental,0.7235981926183822,6,20,665,782,117,52.39546853683052,5954
bff94668-f535-445d-b8fd-8331b3fb00a5,Educational,0.9417311301185192,3,49,634,1016,382,60.050617037077416,9532
96e9a634-0a05-408f-bdbd-dd88567652b8,Commercial,0.1686690712810297,27,36,277,939,662,55.13363102486158,8694
9bd19c7f-1945-4099-a5c0-363d08eca10d,Commercial,0.9083334389136526,13,2,437,1385,948,77.58038814409964,3392
e93d118d-9890-4aac-bc47-86909afb2966,Residental,0.7383938523073749,20,33,558,781,223,29.726574962284104,5268
3d7eb0f6-c541-4734-a49d-5cbfd5b09ef7,Educational,0.28858960792641064,30,28,276,830,554,37.43757400057139,5054
5da67f3d-faa4-467e-8079-f237d134bcf1,Healthcare,0.47046098942957726,38,7,299,1145,846,69.66804438869431,6913
87b9ea59-fc55-4856-a1b1-fdf18ad95e03,Educational,0.7065128778559306,33,2,49,957,908,68.4064124871098,1073
cb2c2bd2-2060-47d9-9be2-a9279a7e6231,Healthcare,0.16466988932385263,21,38,502,1114,612,17.94958349821514,2875
70bbc827-82b6-4aa1-986d-6f80ebc5a5ba,Educational,0.4687844794345716,44,40,602,1383,781,70.34352210072821,5752
d5f6bf0a-2c8c-4082-9cf0-a2c9ea5d380b,Healthcare,0.22729455215361227,47,25,504,1281,777,68.2141128699731,9135
f73088d9-33d2-49ad-9e72-5318c2925abf,Residental,0.6945525901522872,44,30,120,347,227,62.226078408248554,1951
9c4811c5-b4f8-4d4a-99f6-8eba09babd69,Healthcare,0.07820230548885432,1,17,89,181,92,67.22309389444978,7080
ae19eaf3-517a-438a-997b-b182fcbdba7c,Commercial,0.21205609704685358,30,3,259,1106,847,19.65710060388325,7581
42714693-19b3-4c74-990b-6fb535fcadd7,Residental,0.5995685471158604,50,15,305,1207,902,72.31115965317636,1345
ee179c05-67c5-4004-a3de-70a05dde61d6,Educational,0.5281198791473811,31,8,529,1428,899,47.15161403266755,9906
d63e1343-851e-4724-91a7-281b7586ea5f,Educational,0.8965014827776073,42,12,412,1328,916,17.789923437725683,8856
8eda3e4c-87f5-4d6b-aecd-4b90af054703,Commercial,0.08366126219956538,49,24,347,1202,855,56.70730282887418,9489
320e68dc-98d2-4a99-9ec8-7612fd0b9a20,Healthcare,0.2980192262433584,7,30,402,1019,617,82.40494968714111,5654
acf7bb95-9208-42d7-8259-e39e8ffd002c,Residental,0.18819730177232386,1,42,427,971,544,95.63629606975245,7527
896309dc-5d7b-41cc-b7c5-8398d7394759,Residental,0.8760303656078731,43,14,212,857,645,72.61988207459363,1527
28f45ba7-b4d4-43aa-85c3-63249ffa8e08,Educational,0.10430714687915099,20,20,49,739,690,60.22415480606771,1616
bea0d61a-66c7-4722-bf64-e32c34a70bcf,Healthcare,0.1625165360677937,14,39,228,1022,794,23.009530237758963,8509
0cdbe70e-b631-481e-8141-3eac14e9fc69,Healthcare,0.14994987572283458,41,9,571,1209,638,98.48699543648127,4750
d5206644-f8ad-4c0f-a2cc-1fd5be5a6309,Healthcare,0.6870107572384481,50,8,369,1400,1031,38.339020921555615,1830
79878e85-8eaa-46c0-80cb-66f092dc212d,Educational,0.7320271259238345,8,13,402,908,506,57.344134651129266,7698
3848ad24-27c6-425f-a6bf-7232108a40fc,Commercial,0.9950785095401857,32,12,153,1134,981,79.71923236405894,7592
dd110c17-f659-4c9d-8615-204a85d48694,Healthcare,0.03662875675360011,40,35,675,1103,428,42.13309549749632,1164
25952df3-6b30-416e-a69d-9a4266090b89,Healthcare,0.18070955256416565,47,28,319,1308,989,53.22288077457979,2705
016630eb-9d59-4500-a0ed-0eae221a4e5e,Commercial,0.35683255160815996,28,14,688,773,85,36.50185387445279,7606
c7a78fc5-67a5-4bfb-a629-e2582e4fafac,Healthcare,0.8622024514744007,39,30,74,1249,1175,77.81581936583048,9977
34c30f9c-0f8d-4f10-ab7d-90001a44e881,Commercial,0.6753549074795163,21,42,340,1096,756,33.08162418430473,3555
ddb881fd-593e-4935-bf6a-bf698bbfc285,Residental,0.6249714123027169,18,49,671,838,167,98.34888484556899,9228
6073d1d6-cc97-4254-8b71-b89e71d6b1e3,Residental,0.16653274794883655,6,5,564,1236,672,77.41489731655048,8670
62eb7b90-b860-41d8-b30e-51d4dff0b4bf,Residental,0.24277421128476195,40,18,240,1180,940,31.60922990219431,2282
b8c1046f-ad56-48e8-8dea-e7cf5d8235fb,Healthcare,0.48933366272172907,27,10,139,529,390,66.59427966765713,5049
704aa898-c15e-42ae-af39-bb8820915715,Healthcare,0.27287343842928313,43,28,537,1056,519,50.578509538528785,3603
29628de8-a0c1-47e6-a8f5-1e5bc37a8ffb,Educational,0.1495300811773681,11,20,210,221,11,77.91960352312933,1192
f04023dc-34fe-498e-917e-873937d9400d,Educational,0.3619588493948648,42,20,9,1148,1139,38.83399527548404,2232
b490dead-f268-4870-886b-c5dc17e1dcd3,Residental,0.40074669412704267,34,31,679,766,87,17.155686684596738,8404
f7d7feba-ca70-4bdd-baca-a8d6c868f697,Healthcare,0.7869306367312935,37,2,620,679,59,91.50320513905409,9037
145f9f12-3feb-4021-b9e2-9130b1e94966,Commercial,0.7868019600515403,18,42,456,834,378,26.110643539021126,8162
f81bdc1a-14cf-44aa-9905-fb21b3713d8e,Healthcare,0.8695416810721827,30,15,203,1225,1022,71.50885709662788,5331
42216519-77cf-4f26-ac78-bfaa40c0df97,Educational,0.8569730729699244,27,16,67,1070,1003,76.30904575442777,6049
92f132f4-6d0a-46d6-b9c6-0738fdce73dd,Residental,0.7702949437372579,28,11,447,1066,619,42.223204957948525,6480
6129a9f4-e1a8-47d4-971d-a66e90a3fee5,Healthcare,0.7875548451107056,17,31,316,890,574,79.1334619084456,7954
b5e8a08b-a782-46b7-a9d5-bd451ca0e1f7,Commercial,0.5188882037579376,48,40,204,228,24,48.09088413362159,4731
ca22a295-6cd2-4063-b225-31002a0b86c2,Commercial,0.8013124129835281,41,48,543,1332,789,39.82678599565088,3206
8cfb1076-094a-4c96-8948-d0a5dc3571f3,Commercial,0.6324989909126352,14,48,3,1430,1427,93.29705867112794,4731
72f39d8e-8a40-4696-a27a-44600803d660,Residental,0.8856810384761875,14,49,487,910,423,73.46527425768832,4763
8d5004c7-613f-4a21-ad55-4ee448c6bcd2,Commercial,0.8989278386166439,33,48,488,1163,675,27.218473366238147,5477
93cf6124-5626-4378-8e45-6f0105356746,Healthcare,0.968242829074925,30,42,13,743,730,50.764300990668545,9240
c16c2858-4eba-4bd1-805e-431319b8f31d,Commercial,0.30236361942474754,10,28,336,812,476,65.71347924358523,3082
752750d4-a57b-4cd8-a06e-e6098d4bc824,Commercial,0.6503262959196648,45,23,79,1246,1167,53.65055749545902,1004
1908951b-b5b5-47e7-9c3f-3a5ae080b594,Educational,0.8048711451180438,29,38,45,1069,1024,92.89821479081,9123
422c7117-f182-4e74-981f-7df448cc0ad9,Commercial,0.24540725621609927,1,16,228,768,540,22.27777969283496,9715
d824c046-5592-4b00-a1e1-f2e1c1456878,Residental,0.8789734998651932,21,42,247,1361,1114,90.78997666022573,3584
e932e7bf-f842-47c2-b1dd-0a20f00f4c84,Residental,0.48436794087109336,19,9,455,765,310,25.957125234604476,8112
70b558fa-31a0-40fc-8a16-623e2fcbfc7d,Commercial,0.7316504888568409,50,4,718,736,18,14.654842453358087,3621
9cb5fe9d-0028-4feb-9368-ab8b6c05164e,Commercial,0.6703737130119888,22,24,319,347,28,99.52993461104731,3897
e822167e-ce27-41c0-833d-b180bc04f261,Educational,0.1258029235211412,9,15,135,1267,1132,44.39087130666257,1202
c7837ab3-6d39-460c-b4c9-f2d94ab597ff,Residental,0.43814215645357313,23,48,347,886,539,92.40189419959489,1309
90857b86-38c6-4721-95f4-23476c385161,Commercial,0.10362477028510864,23,2,344,1288,944,68.21167545981744,6483
e714f239-abb9-473c-8fce-098f82d26060,Educational,0.19614809123307697,45,7,594,691,97,75.8332827995545,8786
308991bc-9a90-429c-927d-491113452ca9,Residental,0.23785174182639335,38,37,489,769,280,76.66680817077697,5037
a799ea02-2815-4b38-8cfb-7150af60bfa5,Healthcare,0.6616390492317136,38,10,629,1252,623,86.0484332754049,5165
9b55f12e-c7a9-426a-9296-fa2c53fec96c,Educational,0.12416147874822325,28,32,128,698,570,56.33886209989867,9226
f6bfacdc-f817-4af0-a7d1-826d3085e72b,Healthcare,0.7237008231126059,13,1,243,511,268,28.74218156162155,2683
506c1c76-26c5-4de9-8809-7dd84c813049,Residental,0.2146077402939517,1,3,549,913,364,84.33797695654673,7660
02b190e3-63de-4205-9c2b-3310b16c345a,Residental,0.647174130120423,15,26,311,535,224,66.03424132311591,8279
1b99f511-e46f-45ea-a7bd-15beaf94885d,Commercial,0.1498996614519501,6,38,319,1174,855,58.94827276042732,3097
2146fc9f-1745-4907-87dc-410db995df82,Healthcare,0.7932549781521986,9,45,170,799,629,17.85338612849911,7690
2fa8d6f3-9166-48a9-ac92-d5e4a684e8ef,Residental,0.8687358466611794,50,46,669,1401,732,65.76222024202912,9040
ecffc391-f95e-4834-b6ec-370f907d2103,Educational,0.42094269871261547,19,5,594,1280,686,54.790551807866066,1163
f361bbac-d7ec-41ca-a170-c0f1da91b241,Residental,0.18235194806938804,2,25,698,1237,539,81.49444558392162,5731
edbc7013-d3be-44da-9651-590bdf393746,Healthcare,0.820018441416453,28,25,242,1330,1088,20.474848530266033,5152
d57a46e9-1528-453d-94be-6ee511bfa883,Commercial,0.12831401679447052,48,29,703,911,208,66.53601278828094,2689
f0ba3cd5-059b-40ae-a1d8-c6ea235a0520,Commercial,0.8205185946832726,42,38,159,1234,1075,54.20272599387813,3269
6e640c54-102b-47ca-b4b5-c7fc947e3111,Commercial,0.6365089609732443,4,25,434,734,300,69.60393142989848,8354
f57b0f7b-1545-43fd-bd57-9b06e50c5b46,Residental,0.4307263311530123,49,13,33,920,887,71.40572581451997,1490
21873b21-38e8-464a-9c64-31a5f5f973c2,Healthcare,0.7307042166509359,11,37,140,1321,1181,67.03993965901174,5490
21c48d1b-5740-4e65-a159-7ccb549b5c5c,Residental,0.6213691907976923,33,14,657,921,264,67.36925065152684,3620
e9181fec-a9ab-4f5d-ae83-6ce539b7ca8c,Educational,0.6490299458656427,16,24,125,1422,1297,77.40810320294928,3388
e8509b48-5d47-4aab-a075-47462cff687c,Commercial,0.558472948845949,36,3,541,977,436,30.37585897932219,7598
41a9c1c7-7588-445c-8986-e1946a96045f,Healthcare,0.3914737161438704,49,10,235,481,246,67.12199191749784,4100
ee60fbeb-a6e0-4e58-b51f-53e6b2412a08,Residental,0.1275700582898398,1,10,376,556,180,50.433109215969964,4243
b20cac22-acdb-4c94-bbff-86bda0e0a9a1,Commercial,0.061858330097162795,46,45,569,693,124,74.12020317118854,7712
95efe901-2c4b-472d-99be-35c7605630be,Healthcare,0.7672659623735373,35,34,208,1304,1096,92.49194502136764,6673
feddd9f7-a21d-4efc-8070-3a298ff19dc8,Educational,0.27044954244865393,18,20,585,1175,590,24.463598630507832,6320
283f591e-87cd-44c0-9beb-65b7bf1187c2,Healthcare,0.6924043489105197,14,20,23,1144,1121,75.38068923456463,8118
d7d5c565-ae19-42dd-ac00-6dcc06dd4503,Educational,0.15953236490354017,18,40,286,348,62,57.94638976927144,5065
979ec4da-70cc-4814-a71f-d565ef57efae,Healthcare,0.833986082211518,18,38,100,1397,1297,29.899176224391095,3697
d2d82258-1fee-404e-bec4-aadc2248edfc,Educational,0.44825070161939573,26,8,357,1103,746,67.99213363196294,2599
c48ca0ba-ff1e-4cf0-be6d-0fd5c615c6da,Residental,0.5348086219064466,26,34,682,779,97,35.844068043793044,3743
28d7d17d-b420-4ff0-beb6-fe036d71df0d,Healthcare,0.917876616799574,7,37,393,1439,1046,72.54485877863789,2557
7aa3a1c6-1551-4e5c-ac73-0b56fa6ab01a,Commercial,0.4810386952448378,16,50,260,381,121,82.18223029173596,8301
f779655f-b5fe-437a-b77f-e78c428a5ef8,Commercial,0.409179002908868,31,17,600,1048,448,95.61224327765338,4385
6b87ea77-08d5-4683-9cc4-6aee231df7d2,Commercial,0.2565819012856826,39,31,289,1184,895,66.66783196770132,6632
ade10acd-c131-437e-a81c-30c88efae4cb,Commercial,0.35970610132245084,35,25,514,955,441,93.40983431805721,2239
ee27378c-67b3-4970-98e0-ca103c4093e6,Commercial,0.9974680258488116,13,7,302,458,156,44.83844233672127,2949
fba92d30-2361-4f46-81d0-13f228be5105,Commercial,0.38300659159440764,1,16,262,1341,1079,75.75672540022445,7650
fad40a5b-542e-44b3-ade5-86973ea4ff43,Residental,0.4037315783431238,9,26,362,1039,677,36.39061699458554,2876
cfb75970-f275-4221-89e2-22697c8ab675,Residental,0.4332463023950428,36,31,517,749,232,36.46281895536582,7502
11a202b4-92ab-4c1a-8630-989830368e35,Commercial,0.6887461601033892,38,1,699,866,167,30.81716073775752,7707
e55dd904-6790-4325-870f-03518d076beb,Commercial,0.987149303485749,33,5,115,151,36,44.29039050917267,6132
189cb22e-39cc-456b-9b99-a7666d073adc,Healthcare,0.5042674648023939,18,36,483,507,24,48.91634056872614,8487
b4dc2410-4aca-46a3-99ad-d26699a6a8f8,Healthcare,0.8597631006264033,30,33,599,1131,532,73.66519827298148,3355
be278a39-16c6-4ecb-81c4-b1e221eae61d,Educational,0.20201835268793433,42,14,3,417,414,66.99043155516952,4221
23cf1e5b-5847-4ff9-acd5-e52f7dfef58f,Educational,0.649270135296546,50,28,285,1348,1063,23.493319063076996,6972
a8a44e98-b89a-4f2b-a511-f9b60a6d29a5,Residental,0.2517575493804618,26,14,684,1291,607,39.381923568881795,6302
662a8fa8-0546-4dc8-a5ef-84f0c2ba37d7,Healthcare,0.28939883825684665,22,23,196,494,298,23.39185378954403,3298
e19036d9-29fe-4ae5-8b0d-0d7fa5f7e4b8,Educational,0.9054847893017351,23,11,401,1231,830,71.9318013830841,6923
09b3a8d2-f0cb-418c-bf0e-6acc88b5c9a4,Educational,0.5317784996652342,48,7,382,486,104,31.845067825824643,2029
7e40750a-7db7-48c7-9ca4-10ec3741eff0,Educational,0.6411993083674675,3,21,422,570,148,72.99320703619357,9834
30e83dd9-dc32-454e-8cdf-8cb0209977e0,Educational,0.9507539771819048,29,13,145,530,385,51.69103596528473,3191
b76f5b17-00a6-44ff-9b8f-581ef1c42d08,Healthcare,0.29422233999228176,18,6,278,892,614,54.1236334484065,1884
efb65e45-e3c7-4bd0-87dd-6fac1b1216fc,Educational,0.07980519622063886,14,18,677,1354,677,62.299418616010634,2447
deafc13b-9830-4dfe-969f-892364451d2f,Educational,0.10849396091174213,14,13,137,968,831,26.822366470129694,5997
c7f67b6c-eb0f-4dac-9bc9-544b29638284,Residental,0.8090990326606076,36,6,429,703,274,41.33271320999217,4029
727fa2f3-a408-4afe-90c3-ba5197f348ab,Commercial,0.21375220814682627,14,25,202,464,262,91.02726850908648,4954
e94ac681-5c25-4536-aa4a-2d552a895491,Residental,0.13040421574669991,8,31,227,1400,1173,43.276649802458834,5035
9961f723-93e2-4052-b7e4-9226d66240b5,Residental,0.2616799476538054,5,23,347,1220,873,57.38345400526412,3208
2e953ee6-1011-49cf-a6cb-ddba889d10a4,Commercial,0.9638446334731079,25,26,418,560,142,76.71256879061123,3414
a79103f9-4c8d-4767-a886-fd3e135ef820,Commercial,0.7372351259126044,18,12,540,1230,690,25.54797265808959,8926
5ffd3a54-e497-4653-8a15-400afda945f8,Educational,0.6799808153055351,5,39,210,1137,927,44.67085958135762,4925
98836ba3-a3d9-4729-88d0-2d446d614b4e,Healthcare,0.15224897746743082,1,3,618,1095,477,20.562039477980875,9527
f68147da-cd79-4f81-9f14-faf81a024d88,Educational,0.42139605031550964,36,7,299,1370,1071,60.11525824598489,5672
c3d5cec9-71e4-40c5-b824-5080da900646,Commercial,0.764942214143592,5,37,676,1235,559,51.124412719750694,3982
f6ca130b-c2bf-42a8-a9ca-f0d428102f79,Commercial,0.2652427496670986,27,40,96,473,377,72.11490663160215,2825
27e0a394-213e-45e0-be47-d890a765bec4,Educational,0.6082752888608186,44,37,125,532,407,15.900957112105564,6166
461fb727-e8a9-4c12-b938-d6da61758143,Educational,0.7145683200091874,42,18,180,1381,1201,11.214555911033576,3117
e8f8a595-1bda-4fcb-86eb-1be103ac84f6,Educational,0.5626038680646537,5,6,715,1215,500,30.338336826651144,6844
c81b1bc6-772a-4d04-a78d-bcae3189ad96,Residental,0.3615315018383082,43,6,74,800,726,94.40862571724644,9078
30b5b90b-2517-45d4-b01c-4da9ed7f335c,Educational,0.9996883390823968,31,39,459,800,341,15.2372776081807,4048
53119a41-9937-4344-9431-2151dcd03488,Educational,0.2446991314159338,41,49,259,992,733,49.208525998853275,2110
3a4757f6-1160-4db3-87be-8621f8bf1be3,Healthcare,0.20646403213069997,15,48,72,306,234,36.08693974450378,6736
6cdc1a53-36f2-40aa-a5b3-e349bba337f7,Commercial,0.9109432405059793,15,5,610,1079,469,82.18936305737954,9123
c230bc28-8bfb-4b13-8df8-c29ab599ee4a,Healthcare,0.08790654331053727,16,45,383,1340,957,68.55626352004208,8855
56e13615-02a3-413b-83e0-0dbafef69c6e,Healthcare,0.14415276458030013,6,38,233,1404,1171,26.844991493491776,6492
256c9bc2-9e9e-4460-84db-d1bdd44c3e03,Commercial,0.8715672867454693,28,46,31,942,911,27.191694260859514,4457
ab52e202-d900-47fd-8504-548bc1ff20a7,Residental,0.3826969958151839,49,7,177,1251,1074,98.69517248990834,9962
c46e0525-c72d-40eb-9838-2d8e0d02ffa1,Educational,0.3456374629119252,7,10,277,779,502,25.971438193049988,1267
0334872b-6d06-43e3-a3ac-4a280514676f,Commercial,0.9936239196208848,46,11,344,374,30,93.3544893400191,2887
aad947a9-1e6d-45b3-bd35-ee27d6a79835,Commercial,0.3625368885625083,36,49,425,803,378,71.44894980128277,3248
6e1db43d-764c-45d8-809b-3e983b0e4a7c,Commercial,0.5812542608907911,27,8,498,846,348,74.16619853513765,7189
4ae0ab7e-d07f-4393-9367-6d928c56c665,Educational,0.21175736325952554,38,9,374,488,114,71.26761082078308,8397
75a6d948-559c-4fce-a449-b309f5b77136,Healthcare,0.29015456526424444,21,22,72,1081,1009,71.70270382512444,4399
4916c389-41b5-424d-9673-fb1d01677940,Residental,0.04996728476614998,10,43,445,836,391,94.7049243662146,1869
7c7b2474-db90-43cc-a2b1-b414db907def,Residental,0.45270185392912965,7,14,455,531,76,26.40063769942972,8625
ac02539a-be66-4f0e-9e2d-8e71d3c32bfe,Commercial,0.8326185184116213,42,2,210,1005,795,35.29041833298019,5658
155a3a61-8c0d-441a-8ad6-fbd4b95bc156,Educational,0.8155437230220862,22,17,393,402,9,45.88988843061337,2294
89a052f5-cfd3-46d6-9bef-bcf0694e99e1,Healthcare,0.5667986790140842,5,25,442,950,508,33.50206315189078,3541
76bd52ec-682f-4953-9d6b-bd84a7557a8a,Educational,0.8412346568208418,46,6,431,993,562,39.21042299080789,1249
15ba6ec9-012f-40ff-acea-3605df74610a,Commercial,0.7633190861953024,19,19,241,1326,1085,62.75305053394691,6557
20d700bc-b199-4346-bcdf-c756b6b87037,Educational,0.2763079485188843,48,17,484,1155,671,74.14409887676744,5410
9551da9c-0cfe-4b40-9489-f454044e514f,Healthcare,0.7330340533876496,37,50,445,667,222,17.55254112109268,7658
2188da9a-cff8-4115-88cc-2ed99c5773de,Residental,0.19304912266727126,48,33,509,1070,561,57.59350171178607,6432
0685081c-2044-4242-bf7c-2fe1cb63d822,Educational,0.12407509020362206,38,27,42,278,236,28.49844044894288,3738
214806c5-2934-4a2a-a266-d89e1aab5a23,Healthcare,0.3675690296654873,37,50,399,677,278,58.097495896119156,6030
f321b32d-6fe3-4094-99d4-61a12bbd7274,Healthcare,0.02489353676007977,14,32,277,931,654,47.405376683465576,6531
48caf432-655b-49a0-958e-5d8d627fcee1,Educational,0.15727083300124045,15,22,394,858,464,63.30447120485074,2406
f65c029e-9834-4dd2-b981-dd1862470685,Healthcare,0.4613580802913205,41,46,683,1315,632,58.412727919009576,4993
fa0cb74f-a872-4c3b-a795-edab296b3e92,Residental,0.814397215415818,28,25,540,1277,737,18.35123511531618,8944
1f2fb431-30c5-44af-8006-efdecfc2583f,Educational,0.8476310243209353,24,21,226,1273,1047,86.19566185767765,8762
e37d9c51-d2bb-46a2-b7f2-b1e14ecc38a8,Residental,0.6477318424242146,35,44,677,1053,376,14.207874099138893,7354
3c76c618-dd41-4bd7-9d42-bc7f38d0914c,Residental,0.6379892245059204,38,2,218,702,484,13.636859471789707,2301
a92323b6-7d52-491c-bc2e-ab9d1c13ee66,Educational,0.732994503134977,47,36,14,1294,1280,26.08936495643313,7798
262cfeb3-ed42-4053-a530-305d2bb829f9,Residental,0.20618353772215758,36,7,131,254,123,10.498683177124327,3970
63265e9e-561b-4209-8aae-6ace38079941,Residental,0.4883871436800463,6,1,34,789,755,93.91318246432097,7938
cae08f04-cc32-47ca-ae15-8365bce18509,Commercial,0.9966775350857277,30,3,373,1258,885,91.97296028586582,3410
9fa4df95-f567-483c-95b7-14dfd90ee482,Healthcare,0.2769200519695064,39,40,299,631,332,96.60728763526043,2044
3d697893-7abe-4e3e-8f7b-04301b4b4cff,Commercial,0.34725487623022244,6,45,459,757,298,69.85805640981931,9840
3c4146f0-912c-4ed5-bc80-c15212a035d8,Healthcare,0.5169286020261212,1,11,570,749,179,98.33350232651466,3669
2e656259-b3fd-4847-a350-9c5593959589,Residental,0.30860355478197965,7,40,131,464,333,52.169634848162914,1368
3dfbf3f9-c6ba-45ac-88de-f865a4a13fb6,Healthcare,0.6072212317766833,45,12,518,1275,757,43.72574630869204,5113
cd4069dd-9a44-49f9-bb80-3ec06a5ecc1f,Healthcare,0.7830548760372926,15,28,108,1107,999,10.999648393894196,1440
32e6002d-166c-493d-8da7-e32914f3b5f3,Educational,0.47858494717168376,26,35,570,1125,555,59.77652742616876,8144
a6a8606f-e50f-4f9a-addc-65c74874efaf,Educational,0.6699470557699293,36,31,599,998,399,56.7506833827111,6419
56a61f3f-697c-4246-856e-123b05a24a5a,Commercial,0.8945864503773518,42,21,360,1366,1006,11.681986423163494,9252
d615bfbc-c927-499d-9b95-dd60e51a320b,Healthcare,0.1761809025732729,38,47,403,969,566,29.457329783189536,2628
2bd7ffdc-bb31-42fd-8dd1-cce669e8b0a0,Healthcare,0.7795799624228875,28,49,184,1283,1099,45.65507763125229,6919
c88e877c-bfc5-42df-9614-1fdeb06ce139,Educational,0.23038263820417515,40,6,91,1391,1300,31.794207737086044,7940
74ecfd06-103e-4693-b1a2-07ee1e318b6b,Healthcare,0.2710127913809405,41,32,320,487,167,57.53902795301967,4115
3cfcc425-dc84-4e32-a59c-67225b800aa5,Educational,0.9554626061126844,29,16,653,1019,366,79.22181850372546,1159
7ac97bad-1169-4517-96c2-45981cbd8372,Healthcare,0.4744201743936667,36,8,350,897,547,98.36922912372418,1035
b4fc3371-df3a-4109-924c-d780bbb93bbe,Commercial,0.0810555822225375,9,8,715,935,220,35.72772344646427,3461
4084e8ca-f138-4161-99b5-d99aeedcb432,Educational,0.7209221121050136,50,22,484,606,122,44.318480452329965,1714
4128d33f-0e65-4a87-9a73-67cf32598b63,Residental,0.06732234949891602,22,41,410,883,473,42.15810175470484,6878
68c9056f-af79-43a2-86dd-e003ef165d62,Residental,0.6541000074342528,5,6,284,408,124,78.90008386238253,7564
759553b9-8788-45bc-b358-088db2497e13,Educational,0.235645564672342,26,31,649,846,197,80.07648248260944,4547
84813980-7c37-4611-80d3-ef7c4cb9093c,Commercial,0.6479740014134469,30,5,472,926,454,91.35676985760936,8744
3d1d3ea7-70e8-45b2-b68b-105d5366e530,Educational,0.4759483031958601,25,34,175,550,375,78.17825164261889,6871
d4313e0c-3b0a-43d6-8a7f-0eaf78a5960e,Educational,0.1488500384116508,13,16,232,646,414,56.56732898987385,9159
e41c306e-f680-4420-9545-17291a2b9387,Commercial,0.13307037453676274,37,50,332,988,656,49.31428236185135,8202
0dfb66f6-16c8-4628-987c-cb8fe813b516,Commercial,0.4055330222585609,33,25,335,1081,746,12.290767679232697,6503
231b8e34-c763-494f-9396-bf5eb6f2f2b9,Commercial,0.5975641326838566,45,6,715,1072,357,38.30104318323211,4497
063b7e98-aee3-4b14-90d2-e0ed953fb605,Healthcare,0.7289615375600841,28,16,405,1277,872,23.193568394016403,1362
70004e04-aa02-443b-8308-3c016d113c97,Residental,0.7491635245829359,10,3,715,752,37,83.24158180831121,3380
2e798099-2402-48b9-8a79-a580fcde19e5,Educational,0.05951991927399769,11,33,290,500,210,36.47225519527211,5415
71ac977d-8164-4e5c-8d17-25fff2076903,Residental,0.35371587537728844,23,41,627,780,153,60.837689090681714,4008
09f797c1-74a2-4763-a69c-5994f8e7f467,Commercial,0.8735695620710356,42,1,486,1247,761,86.18948144722589,8505
9e4dfd73-cdd1-4ee2-80bb-dcba4aa5dfa0,Healthcare,0.6408670445626781,14,33,472,888,416,50.3785888326859,9679
128676a4-51f6-411c-8910-4e7f9d81ff6f,Residental,0.34537186987493995,24,29,41,851,810,88.73131419274627,3345
625293e4-d32f-46b8-b1c7-fc1d1d129552,Healthcare,0.30402921313180953,50,1,164,201,37,17.061333223106633,3234
6f5edcb4-3b7b-4674-b8e9-7378ced7c26a,Educational,0.127161123801657,7,32,41,1405,1364,96.74495928441057,2784
64638648-ee81-44fa-b0d7-6efa298b053c,Educational,0.5465708809463372,42,1,603,1153,550,55.1496643739856,8868
66fb9a2e-b7a0-4406-8105-fba434366ca4,Residental,0.5804145425994017,1,24,564,1430,866,65.69019774556618,3468
9d016fc0-39f0-4f5f-a9bf-913dddf36edf,Residental,0.04011186011128964,20,13,543,1059,516,15.292795606815755,3938
e54fe8b1-37cd-49bd-aa9c-0fecd9d52544,Residental,0.13716937896616443,40,32,498,840,342,79.37126264165548,4336
5c649eb6-8444-42cb-907d-01f94bd35e55,Healthcare,0.05453784525867378,27,18,149,1000,851,99.60811272211829,2050
ad5bd016-2ad9-4382-9422-d17d84c89e45,Healthcare,0.27790373359145404,45,10,580,1109,529,51.65278971610633,4591
7cf0d295-0d96-4bea-aba1-773a0987cb73,Commercial,0.23892324701842294,33,36,62,170,108,49.45652597464644,5058
14d849ae-bcad-4109-943f-be5985864cb4,Healthcare,0.7998991967365524,25,13,532,1416,884,55.99125604723234,9283
651dd9c5-30ae-46fd-8583-0d82539365ca,Healthcare,0.7534526265471013,44,21,223,837,614,30.413389242352295,8938
8fe3e2aa-c1a3-4207-af0e-3b9eecfb100e,Commercial,0.15959034903823477,20,27,360,1318,958,26.044809929888768,7078
4238bb52-9f71-42c6-b669-1dbff70df557,Healthcare,0.8992578215707482,4,30,192,825,633,81.13137688561594,9121
d59f78a2-5248-4730-bc67-9e4dc6a7ae28,Residental,0.2051700000828538,41,1,397,597,200,76.12619877433501,7099
40a7130d-9bce-42ed-86bc-ff4d964c5317,Commercial,0.008843166321609197,17,45,229,234,5,44.851899066115415,2453
0e4898e8-545b-4ae8-b1e0-dd2ec7754f7d,Residental,0.7093698868881414,30,2,395,492,97,99.6528535154597,4215
08b64fba-bf2e-4b25-ab31-ec244b19c8d7,Commercial,0.9065595706588371,24,31,131,1121,990,43.11593086303007,7282
a3234e4f-af2d-433f-a185-b91582571394,Residental,0.3359070972860526,15,19,689,1350,661,32.8805716752359,8969
19269fd0-693c-4b6e-89c5-21f25676ed60,Commercial,0.4400268157329028,22,41,438,565,127,39.199761771867436,2605
e9635d74-837c-43b0-b6d4-1c9dda1bad88,Healthcare,0.2831621672660578,38,41,433,552,119,37.23540339767447,4791
94369fa0-3d85-4653-8b75-772b56e5ee0c,Healthcare,0.7849909689776757,33,10,252,996,744,13.043694743042316,9524
fb4a51f4-38fe-4a16-aa77-00fce63bf365,Educational,0.3929067447375554,37,25,346,497,151,28.786282174198277,7139
2d94dd35-b33c-4573-9af8-0261797cdb03,Residental,0.09713840123323259,26,13,561,1330,769,95.29722306404753,9504
a0b6f253-5f6f-461a-ac81-2557e2c1e5d3,Healthcare,0.6736353615763266,37,48,578,1248,670,62.273257381925106,2297
74e7cfd0-cd9b-4201-a310-1f179b887184,Commercial,0.37741528688252146,44,26,516,806,290,62.31992192013247,9122
dbfa7541-941c-48be-bbc1-ac8fd038af7e,Residental,0.40345655900693755,1,27,91,1373,1282,90.67878378819607,8828
50d94787-0ea1-4446-a831-9d3c27079400,Residental,0.13252191615551567,43,45,62,923,861,13.211588433457443,3643
50398d66-a5c7-4d8e-8d25-a0b5bf3848ff,Commercial,0.6972470617508875,23,33,320,331,11,30.43958989940748,7837
0c22dc4b-a1ec-49c7-b940-bb57a5980ad0,Healthcare,0.7528034662281904,41,49,421,1057,636,62.24828253491622,6985
81d65bdb-c88b-42fa-906d-06d4c38c48ac,Educational,0.13063650630735657,22,19,344,764,420,20.7818194797545,1102
7eefd680-4be2-48db-80e8-3be1d59efdab,Residental,0.43277410649129067,17,5,365,512,147,90.43057017887553,7604
138f73f1-046e-41dd-9d05-ebe0e9a5bb3a,Residental,0.5902607608827894,11,44,387,481,94,67.47729940089229,2918
c706f099-6a8c-4bb6-86d6-178d9a0d2ff7,Healthcare,0.7197975441080053,21,48,437,642,205,82.84286833354973,4940
d76477dc-7d06-4f53-a231-ff7ec0da5d4b,Healthcare,0.7921740317875301,44,3,638,1202,564,32.43095379666862,7075
89a32231-f5a7-40f1-8b69-7166bada18b9,Commercial,0.06498639424648156,39,48,393,997,604,77.51894301690848,7995
fab3e934-36a3-4371-9e99-cd30c10f180e,Residental,0.7757354398945843,37,26,487,1231,744,16.39377489847966,4726
c86668ba-119e-4cb8-94e8-a8a73cb21596,Educational,0.4973015031931791,7,26,698,1017,319,15.84304731449677,6677
e161f01c-3b00-490b-a79b-8ccce0a01d21,Healthcare,0.334232010687729,24,10,549,766,217,46.31034144424937,3797
d6b42911-d969-495e-855a-2bd16e2bf956,Healthcare,0.5956288420916036,43,46,177,466,289,84.635373051871,2097
c581c92f-fd21-4c20-a204-e7e9fe86fe76,Educational,0.29755237325860595,8,3,123,1191,1068,36.03087035636647,2355
3f7e05dc-5155-4e04-8968-65930f046ff3,Educational,0.17947449465862486,7,26,38,783,745,69.50341362971608,4188
a01f2008-cebe-41ed-ab9b-7f0b55b5578d,Healthcare,0.042814609915593715,17,4,25,640,615,33.97559541739743,7501
345218b2-1135-4fa3-9e12-caec03bc769f,Residental,0.842169323318564,45,20,144,693,549,65.22043938940408,1718
5df3c6bd-abb3-4472-b4f0-30d58d743b91,Healthcare,0.5646960558634195,6,28,237,1293,1056,48.24959417171711,6468
ba6bf2ee-111c-45ea-afc4-9b380c560ae8,Commercial,0.48323932538344694,24,31,119,571,452,66.8088242862787,3712
997a90a4-3589-4308-9792-97b88af01f17,Residental,0.7973897745976802,9,39,619,938,319,48.11157989503704,3654
d720dc9c-8045-4ea5-b737-ac5297d4b5ca,Residental,0.33373646488060316,36,43,147,853,706,52.85217815581131,4902
dfcbd574-dd91-420e-86ee-9bfa9ce37656,Residental,0.6650335976298856,28,45,237,404,167,16.26300896357002,9520
0a11d7ac-fc64-4138-9fdb-6987f4f31099,Educational,0.5826653823854093,40,40,556,610,54,23.988861533724204,5228
f0628026-b7bb-4311-bd04-820bf16ea3b0,Residental,0.5474565791507235,37,21,55,166,111,79.96619710422128,9550
68b608f7-cfb6-47dc-bab7-9caabd2e46bc,Educational,0.3708897071202861,1,45,263,1226,963,89.32127286155027,1909
797c73de-80f9-4831-a9cc-a6a7b959f0ba,Educational,0.6072428500961501,17,3,638,756,118,49.130786257870014,8912
138c164a-a730-4855-abbc-2d7ef1f84ffc,Healthcare,0.06140503623610505,35,30,167,900,733,89.10089486936202,1041
b084f06a-76ab-46ee-bfef-5b2b6a234a6e,Educational,0.4811049466800147,7,16,66,1332,1266,55.06476293993874,4721
52b60aff-3104-40a8-a84a-f696ec57f30c,Commercial,0.18737121943832258,30,1,635,1387,752,27.923996774757885,7839
ec19f5be-45cb-47f8-aa05-51c8091427dd,Commercial,0.8163184700007524,16,29,601,1315,714,56.16706807992428,1201
d4dfa71d-39cc-4b53-94ec-8f1a14194c41,Commercial,0.9022536542558842,8,4,212,1116,904,71.10809764234615,7921
1b705681-1ced-4ebe-b036-ed444291a027,Educational,0.7475244067819523,16,25,263,1229,966,62.114384012974654,6897
fbaf437d-9288-40ce-b30c-309957f8b570,Educational,0.5669448133832541,36,12,36,349,313,29.974515717476972,2533
e9015793-f0f4-417e-a293-451c22fd4e9e,Commercial,0.5555016864308024,35,32,537,586,49,37.800663343426365,6009
99a60133-83cb-4e09-a161-dc0a482d7f31,Residental,0.9230480859786255,28,39,101,1008,907,41.27194790473422,1234
5f7f655e-e082-495e-90f0-ba8fd2c2a3fa,Residental,0.5057377387281861,42,8,309,620,311,33.536623676753806,5841
e5580e78-c208-46da-b2ad-54ee9e3fa259,Commercial,0.1991962149751042,45,22,696,1074,378,33.36824867605986,8643
8029f3cd-9621-44d7-a3a4-8fb72ed4c55a,Educational,0.1347543751156487,29,37,103,1266,1163,52.1068223324821,2614
92a58c16-d544-41da-82c3-e1b03964fd3e,Educational,0.02944991455089907,39,29,24,965,941,73.9743947216665,9543
a4389f75-71de-4b0f-ae59-8a2aaa8c1123,Residental,0.5499202453314699,21,29,670,969,299,96.17735081654293,6252
af164fae-ad80-441c-b743-f78b3bb06ab0,Commercial,0.5686049618458361,9,39,658,736,78,23.74312399860295,9071
5768a722-5abd-4427-a3a3-8bb280d776b9,Educational,0.019371266631465378,50,22,491,1178,687,26.824345149616114,5826
2bcb11bf-319d-4aad-9658-714b4675d812,Healthcare,0.2420173947341644,15,44,334,994,660,67.31948424232857,7996
9bd1a9e1-1531-4f69-8b5c-1c024ca6f09c,Healthcare,0.019198590239411506,28,2,472,1413,941,98.5593216257391,1930
591116d3-5e96-4c65-828c-924e2e546ab1,Commercial,0.6680344699675114,21,47,551,1148,597,97.1135672257078,9491
58a9644a-de7f-41bf-87fb-2eaf2363cede,Educational,0.3368576436987766,11,40,712,1008,296,96.86301291329765,4472
eac573cb-eff0-4f5c-bdbd-4127a4452955,Residental,0.3435929885187975,49,8,37,157,120,38.869436393872725,9246
ece444d4-5a85-4ae4-816f-4650dabdc7ba,Educational,0.4946804480041611,5,3,483,1383,900,63.16276383371354,2939
6f00d227-089e-485d-be53-ace5f626c195,Healthcare,0.4935201744824427,38,9,447,535,88,22.7657351912682,3152
97ac6e10-a0db-4fb1-aebf-87d455f1554e,Commercial,0.6879639161171086,29,37,3,187,184,71.79704300402223,7256
4f841bf2-ae04-444d-a600-9209a42e06e5,Healthcare,0.7137162785366346,32,8,690,918,228,97.83951738614695,1919
6c571b38-2156-4bf7-8804-d35b1aeba8d6,Commercial,0.12512427256023495,31,9,310,965,655,33.07059701193501,9792
48107f21-0f90-4ea9-928c-a7b77b01c1a1,Residental,0.8227161902736488,41,32,246,747,501,23.170094859914094,5439
217cb824-c1d6-40c3-83a8-777be59dfed0,Healthcare,0.13609462571462183,30,49,417,631,214,20.028982932742778,4883
3a0b5313-bff7-4226-9f2d-c9ecbc9ad2e3,Educational,0.17803440952892635,25,17,439,1158,719,81.5570185788194,8974
497b5490-18d5-4bf6-b6d5-31456046b700,Educational,0.7323435985264141,17,49,563,1075,512,30.143033815880113,8306
4cf64e37-d94e-4a56-8108-9cd43cbeb171,Healthcare,0.6455527538646316,50,34,641,1262,621,30.58061948920979,5931
ee917761-28c5-42d5-aa5d-cddc2b80571c,Healthcare,0.3922607330011486,12,21,168,622,454,68.6764837306514,1374
89af1b17-e8ed-4ed3-a799-b415a6238d35,Commercial,0.7220589113050804,23,31,460,666,206,16.39393042537473,8511
b5f7e73f-1ed2-468c-9384-deda2e12edac,Commercial,0.2999053336469534,38,7,719,1423,704,17.97052472289913,1344
25fa3881-5b85-41d3-aa81-5f359ac43e40,Educational,0.741331224689037,8,19,670,735,65,89.75543188690735,5201
1ed3cce9-2e77-42d7-a760-47b8f0d8311b,Healthcare,0.7830173841604217,3,26,376,1423,1047,57.437958952139674,3204
1de837e1-f51f-4b8b-abc3-6004d031fcf2,Residental,0.6520118444846835,6,45,442,961,519,41.4182626210453,5184
ef39e332-2e15-4856-8d8c-5ca67ce4eb94,Residental,0.9320569300034438,37,16,623,902,279,86.3853953071164,6828
671b5cef-37dc-460f-b352-1e103a8e6a1c,Healthcare,0.280182840285205,17,36,75,687,612,78.30072813441316,7388
962d150a-65a6-43f6-9e66-0373b78c7d02,Educational,0.11160285920053714,24,47,388,952,564,96.68051061836948,5804
900274ab-4f4a-4eca-ab7d-d243891244bd,Commercial,0.12920059873766976,14,3,717,889,172,89.66996026511038,7586
1f7ca864-c59f-48ce-8c2e-f34b30e45fbe,Healthcare,0.6807361231053556,19,44,68,802,734,98.3876942777576,7999
27c77e7a-45eb-4d9f-a51e-c61490c40459,Commercial,0.6240174534518612,2,12,277,1382,1105,58.0668974312426,8322
f119ab32-5c58-4246-bb35-b32294447051,Educational,0.2648833313375838,46,5,117,306,189,85.72358035075594,7741
b0d22e2b-6bcd-4697-821f-47fa4418c9d9,Residental,0.5274608491247714,18,24,344,667,323,53.341948872864194,7144
83d5634b-445b-46ca-9b78-a5e00cdbd459,Healthcare,0.14359956409500574,42,10,366,1053,687,61.819502891122184,8117
1558e1d3-3bfe-4ded-be20-d0391e428169,Commercial,0.7753513928240061,3,47,364,999,635,67.3621783032255,2320
e362cb8d-6252-41a0-a458-8447f5d03f48,Commercial,0.06349691524144185,45,50,346,1285,939,71.30397897691418,8921
3994e839-7156-4033-8ef3-c4c754d93fa2,Commercial,0.8575040424152005,19,48,21,874,853,79.1509108658632,2158
60dec79e-2c08-40f3-9d40-d618190196a9,Commercial,0.5193167664440457,28,24,277,597,320,15.316811860721485,5596
46f38c94-4571-429f-8034-ee9f36c4bbf5,Educational,0.4303394984755893,16,48,256,506,250,35.44490778165495,1419
618e649b-2f28-4a4e-86c2-863b278e6ed6,Residental,0.444936760582037,26,14,454,560,106,86.9315297919152,4544
8cc70c34-7263-4658-a200-6df343e3e699,Commercial,0.9965460617640627,37,15,361,519,158,44.507829636907616,5033
2aa5cb5c-5719-48cd-a2c3-b9b7531c1f9b,Residental,0.20843434826953744,38,39,584,1394,810,28.752311707127017,5087
be09f3d5-d0c2-49ae-b80d-5f616a0902a6,Educational,0.9561968822374997,23,50,53,999,946,16.134393357975938,3010
e72e493b-63be-444f-b467-801f1a1b8fa7,Commercial,0.3989867349309576,29,11,42,1042,1000,84.47800210503672,5525
80af8856-1786-4d63-a69e-479bfe1830d8,Educational,0.08074735732702665,5,36,661,934,273,68.88156233361795,5021
c4ccad3c-d5a4-4d33-866b-6168e1e064d3,Commercial,0.2037852627935719,26,47,515,858,343,61.64486302051536,9846
d26f6abb-5fc3-429b-9ab2-435b096b75f1,Commercial,0.7505451777591883,41,20,299,352,53,96.36721658808418,4611
546c52ee-a876-4ee6-b4ec-11fe6793cb8b,Commercial,0.01669101753747959,29,42,601,668,67,29.455691269751615,2977
15337ec2-9437-4406-ab87-c796e193a0b2,Healthcare,0.129499573532032,32,21,5,589,584,21.25539384360792,3546
e76ed01d-6efc-4709-9e36-fa771e3cd11a,Residental,0.24943116770479257,49,13,362,1064,702,80.1776545031865,6455
41001617-e590-4713-8949-8162f8c8aba4,Residental,0.4366117728329073,39,20,214,801,587,60.2263065403123,6741
593a7107-46d1-4173-af0c-0e709cb6915c,Healthcare,0.2725823559466225,3,35,17,466,449,59.85243113105279,8375
b1e7f340-aa0d-4cfa-af20-d5391ad5acfd,Healthcare,0.1310900111397475,26,29,210,677,467,97.69331539886342,7655
34823f8f-da45-49f1-b3cc-210fa6c59714,Educational,0.08964517927268778,36,48,439,805,366,30.012252423659604,9687
fc58ee5d-6ab9-4f2b-af24-0c7b8ff7d5ae,Healthcare,0.21705511506652464,26,45,348,963,615,32.76373394651387,3831
aa26e25a-179c-49b1-8a43-a25da1365767,Commercial,0.042920060988598685,18,31,104,452,348,49.891309894100154,3424
c28c7731-8505-4e8c-b268-5b146dd5ca67,Healthcare,0.9877376280365227,5,25,211,585,374,42.7496944276053,7150
13a5140f-fb93-48c7-a16b-2a2e456248a0,Commercial,0.17926131346532936,42,18,58,1236,1178,42.87799104563996,9950
82be17c4-d43c-494b-ada7-5384ca1bab69,Commercial,0.026163232585505014,46,16,542,735,193,20.276578790935126,1727
6dce3d98-a370-4a3f-a676-600dfe859bc7,Educational,0.337996598755697,5,2,393,1333,940,16.694001626298885,5449
e334d9f2-c2c6-4d52-8d65-aaf6a6eb12b8,Healthcare,0.973882641443406,42,20,210,694,484,37.41318761574344,6853
324696fe-000c-4e64-a851-d85ce28777b8,Healthcare,0.14040653556109806,41,45,462,840,378,81.16511078924277,3827
f4839287-6df4-446d-aca3-69baa3cb2c28,Educational,0.8824606305698338,25,37,239,240,1,50.76633024110355,8369
6af92a45-7139-4586-861b-e5c70336200d,Educational,0.015142544097158206,46,16,702,755,53,48.668374632802454,4676
fbababbc-3c85-4488-b55c-89d8711db40d,Educational,0.2211432526257251,4,7,95,695,600,52.52196519603548,9573
4bc9f675-b433-4b24-a4f0-ec36aee21a63,Commercial,0.2579011710147977,27,34,336,868,532,33.40849499655025,1604
578068be-6824-4bcf-99c6-d369092fa9f4,Commercial,0.2714434084805666,34,47,599,1081,482,25.15715663365677,2182
debd2eca-dd57-4e19-90a7-3b9096826179,Healthcare,0.7325476190713729,46,16,113,498,385,80.07618783162366,3975
d2334784-e1d5-4e11-b6dd-eb9c24cd1d93,Commercial,0.6406971369346316,7,18,177,1091,914,65.93299968657053,7627
03521b04-0ac5-434c-8af1-27f076f2150c,Educational,0.3644045486482156,24,23,581,1434,853,72.91854647157089,1937
9df2e95f-0366-4686-aa89-9226f176609b,Educational,0.7260180105023928,15,43,649,1093,444,43.15145318999891,9488
9f521863-a6b1-4f5e-af97-657e1f730f7e,Educational,0.8380775335166777,47,30,20,100,80,47.53911937925914,3377
02845a0c-b660-462a-aa27-eb88d9faffc4,Healthcare,0.8428038666182075,24,36,125,132,7,32.48003503518809,5745
9fa45e1a-a2ba-4f3e-aee4-df4a5c6ac030,Educational,0.8411784418258561,30,1,247,279,32,54.83840769227466,7452
d62807ea-e89a-401f-9fd1-4efdac758c41,Healthcare,0.0068090097948591,44,19,685,1369,684,85.56533380612498,3679
47578667-4dac-457d-808d-f81c7d692fc2,Healthcare,0.9215800775134484,46,6,214,309,95,70.78954545870715,6121
96ca0748-0d04-44ed-9fa3-3900d5df7c6a,Commercial,0.2257693509839609,45,6,637,963,326,81.69146434058294,9668
7398bf77-bb6d-40dd-b7d3-24d16ef79a95,Educational,0.994291968639955,2,21,41,1423,1382,27.414892769578717,1614
c09ca59b-e965-45b7-94f2-c7369059f5f5,Residental,0.4590246566092939,21,30,139,1156,1017,94.94337926446165,4247
5838b897-e58d-4e59-aec2-d6cad29f817d,Educational,0.5711543591573734,6,38,505,1326,821,37.22958801328472,3858
109a9a34-7344-40d7-a320-8aae35b0fbc3,Residental,0.034939685026339706,6,1,184,753,569,52.21590445032407,5646
be04b45d-bebc-4a42-9a96-6d648ac47f60,Educational,0.31148502895746477,10,8,550,1040,490,83.67457788758428,6881
3a19a440-c841-449b-9aff-da130c2ed34f,Healthcare,0.21263590770384944,47,17,566,1129,563,26.27879036818212,6547
eb30cac6-5bc5-4338-a3dd-e8e434c6c20f,Healthcare,0.401460646722669,45,7,680,910,230,65.25392450999252,6661
2270edfc-1e66-44ce-8429-560f552196e1,Commercial,0.4750696742454754,2,14,559,644,85,34.57035106229947,6842
de3f962c-3a39-426d-b800-5a80bcd7e122,Commercial,0.05196377253202311,20,6,436,1390,954,29.278135197379907,7715
73e14948-335f-47ed-b5d0-2b083d40e3ce,Healthcare,0.8450181615167368,5,24,191,1310,1119,94.79040824298028,3411
a8e548a5-398f-46d9-9ca9-935bc8f61bd2,Commercial,0.18208440699549944,10,41,392,1041,649,94.87853526857087,7517
0639a32e-451b-4d46-883f-d5a3cad47c20,Healthcare,0.7690101782940404,8,43,137,733,596,55.00456806588199,9592
e730972a-fea6-499f-a5df-6946735c9930,Residental,0.16495598856819016,45,19,298,1148,850,10.117767484679247,2628
1d70f8cc-4991-4240-b4e8-7693a9c9113d,Residental,0.5632698013152108,43,43,456,1115,659,90.16678421277803,2985
6174156b-edf3-48af-a571-3178508b628a,Educational,0.18614071545938982,31,8,322,1347,1025,42.386943884628984,9044
fa4e1e17-93ec-4860-bb52-df76ffe49488,Residental,0.9805118007096423,35,9,569,820,251,54.75779052397045,6762
b5e5164c-02b8-4ffe-b907-ad455c1b0e67,Educational,0.7843526502498144,26,4,504,1150,646,71.0975245897697,6267
c0f5af37-365b-4cb5-b44b-4e460a2345f0,Commercial,0.9765550948501437,8,8,440,1061,621,89.27009740621527,6438
6e258b7f-5a77-46b7-a544-22d2fa6fd521,Educational,0.22963734822105342,12,6,20,1352,1332,90.18227320506895,6732
65f6a29b-f73c-4557-91dc-8eb2617f0b2d,Educational,0.4989843375876324,10,49,485,798,313,21.600083138202766,9317
c9aade98-0fc6-4a9d-bac8-fd336f814a97,Healthcare,0.429490872458416,41,19,693,1163,470,85.41470098346736,4490
b18ec4de-c1c6-4512-be63-e8873e8481b9,Residental,0.617381259998727,13,27,710,1041,331,49.82943237239415,7704
492c3821-a114-4f9e-93cb-9eaa42415062,Commercial,0.1190385512933595,13,33,297,1055,758,70.09428854936561,4985
adb5f863-faa1-4fc0-b3d0-e150f6c866e2,Educational,0.5512463186503185,37,8,13,272,259,27.452003775198015,1493
b609a00b-d775-4c29-96e6-dcfe3b0757a1,Residental,0.5128441195053199,32,38,617,880,263,68.21142901597383,9808
2a1859bd-0e61-427f-9a5b-be9b16491ae1,Healthcare,0.5465573407300308,36,20,533,1237,704,43.11172769349027,9145
fdec9000-3d84-4508-8caa-0d093046ad47,Residental,0.23488664167333462,25,26,706,992,286,28.007693399101388,7444
cb1f6618-e713-4a9a-bbf6-d3f6a42077fb,Educational,0.9947124228390585,41,49,11,49,38,21.626707815217884,9880
65fa19c2-6052-4d3d-9dc7-e436867a9e4c,Commercial,0.13503151303457994,14,22,532,967,435,31.095084824124374,1202
0883d166-85bf-43f3-b478-31b420e8a4b2,Healthcare,0.19086915201307364,25,29,474,1342,868,92.3653420892352,7550
440e4523-6067-446a-b201-26edbf780299,Commercial,0.4267559011117379,11,38,67,593,526,34.11908236671633,8360
9d2f0166-79cd-47c3-ac06-f7deb10c97ba,Healthcare,0.7231597189337954,48,36,42,1324,1282,35.24827118521501,9954
34fb1fba-ba45-4601-9a84-4d02677db4af,Commercial,0.1438089284647982,19,18,23,1310,1287,89.19556394278241,1879
24bffea4-6d1f-409e-bafa-04828abcade4,Commercial,0.667281392103013,19,10,253,1413,1160,33.82355886644862,7216
124fe1b2-52df-4864-ae09-a383c0db0b41,Healthcare,0.12933190873808387,48,36,449,890,441,21.313305651805038,1593
26a29a27-e6e2-48fd-893c-1b9af13aa311,Commercial,0.4857955066257016,26,40,301,1318,1017,93.93680764923324,5642
6be37c96-bedf-411e-9ccb-cddad56e5bc3,Commercial,0.1818087877754252,20,46,174,1009,835,94.8829524763529,4165
c9b0b60c-a07e-4bc6-a618-f082117d81e4,Residental,0.46501412722046187,19,46,531,883,352,39.91331902540014,1774
9d14024a-e688-4480-956e-b4f498a10310,Educational,0.2216160748098761,10,9,673,1021,348,17.116019514059992,3079
bfe0cb76-a54d-458a-9b52-d0f6464c32c5,Commercial,0.33134589348273547,40,10,548,721,173,15.903005645426509,3535
fc4ee426-6ac6-4715-9fc5-bdce61640fe9,Healthcare,0.7528420743744081,31,7,218,295,77,72.98633114506814,3403
865264d7-0355-4226-8761-5439755941ec,Commercial,0.5691588665648626,3,37,258,454,196,54.14129315485586,5505
d7cccf57-429d-4113-984e-f602b9434486,Healthcare,0.5559452912221791,34,32,164,260,96,76.68486822537405,9083
0b29b6b2-3c73-4399-8758-57e4764fb1a6,Commercial,0.0816363380122529,6,30,438,765,327,38.475207822339314,7575
1c8caa7a-c461-4b21-a6c1-0e4b5b037904,Educational,0.30822068380383527,22,14,14,817,803,94.54281591006259,2070
67e98311-068a-42c9-bdea-ae071ea191fb,Healthcare,0.31297799511659075,41,23,45,153,108,91.71093185840233,8266
0becdeaf-3c87-4a2a-af93-dc9fd6aa4fa8,Commercial,0.753584443058202,38,35,595,1187,592,45.91657254044603,9163
2efba75b-c0a0-4073-b4c8-55fc7b56ffc2,Residental,0.8481316355627371,28,15,668,1121,453,10.211122467941951,2760
e0adc1d9-f0c0-4ed5-8504-0fe5ecc10e52,Educational,0.10378666526900837,25,13,271,1368,1097,33.248573416056274,8269
8a8dc8ef-d1ae-4cc7-845e-a9d14350477b,Healthcare,0.4917746359742301,1,11,421,1387,966,57.1358264315617,7854
39321a7d-65d9-4b1b-8fd7-a1d3e8080903,Residental,0.31496314602822273,19,37,485,826,341,22.84159590872097,1319
e3742634-01f5-4813-b571-84a753ad3266,Healthcare,0.43798059737244155,19,22,34,249,215,96.82594835911135,8782
47b51ead-9146-4ad0-b4d8-3edc83f13867,Healthcare,0.7201067095212527,11,40,250,917,667,86.56162556513326,2705
626b72d0-55f5-44d9-9800-a7e6307ae722,Residental,0.2119930423869354,42,29,298,586,288,60.063336083492125,6276
a9c8f0b5-9c98-4c09-a561-a38e28a9f6c0,Residental,0.775210775186901,5,17,409,642,233,80.33182572913107,1729
862cf085-0a03-4ee7-8d81-d640efbe89a3,Healthcare,0.2627018220863522,1,10,703,1384,681,31.18821813897817,7289
5b28f08d-efb7-4da6-844b-73fe8a225f14,Residental,0.6258187399008917,8,45,592,691,99,10.675261426122395,5109
dce42f50-21cc-418d-8f73-76d3de4cee6a,Healthcare,0.020610421350464425,43,28,576,948,372,80.23986262089866,9458
94e62d78-2194-43aa-a55c-1be282f82236,Residental,0.24611208156438447,4,4,696,897,201,44.49445972392128,7614
4580761a-c711-42c3-b86e-242ad1c1cff6,Commercial,0.12223379638661924,39,4,678,1346,668,34.6638916668518,1152
c5c8d02d-0d6f-4997-993e-97bd1c0732ee,Commercial,0.7521398957198697,20,31,655,770,115,71.20427846648828,6359
2c95ceb2-1ac3-4a1c-8376-890c647e7121,Healthcare,0.6663527913745008,26,18,291,581,290,78.09659069599431,9113
7ce44ffc-a332-4ab2-bfb3-ae4f47a45732,Commercial,0.8804821522656919,29,48,403,534,131,30.691819769648134,5225
ef62a150-836b-42ce-9bd6-fe0e283b7d4b,Healthcare,0.8786975905414733,18,43,393,850,457,16.50827537043758,7649
a3db927a-0224-4bf7-9416-be3539fb1007,Residental,0.5919940370134432,43,12,324,1153,829,38.9392520140439,7940
8d2296cf-d238-43e3-80e5-1397a641acd4,Residental,0.646426672011527,45,3,673,1283,610,76.03823980390003,6363
e548e11f-2ae9-44c9-a997-33eeeae0ceeb,Healthcare,0.08579006367621111,7,2,429,856,427,69.2173542373232,3046
5ec607a8-a7ca-4c5a-bbec-a93c941c52a4,Educational,0.06029108405466199,45,46,79,529,450,52.03467123211529,5066
15d9a8fa-888c-4be0-af69-4949d04ed3ea,Commercial,0.6554811500799381,1,26,680,840,160,91.70767383415584,1531
82c02461-6151-481c-8522-33cc46238b67,Healthcare,0.5256488727255347,32,26,527,950,423,30.897676688048765,5364
8a916193-6757-4b35-893f-1ce435487e05,Commercial,0.005105099915683198,27,49,281,1366,1085,37.11382041008322,9412
7693f781-141d-45dc-82c0-57fff275cc09,Healthcare,0.7982055224386654,30,22,54,127,73,57.37179343038541,1548
334255ce-3f7e-4991-89a7-69c20a07404b,Residental,0.38121752019599375,50,33,101,1156,1055,44.97725455540769,8824
b8fb8897-5510-45fc-9ee2-92a993db8151,Commercial,0.18338437638630023,16,5,174,1018,844,81.45852140108244,8923
aa39caf4-6fb4-4ffb-bec5-1c354b72f704,Residental,0.018843975215985354,28,29,518,838,320,36.54141008787434,9297
241998f5-ef74-4b8b-8345-07613cb0ff92,Healthcare,0.9548629160671036,2,25,392,1130,738,47.713288444702656,4956
887d3ff2-c2b4-4a38-b054-599ef7a3ab79,Commercial,0.543532455277787,5,14,75,1434,1359,12.671954970904606,9476
71833481-a22a-4e89-8f7a-1dbeda209476,Educational,0.09401322331426898,41,40,548,1400,852,60.78756228640476,4544
1dc3a85d-7134-47c6-9e2e-665c52e0e578,Healthcare,0.31360100384992373,33,38,74,836,762,18.4663178863852,9320
a23f4952-0881-4310-9848-1928a19eaa33,Healthcare,0.49296264027591385,7,11,24,469,445,62.36186780113538,2770
868b5238-749a-4b85-addc-a8bcaa8560ec,Residental,0.7561626719877136,17,26,390,641,251,43.808876931807546,9569
964123c8-ec69-4ddc-a5ba-e4068744113a,Educational,0.8269524225908051,21,18,296,840,544,19.584424580730712,3755
8c75e5e7-bb12-484c-bf40-a0dd7e0fed68,Healthcare,0.9330184569271452,33,46,549,815,266,17.01492107934923,2159
6e0e83ef-63dd-4e72-ab65-c6e08e90a312,Healthcare,0.992240623111174,26,37,409,1092,683,93.68682194682947,4555
72a4cc1b-302a-4dc8-8289-06a02d7837d9,Healthcare,0.7758655662808055,31,12,528,915,387,50.173619850147894,9752
60d12644-d08b-4bad-8514-360f82bdcff5,Educational,0.09827197833630796,48,15,218,1097,879,63.58667387350743,5333
00c3f8ac-1495-4fb9-84ad-f0cdb89133d2,Commercial,0.4167640409708657,7,21,117,211,94,75.87071809085819,3521
0527ed76-2e7e-434a-acf9-8f0dfbe484b5,Educational,0.05750857489842032,25,43,148,788,640,58.37793253595804,6312
fe11a3cf-2fdc-4617-a111-151f441e9378,Commercial,0.8096107065832333,10,46,665,742,77,80.73386680646756,7419
a34afaf9-ba59-4d69-9707-9350653d1d93,Residental,0.534992029262646,43,10,346,443,97,61.32065371519855,3335
20a17cc3-ed25-4fa0-9c8d-a9d3c9ecdf32,Residental,0.9149102332321564,1,37,342,511,169,39.68610163104815,6012
c8da4301-27af-4c40-be69-515859aa9f28,Residental,0.2674738050527895,32,33,211,245,34,53.82078609281186,1612
c3a3cd81-5eaf-4a02-a781-ddfde4165fdb,Healthcare,0.6446927925268957,47,23,312,981,669,13.435092416264133,4296
3c2cc537-a64c-417f-a293-5992f0196551,Educational,0.26684234254495076,17,29,157,1360,1203,52.32463479617323,9301
ca06de52-0142-4b48-8420-47eedb0f8c59,Commercial,0.13282531002577436,30,20,524,679,155,77.82648871044051,4363
298b70ac-629a-4d58-8574-16cb91393878,Residental,0.2584516891060141,6,10,212,898,686,29.560106654314893,3912
bc5a1c39-dbe9-483f-b548-c6a084b1a8a9,Commercial,0.5241936331152284,16,21,708,713,5,45.905110270248414,4803
9687c7f8-c023-4f2e-b3b0-5401ed8f3ad9,Commercial,0.7354520790705804,35,30,423,1357,934,59.87421739403373,3921
2a7e9009-45cc-4276-97ff-6764198f0698,Healthcare,0.10312003000466297,19,33,522,992,470,48.997265873952095,2807
e4498db1-d746-47de-a2c3-cabbdaf10016,Residental,0.49292984705787046,5,41,606,915,309,68.01302581810691,7969
8ab3cb2b-59dc-4cd3-8893-52f759b70257,Healthcare,0.37014791924305135,8,22,548,1299,751,42.98747537146335,7823
194e18b5-e762-4ccc-abc6-fa977948f65d,Residental,0.701130556689432,37,18,386,1297,911,78.35068499654804,4946
0f020911-e127-4ce1-8dca-fd2ff3bdb96e,Commercial,0.4600977068089369,50,9,628,1076,448,59.94371802011324,2118
e13441ae-9d6e-47f7-be8b-e1a6ed5e1c28,Residental,0.32181444487860367,45,3,615,1290,675,83.40234396056506,1076
f9c80c70-1b7f-4bea-9293-f92c12ec2414,Residental,0.32769650167523834,45,18,29,323,294,32.27665473603214,5635
5c5b3a1f-c6a5-4403-a41c-c4de0100192d,Residental,0.1352374961523265,24,1,49,989,940,25.69992903952368,8059
e10cbcc7-b4d2-4b38-9ec2-d82f9c05b143,Educational,0.24084624403666754,28,49,107,711,604,31.788873093121154,5613
4a16720c-7a1f-4806-931a-fa29592978de,Commercial,0.06496881568335855,3,10,148,1238,1090,50.059805859175825,9764
8cc066fc-949b-4158-b08e-bdb2178b2f78,Residental,0.34946276507690743,9,35,31,93,62,75.1070547032466,6398
ef3b8d58-9c77-4385-96a5-0c512ad29c77,Healthcare,0.5300057261149187,4,9,467,981,514,38.72061366451813,2230
2bd3ef04-075b-42f3-aa24-0e08ce54c421,Educational,0.1302712008221757,11,10,687,1436,749,47.85155347496826,7799
c83e27f3-9f8a-4ac9-896b-d643be41d1a6,Commercial,0.3290019202871901,22,14,412,740,328,65.60375966241021,7912
ce39aace-10c3-4c15-be1a-5da2a9faf830,Commercial,0.4207652936336681,31,6,87,308,221,23.074232694498388,9413
e877e4db-94d3-4e83-9c15-bf21c2813465,Residental,0.733958380633095,36,18,606,858,252,59.3395621421401,9990
639cd993-9fc6-43ff-94ed-2b4e3fdf815e,Educational,0.8036468530881166,19,4,159,410,251,81.70319270979158,5139
6957e740-609a-4572-bbd2-4fba55d9b1ec,Healthcare,0.19703982839756184,28,24,412,701,289,10.526752306984127,1532
6e2cf783-eb3d-4bd3-b3eb-041a4540f57f,Educational,0.8675933662836777,3,7,492,592,100,78.82708026592779,7342
4dac6f35-942a-44f3-8b6e-4ac3fda03ac9,Educational,0.020977583763023944,41,23,428,1300,872,78.83915514909182,3955
55cb0ebd-13d4-4f17-b3da-cdd0c837fb1c,Residental,0.4799664488333675,2,40,704,1082,378,11.148602698982348,8921
794ef3f4-42fc-4715-b5e9-e445e58c12f9,Residental,0.9398141794861052,32,39,257,1268,1011,86.31628825262851,2235
15d9d4a5-33f1-4b1f-bc09-e50ac89de9ed,Residental,0.2989466614495534,35,9,555,751,196,72.29133852810585,9114
74bfcffb-11d5-4eb2-b9a2-8ec024866e9f,Healthcare,0.3470950167635155,41,48,520,977,457,54.30990189357289,4840
c85773e0-87fd-4fd5-9848-225973df8482,Residental,0.2579307147342902,43,15,692,941,249,88.82987286603675,7082
79bcd94f-7e89-4bb0-97d4-e7f83bddeffc,Educational,0.14445852475130927,8,46,230,1376,1146,91.32991247093612,1071
551d7e4a-21fa-410b-bc7b-6488380bbac6,Commercial,0.9055048113029397,42,15,391,1132,741,86.05460564030899,7589
571c34b7-a7f7-4cd9-823b-5f1ef2edd437,Educational,0.6047039800962704,40,9,629,1140,511,97.60070307536174,3511
e318b6a5-d277-4643-82ff-6ae02fe8f28b,Educational,0.9757686396577001,26,24,421,1305,884,85.34748214504327,7548
4d4d06fb-eb85-449c-9488-d841dabc7cba,Educational,0.37041912612647776,11,33,485,1121,636,82.03880398439338,5467
f3540e93-67b0-4371-ab8f-efa33a91a560,Educational,0.18061034468884474,5,41,351,497,146,94.1787607946556,1678
602d983b-4f53-48fe-ad15-78415e0fabe3,Residental,0.4512067277331513,23,30,707,1044,337,13.029979870691086,1695
0b9cf662-87c7-4efd-83aa-ed226abb925a,Educational,0.8308086427080992,13,12,486,632,146,85.19297746398317,6645
78b6f5f4-cf72-4d81-a001-c3f00ec3bbb0,Educational,0.24718764100685697,43,43,35,511,476,27.23305296576833,9632
824fd114-ac46-420f-b11c-9e0598bf490a,Healthcare,0.006736664884465449,46,11,447,456,9,10.688051492100964,2420
a30ab329-585d-4b7f-b86a-346d26a2e3b4,Educational,0.9112767186854885,32,34,30,189,159,14.232288197333554,3183
9f5fe35c-2c92-4303-933a-2e57c68402f3,Commercial,0.7180026596385595,9,38,400,617,217,19.024427049815458,7837
1ea34e6f-d900-4fbf-a42d-7eb2199f94b6,Educational,0.015768804288681326,13,18,314,657,343,84.41934374950738,2193
0e7881bc-8cce-4344-bf03-0c4f89a018a5,Educational,0.14369969354548506,42,5,320,1359,1039,42.128590589994545,9402
152a1e13-0575-47ed-ad94-7e4bfbeaaab6,Residental,0.9380624021327567,33,44,621,670,49,76.46071579024857,5684
60ff2082-e8c2-4dc5-903c-b87d4f695063,Commercial,0.9940397648680969,39,31,515,1034,519,65.8718459465863,3278
47eac9eb-8049-449d-aad6-b1432ec3fa33,Educational,0.8473477989253749,7,25,152,1319,1167,25.033125198409593,3518
e67e94f4-3d58-4207-bf7f-310ac0f1150f,Residental,0.3996892502941728,29,6,614,856,242,70.01202801227849,9969
9ff71cb9-a06d-4bb2-9a4f-20cfec2d14b2,Healthcare,0.06377088354111515,27,3,38,137,99,36.918438526840546,7642
0d8d8cfb-98f2-45ad-947a-8d920f072c9d,Commercial,0.17819826717473009,10,37,589,1040,451,50.42937574973434,2853
90f2656d-b728-4b2e-a23d-57a80ea88b47,Residental,0.8335787834610514,41,31,65,1153,1088,75.69860129868779,1377
fc26272a-71fb-4970-9e1d-ebb16e8daae2,Healthcare,0.03711293438283436,33,31,380,620,240,58.30635579398224,8345
aec89127-5397-447d-844f-601e83bcb5f8,Residental,0.6380302065795412,23,21,44,411,367,56.72962311319745,4551
3bc3efc5-dc6c-435c-bca0-f30332c84cb8,Healthcare,0.8580210981775924,5,13,322,1085,763,78.5020687920967,4154
d75c8d63-693f-4e67-8dc2-8120f6020f1a,Healthcare,0.21667894483931482,37,37,462,847,385,79.64588126489157,6528
dd3e1c76-03f5-4c2e-93e0-a3031558b5c2,Educational,0.40115213956694473,37,48,432,755,323,80.48356478613216,5971
0e98dcf3-f498-4679-9947-cf2df46cfc78,Commercial,0.1324984483268301,6,28,670,672,2,54.951654225355746,9696
4ad1dd7b-ff25-46a5-92e1-1e00f6993d22,Educational,0.723326365342521,49,35,656,1412,756,12.580790581173034,6947
9b9e0d16-ce5c-41c8-98c7-ac6dad506ac2,Residental,0.8900180514292482,42,41,163,1031,868,21.929491645869646,4524
40477bc8-3bd1-4231-a854-0802d12ec896,Educational,0.9503262612393388,48,47,686,1377,691,13.243308786549292,5374
60091f5a-0457-45e7-8946-c009dec7ee76,Educational,0.4932039317821272,46,46,68,1429,1361,57.182500866305254,1819
206f98e0-543b-41af-9201-e98cb2ddac05,Healthcare,0.7249431631579588,38,23,210,1286,1076,27.39886484379482,2023
425f7096-6803-4328-ba4a-884b336cfec0,Educational,0.3198409147554747,11,33,531,776,245,42.16639438558711,3080
3cb777ce-287c-4db6-bb7e-814e2a81986a,Healthcare,0.8434816660418288,48,47,518,821,303,81.86653034518594,7002
48416230-7c41-4e23-b0d5-ce5fbc2ee9d2,Healthcare,0.7526849062679877,41,47,254,531,277,62.75673876546741,5709
e63ad422-731a-495e-92a5-f8d696c97b57,Residental,0.28881179687846137,43,44,210,515,305,28.140847471391357,9193
47fdd935-aa69-422d-9f82-c3d614c38192,Residental,0.11044799216077461,19,11,320,905,585,58.96749661326356,6907
fa22ac7b-cfe7-4d67-b681-b8dcd117ee3e,Healthcare,0.5061173378523653,17,4,430,1317,887,95.09706024473006,7195
2696abe4-52a4-48bd-938e-528f669ffb0b,Residental,0.6917869053185147,50,28,430,867,437,84.52792927691276,4799
9698f7d8-9d20-479c-b6aa-eef31847f918,Commercial,0.4772126951987715,14,9,449,563,114,91.99398902724147,4803
008cf9f8-5b53-435a-9f7d-1a7d480da99e,Educational,0.4858285144730713,10,3,295,1072,777,92.38075632441046,5449
2a623229-e30f-4cf0-8546-e757bfba33d5,Healthcare,0.730618608359311,21,45,490,909,419,14.905887092023018,8754
0e634ef0-dd90-4d36-bed1-738ba6178ec4,Healthcare,0.8893726426715358,47,6,361,1180,819,11.810494389537986,1507
7ad134a4-24cb-4852-9618-e6693eab7071,Healthcare,0.34488337201331243,50,35,385,534,149,78.20859580427629,9463
0666cdb9-47aa-4f04-a5ba-b0531afa60c9,Residental,0.930577537082771,41,9,534,1242,708,21.755296189093812,2900
e37739c8-4709-483b-90b3-b22c2ce0f1c9,Educational,0.9704084971406113,11,32,74,1279,1205,35.86917617065759,6116
7e74502e-ee14-4aa9-8ee3-21477abaa05a,Educational,0.9446626900143852,48,21,222,931,709,78.88218169685486,4946
cf4b521f-05d4-4d31-bf22-efafbbf57f8a,Healthcare,0.8238239566371237,27,14,587,673,86,73.95976220099689,6492
60cf19ea-43c1-4960-9150-67489a9b0cd8,Educational,0.24799631743863904,43,5,396,604,208,47.526745822153444,6349
7d1ab368-b46c-449a-bc03-ded83bcfeb8b,Commercial,0.14866484849552686,11,11,710,994,284,66.548327353746,8436
79dd54da-ffcb-447c-a131-a906b81057af,Residental,0.03749006832986279,40,13,445,465,20,25.23578125343949,7141
f6d0bd87-0045-40ba-bfb8-b07df2096c2e,Educational,0.5916493571418502,31,37,371,1041,670,63.305382361959275,7715
fab0b951-1458-44d0-a07f-1a0484196ec1,Educational,0.918390563941871,49,32,640,1406,766,86.72934175099091,1227
bdbf27f3-77b2-47fc-a14e-145fba729755,Healthcare,0.694900604812559,24,2,397,886,489,10.073053566484507,3333
dd21598b-6c2a-4be4-b20e-7fb7755a9dc7,Residental,0.2406534950484729,27,17,624,1198,574,36.47724020618784,2202
9c1e23c4-7e7b-4f48-a9e7-381ba0d30d0d,Residental,0.8286920578517301,24,37,10,59,49,40.80981647678874,5153
91db001d-0cfa-4730-a662-4087d4de81a7,Healthcare,0.028226547999914864,20,8,330,1236,906,14.66252048731968,6229
fb4ed432-4a25-4b34-96bd-9661a695edb0,Educational,0.3693402776910283,45,9,620,757,137,65.48012018466991,6667
94569677-bef7-4837-a2ad-7ed55f1feba3,Residental,0.62287967790351,3,16,427,772,345,86.47137633954117,4750
e16da8e8-b43c-408a-9688-7b2f7351b022,Residental,0.32001940622218206,34,31,39,800,761,40.237915136276285,1699
793babf1-bea4-4f70-b790-b2c090075507,Residental,0.10331597794288339,16,22,347,1387,1040,62.790284599448306,9083
6ce0168d-4414-4006-a63e-156a7fc199d0,Commercial,0.6882044513886457,4,6,524,1175,651,16.75690648386989,6953
cf9da2e7-ff83-4d7a-85ba-01e97f1ff253,Residental,0.6951612762917189,6,35,242,780,538,20.75406783435798,9812
1b9901fd-df67-4eed-a394-d6a3b384d047,Residental,0.4314247451936448,20,42,598,953,355,79.26199728654417,3251
3379c2a1-96cb-47c4-b4c1-3761a32a3083,Healthcare,0.44144326556880764,10,31,291,747,456,34.79010694487799,6068
626d53d7-118e-46c8-be96-6466a3f29e25,Healthcare,0.6888603909398817,44,37,162,262,100,19.44503301380052,9555
02452358-7a1d-4b9c-b3ff-d2ec36e33e5c,Educational,0.5260449183485189,41,6,138,1440,1302,94.93586328110403,2619
8b2f002f-2891-46b7-89fe-591feae2eed9,Residental,0.11091720698181251,23,5,78,275,197,85.5904351473061,8333
2bd23c91-4b9a-4bbc-99b9-34779f6a8f52,Healthcare,0.9376390784196237,42,2,662,1246,584,50.07046529947298,1687
4cc54a25-8ecf-4c3b-9385-a3f80677c376,Healthcare,0.08904000503259579,28,25,317,792,475,81.93895502844092,5978
370dd8a6-6037-41b1-9bf9-162acb9c34f0,Commercial,0.8461351517072324,2,49,558,1146,588,31.701089693776968,4949
0650eb56-c16f-4e44-9904-cdc096f012f7,Educational,0.9631676978143383,31,18,412,1015,603,31.817058558641776,8196
5129a3fb-ad84-4de3-997f-ad73eb838955,Educational,0.33485823383885527,14,31,21,780,759,31.157604405910636,3727
8a932a90-76e3-48a5-8dfe-9d861e60eba0,Healthcare,0.4409401649769009,24,29,51,224,173,40.97681947353966,5327
cca2d651-c2fc-4c20-a3b3-6856495a5008,Residental,0.7182307457273059,45,14,163,1263,1100,40.136181208513435,7839
6da5a899-fe05-4339-8e29-a28d13757f25,Healthcare,0.788393374075835,24,46,67,472,405,49.101542047770074,7521
bd8a1247-3e0a-48a0-b7aa-a908752a1bf3,Commercial,0.4480965161090261,22,24,303,1005,702,17.327213126017973,9441
5fe0f166-ecaa-4619-bc5c-9d645f938644,Educational,0.5865304427699272,24,39,365,1085,720,47.1005090007792,5581
2c395b2d-78a9-493a-bc0a-9b9983ca1617,Healthcare,0.6943960628502434,11,6,183,1264,1081,42.913837202810576,1007
be81cb6c-41a5-4f18-a854-9b59153f83a0,Commercial,0.5195008295479505,35,38,336,1294,958,14.43770408313001,7866
6428e29e-87d1-4a9d-9da0-370f6abd400a,Educational,0.1061807609391553,10,9,427,451,24,97.17445801504212,1388
c3b964c5-eb27-40e9-9197-a0f2be6f3939,Healthcare,0.26325988872700057,39,13,476,650,174,31.564188803950746,3669
75e066fb-e0c9-488b-bed1-f534e4112eb8,Residental,0.20448988645256327,3,32,442,1275,833,10.962718716457916,3808
b443c73b-337d-4df2-ac84-66a8d04c8e5a,Residental,0.6275840363901591,9,21,73,1283,1210,15.29686355417662,4032
71cbb3f3-d7dd-470a-bde7-5bf666716508,Commercial,0.31980179735703174,35,20,561,1352,791,88.49057985142372,5752
bc8b5fbf-6389-4b35-823e-74ddac3db73a,Residental,0.9061501478794675,30,29,637,642,5,26.082501146864576,8736
c751600a-d1b6-46e4-a8b7-ff28c75fb3d1,Healthcare,0.14533869983298275,22,15,198,443,245,31.02916876899999,8248
7df6d133-b5ce-4f2e-9b10-9057c2f14e49,Educational,0.9844225512736662,7,37,29,1091,1062,92.46693497145617,6537
755c840a-d59f-4f72-9779-05526bd23d07,Healthcare,0.725499648207724,44,30,457,1419,962,80.82626160777775,7357
2f4d4570-f144-4600-b083-ba2b90b44467,Residental,0.8608962354849662,36,33,153,798,645,62.68328037440171,8605
db79b18a-80db-46bb-b2e9-79d000d2fda7,Educational,0.6105944840366224,13,46,96,588,492,72.98536158787815,6681
72506fb1-4b21-4a29-b05c-3eacc8af5f1d,Residental,0.7039368688956958,34,36,136,1390,1254,13.001089963561766,6900
82b6f838-d30e-4179-bedb-e19eb57e8c00,Residental,0.18729663775590755,40,45,517,1090,573,55.90412371096108,4605
1a26f6b0-0745-4f15-96e7-058d15245ae7,Healthcare,0.989792356634142,14,24,150,1381,1231,90.07162761221414,4825
dd78e64b-80fc-433a-bd38-34bb1a32a7d4,Residental,0.6555058109875095,34,13,535,1042,507,12.003209041097564,8814
f2d1d5ae-a196-4f24-a52a-884c6a6c498b,Educational,0.9190101791207002,27,25,306,950,644,30.574554714394083,8933
77ff0854-b5bb-48ac-93a7-136027e73730,Residental,0.06411876065325939,48,49,380,508,128,36.55489432145486,1032
053130fb-cf5c-4f23-a15c-ae55d994428c,Healthcare,0.8899546713643767,18,1,309,1124,815,12.683377911410656,3250
8977f330-63a1-47e6-8471-23fb627f3353,Residental,0.28642741409761097,26,22,701,729,28,60.6647491808198,6812
59788130-099d-40d8-853a-287c4bf16058,Healthcare,0.16034331630182574,9,22,93,966,873,55.04711093076847,4576
6967f3d4-52fc-4fcf-8991-4c45d52afa2c,Healthcare,0.37284056122264664,23,37,325,1264,939,87.16917838780773,9392
47d97cdf-dc3d-43d5-88dd-f9802208ee1b,Residental,0.40677372830473446,39,10,589,1196,607,77.92874971938735,6234
edd7f9bc-f3a9-4cb9-ae21-1f13f0e3c64a,Commercial,0.6041984884783966,2,28,709,1362,653,22.971622682601755,9377
6f040255-be19-4789-a72f-c1460674585d,Commercial,0.3348391892358873,14,26,648,747,99,15.68921841826933,8030
3e69762a-11ef-4451-8e3d-70b798bfde5b,Educational,0.31754322338701246,50,33,231,796,565,31.702489649926385,5113
fe4540d4-5271-4db4-b54a-161ebebe279a,Residental,0.7125367478079593,40,44,572,964,392,82.2873069830166,6058
6caca2e0-5c09-495d-bc13-b11013c10376,Educational,0.5628076970553426,8,8,77,210,133,22.72538628946439,5838
b50fc088-db8f-4154-af91-334106f68c1b,Educational,0.4022537877976734,1,10,3,200,197,97.70701832802129,3229
e9cafbeb-da83-4513-8a8a-c52ee8e4c29f,Residental,0.9971308622800689,21,8,560,1070,510,36.81895196588971,8386
ba496fc2-8cda-45fc-a55d-43227d631339,Residental,0.6091653431060637,48,19,3,460,457,14.004096939392745,3049
e2fbffc2-c7eb-4edf-8f0b-65ff90bdcf28,Healthcare,0.09434374943298218,42,10,436,1013,577,67.29140461848688,5935
23257932-2468-4c0f-8ed4-fba4cea0d27c,Educational,0.8406884401348887,38,3,631,1279,648,13.266193305333164,4379
2e65c9e5-5a97-4174-95ea-0798aa9c5dd4,Residental,0.7006928966647561,44,18,284,742,458,47.86846592880408,3062
df791111-e6a8-4f27-9ff0-32d98c959265,Educational,0.7754890225466988,10,8,514,1354,840,40.49396720475921,3850
cc38ee2c-a884-4b9d-86bc-2feebe7ddb60,Residental,0.7373209310272735,29,21,699,1291,592,73.68817690453449,9578
659dbc6d-1ea6-4fce-9c74-906a2afdeb7e,Healthcare,0.06016038267028567,3,44,427,941,514,21.01048797866708,8407
84738c0f-7256-4fa1-92f3-6384eb3ec604,Educational,0.3945385407711386,40,14,388,1256,868,58.34295272937371,5266
29c6cc02-8f17-4de6-b5ca-954d8e0a7e5b,Commercial,0.6347877874945536,32,6,320,456,136,83.93659132299605,7385
4ed9139c-c512-4f54-a72e-f1452a3a2e33,Educational,0.7392058260081692,10,18,135,1378,1243,83.81936334319589,7006
f9cc6e1a-dc66-4fe7-aa29-e74c5f105922,Commercial,0.45041218731985644,49,34,457,502,45,97.07190123411686,3609
97c572f7-00ea-42af-a0ec-843b295add3a,Residental,0.181907737807805,32,30,56,1010,954,73.07638968392476,8343
9378f81d-cd61-40c0-8458-3c2f3611216c,Commercial,0.9615080987500885,30,32,399,600,201,49.34738734589487,8268
dcb56117-ddf0-49a7-866c-5d01b0460741,Commercial,0.2761738960334593,28,14,130,307,177,90.52975550724516,5274
f01184fc-066c-46b7-9d9b-c929cd65f933,Healthcare,0.6647298694023743,32,5,310,511,201,86.93002071475998,9943
a1e85597-9f2a-4604-9620-08429ce1c330,Healthcare,0.9788274955077829,37,39,329,1049,720,15.602697298501448,5144
a954d1b8-5929-4e65-aa71-1ead4b66bf28,Healthcare,0.9708642626083472,46,8,443,576,133,35.65663379846036,9744
5e2988ee-86a9-4536-b040-6973ec63ce2a,Commercial,0.7588538344983905,42,9,80,1248,1168,62.47504117453786,3774
95acd61a-35ef-4b60-b6c8-b5d2582aa641,Commercial,0.7737321363186527,13,39,676,815,139,26.508549465288812,1229
9b266d88-cc10-4a52-9b01-a7db1ac52744,Commercial,0.7806565990233372,3,21,299,881,582,55.53939815816483,5440
ed16f82c-af3d-42dd-b0ee-5239fcfb5bef,Commercial,0.05259665350154552,15,47,567,644,77,64.02710242813862,2363
490a5fdd-4b24-4381-a50b-142fbc39a4eb,Healthcare,0.16370829692990274,23,43,366,387,21,49.993952670931364,2170
bf2f4307-7db2-4cf6-ac1f-2d10fcc53878,Educational,0.1775630602981082,19,43,249,657,408,60.29137449688457,8757
1331a23d-c720-4442-860f-67cce3aff986,Residental,0.8135370065017783,8,11,719,1146,427,94.35832100614054,8743
daeb79bc-b9ec-487b-9f3d-a719741dea64,Commercial,0.3306294851086502,36,41,494,1313,819,26.885361810158777,7535
ed65ae59-1edc-483b-9baf-fd429ab72f82,Commercial,0.5793264370008225,37,16,514,1422,908,60.76488427567694,3033
5f92737e-2653-44b1-b880-4503c3882f48,Commercial,0.37138417557799286,34,47,395,495,100,88.10366235053556,2606
c5515636-c0b0-4702-b9a6-72fdbc251398,Residental,0.6477494538176394,43,38,583,1326,743,60.54819165672478,4170
df746ce3-5b9d-491b-87d1-d1f40a7cbbd4,Commercial,0.3873656509664324,30,16,668,1265,597,59.40054446434158,8372
15ac78a3-0cd7-4ac2-a5f4-c6fe8b976656,Educational,0.6966733053617253,21,36,349,1391,1042,59.28294569621803,9679
4becdb08-ed96-42c3-aefc-06b52d9f4c12,Healthcare,0.7586275404009748,39,41,218,939,721,69.14347279261827,5097
5e1f1b33-37c8-4a79-a52a-a3db9414b0ca,Educational,0.7858442710520662,10,14,79,553,474,24.358460248181565,5805
de1107d1-4da4-4acc-8607-9437484f3188,Healthcare,0.7977300122004369,16,40,285,1099,814,21.359403766678867,5814
f69dea4b-ccb2-4825-a312-2543906a366f,Commercial,0.26015611110996817,37,15,485,724,239,77.28859225921254,3089
e316efce-884d-4010-982f-3fa82a18bb63,Healthcare,0.989472928124004,22,2,338,415,77,69.6794181716264,3077
fdb08194-cb99-489f-aed3-d017ab129d9a,Commercial,0.8194460732222694,45,38,678,1006,328,49.34740676469778,4724
cc20ac18-6605-46f6-a752-b6435349a823,Educational,0.9940409611524502,29,1,437,1388,951,33.12676614973655,4933
ce144745-628f-4d39-8009-c4cf9e43602c,Healthcare,0.32880414673195646,44,24,512,1208,696,26.36547775920627,1183
7b92d395-2837-4964-8db0-b8eaaa39f8d4,Educational,0.072836769560511,34,42,376,1282,906,57.64761271533726,8990
1000ce8b-0fa0-452b-99de-01d16862e5db,Educational,0.885277912030984,13,28,458,1187,729,45.34466215988244,1535
79cb972c-32ed-439b-bd71-ae7892cd7aad,Educational,0.030748903320162002,5,13,161,477,316,13.127309594413738,1426
76f3d7b4-5e77-4ba2-b553-03f9d1824f6c,Educational,0.0779860125110462,7,1,540,853,313,72.9044616930767,2985
6754ef05-59c5-4dd1-bd8f-6b746be49e2b,Commercial,0.27389758898579675,8,34,558,886,328,80.28680301030707,2435
ec649828-2bac-480c-ae39-c10af95657fc,Residental,0.48463013672342803,21,42,75,1066,991,35.81738031166436,8582
138d3740-724f-431d-979d-243c66ff972d,Healthcare,0.7519297333960961,18,15,678,1325,647,59.72370031673253,1440
2c1b8c4b-9356-476f-95b0-ca0e7d361628,Commercial,0.8250415565218815,38,11,362,773,411,51.353481732780686,7445
9f94a022-baa8-4f73-ad4d-97618ab83e35,Commercial,0.025121117508197677,50,28,438,1263,825,67.87181282862059,2627
2edffc2a-f3a0-4ddd-8fb7-b4b1d40c0761,Residental,0.5649612679062941,12,32,213,1086,873,19.10021677184148,7210
acd2e2bd-3d18-4461-ae7e-96b3c295ff4d,Educational,0.19035822418015902,42,20,624,683,59,71.64307419216419,2835
f2f667ec-d871-4142-851e-daee295c59e5,Educational,0.786180196100027,42,42,661,736,75,69.15673374526105,7146
8e5a8e74-7d44-49ac-92a9-f3fcd30674a8,Educational,0.8159522513470047,14,27,203,525,322,16.20300289058715,9623
73dae648-0d65-4da5-8dad-e70041afc8a2,Healthcare,0.8450925393516208,36,20,655,1089,434,97.10853269405641,6405
581d727d-33a5-4da3-9eff-1cb1bf27b5b2,Educational,0.06014548317280066,3,5,259,276,17,14.595058382197633,8936
5da6491c-bac9-4682-8f6e-548f105e50f7,Residental,0.8886944071193039,5,33,363,860,497,61.76241408581638,2697
88accc01-d404-416a-885b-a85025bfb86e,Educational,0.9624379037576275,43,42,372,1255,883,16.959237088101666,6774
c1896444-f757-40c8-81df-2c974cd90c8c,Healthcare,0.14890317462268965,2,3,79,1121,1042,61.5488915076747,3145
8b49026b-6157-4d8d-936e-3582318523e2,Residental,0.7842853410918098,4,8,512,955,443,25.712675579990247,4100
4533c110-030b-405a-bb6a-54675364668f,Commercial,0.9649071059607878,43,29,432,771,339,36.66516371435172,8021
7f8c29d7-8ab1-4272-ac7a-f0885d7bad3e,Healthcare,0.25669618015548634,38,5,490,1430,940,47.39533530051176,4971
885d4690-fb26-488d-9efe-455953fda81b,Commercial,0.237939044550447,5,18,117,630,513,56.12355415712832,2633
4a998799-25f5-4b44-bc98-80d261beb562,Healthcare,0.5679278468556124,32,33,177,1248,1071,81.6315484679295,4392
b327f572-0fc9-4f4d-8515-f042b885c93a,Commercial,0.6591629496197081,13,12,155,740,585,85.10352103717725,6266
38cfe6d7-35e1-4475-a85f-620783d16425,Residental,0.05963566425284528,45,3,295,680,385,91.24810419751245,8932
2eca28de-bc6d-4a23-a1a0-b5f1380434d9,Educational,0.6932138999191599,5,28,439,933,494,46.44901017730841,8651
03530bcc-c915-4b64-9167-248d8f538f8b,Educational,0.2504087740731039,35,44,694,823,129,75.12332617361565,7042
8e0e81ca-4cd3-4d87-b1a5-023dedac2498,Commercial,0.2694515321663917,16,31,220,872,652,43.93731422184336,4695
73f317c3-a9e1-4a51-bd14-85ff916e5872,Commercial,0.8840915819001365,16,18,338,769,431,23.003565221120102,7893
026019cb-4f1c-4718-8d9d-8102cbf22d83,Commercial,0.31838867470737275,31,12,32,160,128,68.36996818741943,8079
983a5b28-a06f-4234-8c91-8d670da75472,Educational,0.2736990069799564,42,6,78,298,220,84.32009756094494,2533
0d0a227c-9ddd-4f3e-9df8-347a3567dea2,Residental,0.5769828547104744,19,6,576,715,139,87.72840715184086,6826
7ba61f72-be7a-4c67-941c-df712fdc3fa1,Educational,0.5984563184605575,36,47,404,570,166,64.73245982981362,2951
2d2f2fab-97eb-45e9-b61b-f09ee615fb4d,Educational,0.26404535241507776,26,34,402,910,508,93.8413121900295,8743
cbf74521-e1b0-4deb-9533-ea4684c73387,Residental,0.15862544960326364,35,33,98,1317,1219,81.415624587364,5473
901b9dfa-7e0d-4c88-967b-7db6851e1462,Educational,0.10304857450011229,14,20,184,1306,1122,77.33351329013728,7704
f92898f3-13af-42fa-9baa-44de12887588,Residental,0.11381946145187727,35,5,508,848,340,24.424162047601605,4951
93827e73-3086-4b5e-8153-abe01e19d7b4,Commercial,0.7452327977203334,30,8,217,636,419,11.599217105846344,7270
747fdbf6-0916-46cd-a77b-2ad57f82abd7,Healthcare,0.8369422255558461,33,4,147,775,628,34.15866438829052,7556
7d76b250-8984-4546-9e92-e113b968f8d4,Commercial,0.6113044922626564,20,3,240,1251,1011,53.510790713381795,4479
1e2a5f61-bd99-423e-bb08-0149da855ead,Educational,0.12046674477641828,49,40,684,965,281,17.220500222496113,3179
ae717073-0fb9-47a2-bbc9-b8d03722f814,Healthcare,0.06977485559612573,12,8,314,1079,765,11.165950279568653,6918
b9525295-5a54-417e-8f6d-4781230805c6,Commercial,0.4362824004390956,11,42,290,582,292,27.148894731832414,9740
4864e37f-8c3c-425b-b1e1-afee870d61c2,Residental,0.9911559649919005,44,42,165,917,752,97.91270643833893,7147
b22f6493-2f45-4df9-aaad-132e03331db0,Commercial,0.8607236915387111,15,40,203,1363,1160,72.02021230413675,5145
353eb7b4-f102-4e4d-a03b-b55b8bcabd9b,Commercial,0.4966940640565858,9,11,260,487,227,88.56657700783934,7407
8421dd40-8e75-4fa1-8e12-b9f70fc8dc93,Residental,0.5909685568529282,9,40,671,702,31,51.69309038979411,9767
4164079d-675b-44a5-9267-07f3d35d3cf7,Educational,0.27421208810647135,14,27,701,1293,592,89.77122751836632,6413
2febaba3-4643-4d50-b312-9c03555cf5f2,Healthcare,0.9047568684557038,33,40,234,467,233,33.463159238601946,5265
a1e4f800-9f32-4ca4-8f58-7da9a938782a,Residental,0.4330526701976577,20,5,21,648,627,66.14571883442181,6919
4501b457-1fcc-4c34-8376-6760d18724fa,Healthcare,0.9212542117456265,31,5,618,1032,414,15.151964484602816,2165
cab70134-4e94-4471-a17a-c0a94bbe3e9b,Healthcare,0.15277475939073515,18,42,435,1213,778,30.256065723679146,1769
a1452580-b27f-4572-a61e-ccfc8938b098,Residental,0.46598199378235405,41,10,88,463,375,93.7681281699646,5451
70956fb7-4884-487f-a254-9483106bf1c2,Commercial,0.44293345454279076,43,39,634,1097,463,36.92190133448085,9441
288a2946-d6a1-4d2c-af67-5df1f7fe418d,Residental,0.4090124750126336,45,9,603,752,149,11.980539869219392,2678
c97bf17c-9570-4865-ae8f-ee67be158bba,Commercial,0.5555112755697977,2,32,446,1127,681,89.80320943630879,1093
e48460d6-a451-431c-a2b6-9716705f466b,Educational,0.11908628013219125,3,10,509,1122,613,68.56490244069337,8778
578e3ac7-f57f-435e-9c0a-c0400f70ab94,Healthcare,0.47234323737549155,15,1,172,851,679,51.28500442189695,4351
162fecb2-0145-4bcb-86de-15d26f714f03,Educational,0.020318237011981988,1,28,549,1260,711,58.95499489064612,2889
9428cfd2-3f8f-4fd2-a131-5b20433a5c64,Commercial,0.49763770175995814,5,47,200,1335,1135,57.57750360559859,5690
18ef1c2d-186b-47e9-a30b-fe7cb77e35d0,Healthcare,0.05768304093297005,11,43,336,666,330,99.56436395930662,1534
594f3712-ebd7-4e95-9234-8231b2f7c76c,Educational,0.9191287130411447,13,43,393,1122,729,61.62766134077801,9390
0d7b4937-4bfa-4ad7-b241-94c64486d937,Commercial,0.19778789973243094,40,9,478,1211,733,66.29437760670137,1238
b268fb6e-2955-4913-8462-bb7f67c0ab90,Residental,0.3107591282659713,12,24,375,1025,650,98.50371365378962,6269
d73b95d5-12b9-41b3-8ac6-4ca060b85d28,Educational,0.35103795538628524,15,45,663,1423,760,45.14763996491878,4637
da5e916b-cff3-44f5-b49d-cc3b3e631e80,Commercial,0.9869579976886411,5,23,377,480,103,11.521036392713984,3967
fc1b84fd-b792-424d-bd01-8c052096e588,Educational,0.09642360624940638,1,24,244,1079,835,26.203187707993383,1723
1764ea9b-f096-418a-bc7d-99ba2d6b463c,Residental,0.008985996568492083,35,34,391,789,398,88.65477419277886,2761
264b18ac-f2fb-48e5-93d7-7a381555436d,Residental,0.9377994945131142,19,32,150,742,592,48.78229878782983,8587
0ae74294-e9fa-4568-a00c-e4b2e7bdd777,Commercial,0.6409426531995965,10,50,589,1317,728,88.27339742435629,3971
7a79b29c-504a-461b-ada5-037b4ff324c1,Residental,0.0583239843238087,45,15,507,1229,722,66.60233811809924,1014
3e42f065-37d2-4ac3-952b-f47bae56e738,Educational,0.9149011400355479,17,36,446,1215,769,78.96125610661433,3678
e160ca2a-74ff-4057-81f4-d2244c6499dc,Commercial,0.18898269314244587,16,5,525,533,8,91.52857881268972,4159
c7e73855-fccd-41a5-a8d7-fdccc8ab151a,Residental,0.7302628403920327,8,42,556,626,70,41.710597694379516,9734
ea534148-5cc2-46ed-84c6-4d3bbc7494b0,Healthcare,0.7208431480059112,14,36,666,1093,427,90.9613239824162,7607
3c7dee97-d717-4f21-87c5-c328a37fcdd5,Educational,0.958746745883313,32,36,233,766,533,91.09306151197673,5252
a138c2a0-7beb-4177-8ec1-f8c4eed49588,Residental,0.19955970777216225,4,14,360,656,296,70.82131915501293,6092
26d5c97f-a9f2-443d-890a-5a636ea516cd,Commercial,0.359632079334267,11,21,609,996,387,77.83730285642449,6760
21736cea-7866-48c2-bcbf-f7ef53748505,Educational,0.9818211031624019,42,40,627,1400,773,85.56534002031763,9771
68995813-345a-4e43-8508-984b133febaa,Commercial,0.1764432463004857,31,18,68,330,262,11.128972145449826,4449
892085e0-80f3-46a2-ada2-c2c28540cbd7,Healthcare,0.9808690230313173,20,16,141,639,498,48.852427271089084,7831
c34d55c5-f93c-4d46-a399-913b8abccf1b,Healthcare,0.7050698893585756,33,25,202,854,652,77.60075830529031,3482
d88b1c6c-8d71-4c1c-a999-5f8e887f1d2d,Healthcare,0.12032413416862009,28,28,288,610,322,59.32993826345548,1241
e3faf575-22cd-49b0-b9f2-4ae75d81527f,Commercial,0.45985151750024955,22,35,25,147,122,17.413325641606892,8127
9b626b76-4cc5-4de9-80d4-3f2a65a415e0,Educational,0.030941224815740798,4,19,284,993,709,69.87850933898775,3345
380ee56c-3240-4ee4-baf7-aebb846cae45,Commercial,0.7402616937038096,7,34,97,220,123,49.06500368802827,9133
780be802-014c-4012-b558-811e3f9165e0,Educational,0.9312545975909815,16,8,270,346,76,85.94508706442988,4997
5df01639-e974-43e0-82ce-cdc1c8033b5f,Educational,0.4390596464848844,22,4,290,1299,1009,92.24857557546393,9733
c05d301a-4905-450f-b467-6b1d439eea6c,Educational,0.6525915346593762,47,20,472,1346,874,61.42116386729032,6331
9a48d050-ba3e-4fbe-bf2a-1fc8779464c5,Educational,0.876739216444158,25,49,226,1068,842,51.30713954754921,4660
3978d388-9c63-4642-9efb-603f44a5b1d8,Commercial,0.6762832774009879,26,30,129,424,295,38.188109512208435,5823
af603ad7-692d-423b-8d01-4e65b8e221ea,Healthcare,0.4808901419115863,13,20,307,1347,1040,58.96930664400478,1581
360894b1-d75c-49d4-8230-13372489e68e,Residental,0.28680757681516156,15,8,581,896,315,40.29295582073797,4898
0cc00705-3da9-4077-a426-6020fdb80d2e,Educational,0.674468326018472,9,24,252,602,350,81.48071776248675,5859
05c13b3d-3fdd-4b57-add0-757358bfdb9d,Residental,0.10765144834893348,5,34,393,919,526,12.787530399782208,4571
d82d9e42-8304-46ed-8184-ee6b51443ea5,Healthcare,0.11350160209588189,25,41,695,980,285,52.70009881788903,9812
2fb63ba3-ff1f-4aee-b0e6-962e8a58f1f4,Healthcare,0.9040893380492989,26,17,612,1136,524,83.79979251171768,9527
c8eede14-a11c-45ab-b3eb-9f74bccb594d,Educational,0.07129230972697209,41,41,480,729,249,81.06024903208363,8408
570ff246-7d9e-48d6-9f21-0e902ec42858,Residental,0.9488260595505473,50,30,234,468,234,60.38725549896469,8223
8ed53aff-0150-4bdd-b1ea-fc6cba5bb557,Educational,0.0631201233354739,46,13,179,1381,1202,82.89953170277248,8636
0887225d-4b38-4b1e-813b-4a08d4d1529b,Healthcare,0.1599051535243322,28,49,162,1203,1041,85.1199413459331,6387
b20f05ee-dc95-483a-af46-f83460f4e9e3,Educational,0.7591581698473715,18,32,380,656,276,59.29028571611947,6736
cb3806e0-5f70-47c1-8525-dafe02a325b2,Residental,0.10935046965657114,15,1,21,802,781,41.39609400239412,2837
c5c9882f-8fa0-4c26-a757-4e08b6f79d14,Educational,0.27306452762640787,34,28,427,843,416,43.49944830757732,8171
02963576-4bc2-458d-a74b-a5c8d02a347c,Commercial,0.21399093661008028,11,37,44,563,519,52.59429188145694,5993
6e3b0802-a459-4e03-84ab-8a22fca3829c,Residental,0.43973797672241144,31,2,120,1434,1314,59.93693618931011,3368
9398198e-2c06-485e-8f36-6201b4200722,Residental,0.161683361626343,8,30,90,531,441,46.961905154632916,8519
fcf0d21e-c1a8-48ff-bfff-e191d24d926e,Healthcare,0.7026429889344009,9,18,574,840,266,23.81814966930363,5686
a1f49e63-92b8-471e-91c5-acc81f069fd9,Educational,0.922815966898792,20,19,657,1176,519,35.376712930928136,6090
0fbb30d4-1501-4fc5-9abb-1d58289df204,Healthcare,0.6726167362663482,24,46,566,585,19,62.075392297750284,2828
9750d0bb-3861-46d5-abe2-9b791b91d287,Residental,0.9706791737381296,30,15,317,1049,732,14.729579981260972,4694
7bfba71e-428a-4be8-9fb8-bbf77fb74994,Healthcare,0.6474049396734459,45,15,453,1038,585,69.6433461487782,7370
2734760d-2573-48a6-9276-a64421cc3042,Residental,0.4891512908230984,22,6,448,558,110,28.64526801679673,1303
2273c39a-4e4a-4ba1-b384-8b3fc081c649,Healthcare,0.6382563110896772,19,23,168,284,116,85.90271445366753,2242
43d16fcf-fd2e-4437-8622-3ebd30cde1ea,Healthcare,0.10174597892109771,2,7,178,1404,1226,73.74814290484403,2344
98f25352-827e-48e4-aa7c-76936011d951,Commercial,0.9063777183414188,34,17,13,1081,1068,73.77634268125848,5294
87171f3c-2c67-4b79-8bfe-04d74238e094,Residental,0.9936104358557641,31,38,467,740,273,29.083099716381128,7124
cc610a8e-5768-4d93-9761-dd74b9b6da78,Educational,0.3706535654151394,36,19,185,1259,1074,52.897043647692335,2898
a0df18b6-e130-4828-a8fd-7ba30186f82e,Educational,0.46105496358371456,7,47,179,704,525,65.30157876289812,6125
7b501e8d-8c17-4dc7-be99-d33f4c6a641d,Commercial,0.6262069591302053,19,19,18,144,126,30.298782384681985,3103
7395ca93-7e21-48fe-a019-7417a32caa5b,Residental,0.29076901443239833,9,30,268,726,458,91.78035897584512,7264
5921fd04-52bb-42b4-a435-74f7e3022547,Commercial,0.8147640916121869,12,15,235,727,492,84.08036093286077,9702
1ca4d559-261d-4347-8edb-97c576bf1b4e,Healthcare,0.14590754625702473,34,15,67,690,623,63.936836230152295,6452
465f28b4-abb6-4c2c-8194-71fd88e731a9,Commercial,0.8117953471527638,18,26,217,1037,820,40.39890253024403,9674
7b614a47-9903-4689-aaa4-af1b24127376,Healthcare,0.06557330979449982,10,50,320,972,652,83.55881903654557,5839
c3d4527a-c242-4841-bd4b-1da32732cfec,Commercial,0.23125709968387875,16,9,434,594,160,81.53758793968457,5463
2ecd07e3-4e72-483e-b571-abd72a56d779,Healthcare,0.6784311170520552,7,23,398,1083,685,18.271746279598997,7511
f461e7d8-f9ef-423b-8a36-fffc4be81534,Educational,0.039391107801061254,30,17,669,734,65,45.25255436562596,7860
2848a314-b7cb-4dc3-80cc-2e81a96df094,Educational,0.6081124064880249,12,21,369,921,552,17.641663581791654,3781
9e887de3-6528-4c49-889b-47a55222d088,Residental,0.9377828080544923,20,47,132,149,17,95.7146165145181,1453
13b34aa3-f170-416b-a001-53b9ed8d0f7e,Residental,0.5870346674262127,1,2,120,892,772,77.03445325865273,4945
f1da7aed-c62d-4e9d-ae7f-ca448eff3d58,Residental,0.839816262799817,39,6,364,434,70,36.174097270686424,8732
6c00fd5c-c9f0-463d-85e5-04f4c73ef73e,Residental,0.7419173237348295,9,41,159,831,672,43.902665689776036,5890
c3d3b4b7-f541-4728-894f-3e2f0bd434e4,Healthcare,0.17739350053641045,44,4,51,1389,1338,68.67869270672163,5874
e040d4cf-ca38-4a89-a87d-ea5a035ec260,Educational,0.10278890740610325,8,41,330,457,127,95.00144323566084,4446
bda52917-6fe7-49c2-8174-0cc35f2fbd76,Educational,0.9497288629985194,45,37,244,1136,892,28.245956772959463,1747
0f126c70-310d-4344-9ef3-3a30a173e33d,Educational,0.08460772382565418,42,17,478,1341,863,44.47154052164448,1629
ac6f8e97-b850-4a2e-a50d-b45886e6e6a1,Residental,0.47232012927618716,43,46,223,1124,901,34.33229451641844,2540
0eca7920-654c-4a4e-aefe-9c404bd8347a,Healthcare,0.8642773154009903,2,24,152,778,626,48.5955774346488,8084
0b822a7e-2f53-413a-a18b-1f723e3ee7d9,Educational,0.7910016366351522,48,40,347,1308,961,41.339228322494144,2251
c80a4ce1-f0bf-4ee9-b610-560b9298ff66,Healthcare,0.9050856780829448,1,4,333,584,251,71.30059728728645,8835
076483ce-d1fe-4e44-af7a-2379bf7ef6f2,Residental,0.3071721712822093,36,25,85,1070,985,47.39886595908449,1265
c03ae388-f206-44d2-8d6d-45acbcf4673b,Commercial,0.5633977825735045,42,5,605,1436,831,90.72014339544533,2856
0c21d12e-fa52-4d58-8969-c47e358ffd2a,Residental,0.028575323998613622,18,35,351,1306,955,29.477852764051473,2743
869e210b-ce25-4bf6-be60-ff6c4851afa5,Educational,0.9037999472011319,35,34,109,863,754,11.767813734576936,5096
7a599f58-06b3-4e8d-8a08-962096d7a1d5,Commercial,0.3591541937685482,29,7,7,672,665,75.7859349014325,2616
f55cc660-6b4b-4a73-a57e-4d53103a1a20,Residental,0.48682369711199425,21,43,445,761,316,25.207329844638895,8287
c7efb922-7d1e-4be5-b0fe-3562aed830ab,Residental,0.017576330102793802,3,7,311,684,373,66.55474009593638,8678
e46807e0-7ef9-4eae-bdbe-8ad7ba25f9eb,Residental,0.2558458780429329,31,22,267,1054,787,70.00437076343403,3586
8e13b1c8-691b-4a69-9126-959c8cab76cb,Commercial,0.8449505528967878,31,41,174,475,301,35.981156016935294,3387
56da6a00-4b9d-4722-b454-f343e03c02d2,Commercial,0.09444372689712288,39,32,101,755,654,21.567499733045583,9481
e122510e-b752-4274-bb35-39a02187c319,Commercial,0.2922811984083432,39,9,278,692,414,22.260557839148127,4569
6c4cd624-fd3f-4ffc-a32e-66c2039efc50,Healthcare,0.9626747855709398,2,16,639,1313,674,67.43299976603751,6635
fea531c4-2027-44d0-90df-93cc0b2788eb,Healthcare,0.49400677811882354,50,24,352,1136,784,98.19359716840462,1455
2a6846d9-8de0-4dcc-b47d-074d190bbfdd,Healthcare,0.3726586089785775,46,27,509,613,104,41.967956441198865,6523
1fc5736c-54d0-4e29-a93f-17817f27f1dc,Educational,0.2718818076752191,15,50,245,1406,1161,63.35153049416308,4001
e7149b23-d53b-4b05-ab82-6effa29f51ce,Commercial,0.21534749465766967,20,30,37,1151,1114,14.257431061148587,7775
43200293-55a1-49da-ab7b-a68bea6de149,Residental,0.2978119947107011,37,37,478,485,7,38.43170198686491,4478
e91d56e0-7b05-4f3d-b091-732bceca0de2,Healthcare,0.32059677966154154,8,1,518,888,370,51.16972554082654,4164
ca1023d8-fdfe-486b-ac5b-763c50514700,Residental,0.8154783277294313,40,9,597,885,288,74.9644439990702,8254
32985f47-a92d-4e8d-95d5-61b08ec843b8,Healthcare,0.6286467094298386,19,17,643,1366,723,90.58320425014675,9201
5bb108c9-93c2-487d-a68e-7153fe9733f1,Commercial,0.8025208881266813,28,42,201,266,65,32.99825423532466,2171
cc95f047-abab-4e0c-b3c2-0f6f50968a33,Residental,0.3797948227300175,45,39,494,590,96,88.88619176800779,8053
378cdeeb-9ab6-43cb-83f6-26888cc17839,Residental,0.05206104354950325,33,8,453,1169,716,75.86833624281631,7937
c5da79c6-032c-45fd-b85c-91f6c2ca60dd,Residental,0.7122782455934719,49,46,681,875,194,70.04467465795278,1313
78c448ac-fb3f-4929-83b0-1df9b6a14563,Commercial,0.02840516223011802,20,24,690,1020,330,89.27357896097627,4262
5bb6d030-fc57-4814-b78a-afc2dec3144e,Commercial,0.5531644446569294,20,8,504,1102,598,83.71433043164227,5761
07729d18-499c-4218-92ad-755e5da5376d,Commercial,0.7110704529628801,10,32,656,1082,426,53.485901781965126,8881
4f2eb50e-23ef-40ff-9f4d-0e8e9a681f80,Commercial,0.8377630283717109,38,16,4,95,91,86.80663872898567,9666
bc62fb12-7804-419e-825d-07874bc8b727,Residental,0.211582646785356,1,26,32,160,128,46.50912226969107,6833
3e317d2a-8540-4c38-910c-3e6410c2ebb1,Commercial,0.8899018368480196,12,4,6,1337,1331,26.19353314998664,3049
f0b64075-73c8-4b77-81c9-1d332e082815,Healthcare,0.4786932002234173,27,12,8,245,237,97.64068589486108,8440
bf8881d6-e551-4393-be9c-22355057c6bc,Healthcare,0.5846299234841275,12,22,362,765,403,15.30859267856307,8749
00a27c97-3ada-47dd-8666-23a13dfcbcd4,Commercial,0.46721862326016683,26,10,600,931,331,32.80286802364357,3679
29a7f072-fee7-4276-8884-58e284babc64,Educational,0.33784172587049455,7,34,564,1287,723,63.79629521649897,1505
0f797cf8-4ff2-46a6-8abb-70a569902ee9,Residental,0.025980461687919565,49,14,143,504,361,63.752614105835974,7627
a69512b1-5bca-470e-84d2-08e9e31ca048,Educational,0.26621767788681516,3,27,219,1080,861,68.68438518831664,5565
25fc8966-9c14-4926-b4d5-8c952029461b,Healthcare,0.027917480321275168,23,18,579,588,9,17.836474918265232,2334
e48186c2-d649-4e62-9b6e-023e602ce084,Commercial,0.9909374920128692,10,12,79,1234,1155,62.694861597258146,1571
bfb13dc8-2299-4de2-9f43-43ae54ae8453,Residental,0.7219013928060319,8,22,112,1116,1004,58.35439155852392,6612
51f3b681-871e-4cc1-92f3-0c2ac53c8281,Commercial,0.278571330683416,43,30,94,417,323,69.07108687552763,9987
548b4661-7cf6-43d0-a43e-3038ae149977,Educational,0.8179043241224371,16,19,263,617,354,49.84502005571548,3529
d4bad54e-7db6-4fc9-b1b9-ff5999a34554,Residental,0.9833678773206254,25,48,22,671,649,70.07542964557163,7047
89c9aa19-ef4a-447c-b5c5-9619213fb844,Educational,0.8591621083980483,43,48,467,1110,643,37.77493177293348,4793
e4904393-b95f-424b-82d7-7248a3786f66,Healthcare,0.9477678743444484,45,13,292,524,232,86.10421824792644,3290
2adec2e4-65d9-4796-a0bd-3017f9705427,Residental,0.9144872520481776,9,40,679,1399,720,70.2613633250142,2878
f6137350-e57a-45bb-bfdc-9754efa7b414,Commercial,0.28756207117030663,10,11,328,1062,734,83.36634041604577,3694
280f35a0-153b-4840-a926-1653eb94d53c,Residental,0.40126602514734744,12,47,154,736,582,54.15606703517842,3100
6f78e3cd-a5ec-40da-a4e1-4a1241193ba3,Commercial,0.31985011724877,19,1,303,1341,1038,49.742903800166296,2358
a3a661be-bbdd-4f17-bbda-9ce31899922e,Residental,0.8602185144913727,40,23,471,1332,861,91.23665383130263,5890
bb242b11-d950-4bce-be3a-05c72bf68a75,Healthcare,0.6660947001313933,23,18,492,741,249,27.241225713146864,2240
e19dab98-0cc6-4417-8b11-37993f12d754,Educational,0.4999526545444497,46,34,477,568,91,14.787087879796985,9896
ed6a25a6-24db-48b7-9354-997ebddfc9fa,Residental,0.6256355726248779,29,16,425,651,226,62.11579625603128,5379
8f5cc260-56ba-423d-b506-b85549ad27aa,Commercial,0.4671518738661212,22,39,365,706,341,19.342553012773372,9205
4a692cdb-4dde-45d5-ba85-029720c6a7d7,Residental,0.4700656584244718,9,32,180,708,528,39.001036215923236,7052
e9e7e746-b0d7-4db0-bab9-3eb1d5c209c7,Educational,0.7310936269657036,16,10,90,630,540,24.37604366584002,8008
4771a216-8e1c-4d13-8b0e-7fd9ed059aa3,Educational,0.47281819436207606,23,19,666,1250,584,13.483796547622488,7258
598a4c34-ab7b-4c47-9922-751daa1d6045,Healthcare,0.7174885484263607,47,45,311,910,599,94.20883109577075,1273
0a6bd1ab-9edb-4fd3-bd16-751e548a5866,Commercial,0.17954051021721606,8,47,290,897,607,86.32304455214796,3059
3caa4bb9-ba23-41f3-84c7-24e1ed66ed4f,Commercial,0.800183376516965,41,39,163,234,71,29.85567469796255,5985
b04a8aa6-0cc5-478d-b39b-f2e373831bff,Commercial,0.18936815325194223,21,23,653,1039,386,95.63706993805131,9774
6a337327-fe48-4aae-9178-45a93b1e7f29,Residental,0.24443247293988835,34,35,690,1404,714,64.69272648749512,2332
f539018f-6143-4e1d-9b4c-cdda2cd0106d,Educational,0.7759395188362783,16,48,544,1434,890,61.160181103252334,3273
9fd7572f-424f-4e4c-94ea-30f8e68c7a76,Educational,0.2570934071441662,30,42,610,644,34,68.75575428773084,6756
e9f74dc7-215e-44a5-8833-00e56feef2f9,Healthcare,0.3112771079457445,1,21,25,338,313,38.07537267508755,8372
d5472935-a677-4d89-b86c-9fe326f3ca2d,Commercial,0.41263012238058805,35,43,441,621,180,11.998356391530267,9816
d021e4a2-dec4-4965-aa0b-dce8c5b03fdb,Educational,0.4026987620266784,32,5,167,333,166,35.73837803006066,5342
1cf5feff-6626-40ec-8fbc-df38807ae213,Educational,0.44680604551399805,30,10,626,1276,650,93.30023549978334,4153
caaf817d-6a43-40ee-952a-ee0e78fb4913,Healthcare,0.849417914550296,26,44,282,1191,909,29.444730277447018,1287
ec47f7e2-0054-40fe-b8af-1b3022217a90,Educational,0.7511934148028646,19,26,11,311,300,11.003612855422107,8109
c146eb7b-3734-4630-b5ef-e3358941efad,Commercial,0.11120984957946478,1,35,547,1204,657,77.29282692211372,5096
e5752917-1a0e-44b2-bbbc-edd1f63074fa,Healthcare,0.9241340951158911,4,22,85,1301,1216,18.780993980059765,5289
6818db88-66e7-4fcb-ac29-16e3b8f70f71,Residental,0.19232450843125215,3,45,32,1367,1335,70.94478288563252,5008
15502ef6-b4ad-4310-a670-99a03590f863,Educational,0.03879253581569042,44,11,525,638,113,19.090901910383955,4892
61e26509-2046-48d2-b1e2-40ea5c5641d4,Healthcare,0.08589841507932972,42,37,662,1096,434,72.38800004069452,2583
93043ab5-c651-4fe5-850f-b90cd7be77db,Residental,0.007228325291475102,4,32,370,1059,689,47.17316973234801,2158
fb74a3c3-9aa8-46af-8b44-766253a911d1,Residental,0.6984758627653459,12,22,204,1151,947,54.04958035660323,4453
7f44d50d-cb20-4fcf-bf52-22afb373f9ad,Commercial,0.9063528901940573,25,23,583,1388,805,88.08623242989971,3718
84f9f900-ab5e-47f5-85e9-d7810f25f3ff,Healthcare,0.23132660573608232,46,24,175,336,161,52.911755132484906,7845
1977cb70-d722-48f2-8086-bbd3a4ade974,Educational,0.5340772878625963,23,48,58,452,394,37.7876596837434,8264
73ebb134-d046-4ffd-9db2-2187bf6a1ca5,Educational,0.000644122661379587,22,26,551,1131,580,57.63915198810053,5808
0b47e2be-ae08-429b-81f6-a8e33d396efd,Commercial,0.9715188754002383,9,13,159,1197,1038,15.939888766548055,2418
f3ccb9a7-fa1b-4e28-bbc1-43d22ae68577,Educational,0.2144188818404853,27,11,649,1324,675,49.34210506360981,6493
a8323678-d255-4644-ad7b-326194b6d3dd,Educational,0.6319468371903053,8,37,361,1203,842,51.622492047189844,3889
60e9a8c9-9c07-45e2-87c3-912e6fda81b0,Educational,0.46141682420020746,39,8,587,1012,425,79.85559987928495,2668
de9f82cf-5190-4245-b860-c7b40204bf9c,Commercial,0.9533440997872288,1,36,578,700,122,78.4750391627443,4218
80944980-6dc3-4f0a-8fe8-5ffd64adf73f,Residental,0.6595656875510256,23,37,353,909,556,58.570850768206704,1455
c1e0941d-5561-4427-84de-278ae65fd16a,Commercial,0.16471459523968746,34,25,306,1358,1052,70.6753543302942,7726
5c80158c-705d-4dc5-bf51-2f0ef4df617b,Educational,0.40336270054853673,25,20,648,1435,787,28.266237221721507,7747
3aa9d753-ac27-4642-99fc-bd535ce285a4,Educational,0.9864286877220094,8,47,20,1161,1141,29.653561126552656,7919
8edf8313-e9a0-46d1-9da5-ba74347b0d09,Commercial,0.49767999262641804,23,37,387,419,32,11.509616092458453,5810
db1885fd-9350-48a5-aac4-0eca2c33740a,Commercial,0.42142454518614203,18,1,240,900,660,78.65843056688783,8487
e07868fb-8679-4b64-9d57-facb59dc724a,Residental,0.31871129743591553,3,37,109,1241,1132,64.8591705636426,7589
1e6a960b-c7e3-490e-8722-54980406349e,Commercial,0.8473254313895933,44,26,8,187,179,25.972730953000177,1806
670aa6dd-9d89-4557-84d7-bd1d8a34c583,Residental,0.9433221308378879,39,14,412,524,112,88.85830097347142,2969
92cd4076-5d23-4e30-9bc8-a970e277db68,Educational,0.8676385452048859,19,6,104,1368,1264,35.18520136888003,7360
6691848f-ae70-4ee8-95c7-228eb8d87217,Commercial,0.6749593901318003,43,40,270,1320,1050,95.38254473863505,7103
bcf8e6c2-cf34-49b5-87ed-048d5b5166ab,Healthcare,0.17206741849541507,26,18,116,854,738,71.81714041729941,3602
e0756a45-8d2e-4711-9edf-d911f4f6b5b3,Commercial,0.41535636109956486,22,2,472,1156,684,36.351333918258746,5127
f6323135-1ea7-4425-954b-ed72b9919afe,Residental,0.4628908772074479,24,4,83,1034,951,49.809673263186696,1880
ddc2cd12-bf75-40c4-a1ec-22d5b616daf4,Commercial,0.6925118154750888,16,48,477,915,438,38.58915495487548,5175
9945eb16-80b8-4f3b-9079-680a18d6dced,Residental,0.7198316962968139,48,31,535,773,238,11.206311415536925,5173
78576122-68c7-462b-bd9d-41433a29e93d,Healthcare,0.6230595657023558,50,29,93,740,647,34.43239250176299,3639
3e1a4bcd-db3f-4554-bcc5-02b42d7a2f25,Educational,0.5089948912097536,27,39,247,350,103,23.20114860134586,1596
f098ed0d-7363-463b-805b-cddef9316ebd,Educational,0.0529964498023352,11,38,637,1218,581,40.719894190285174,1692
679d154f-0cbf-4bc2-8de1-cd7cfb6b4bf5,Commercial,0.3910383664767816,28,41,524,1059,535,59.04669947893364,5119
50ac8d6b-7229-4c14-b9c4-e961a1c86381,Educational,0.7666564963244142,25,47,26,1078,1052,22.638242659112613,7698
ebcb5d29-d528-468e-af74-e7606b5e9ac9,Healthcare,0.5944226895894752,3,36,616,700,84,37.433674476366676,1842
f4714180-f134-44e1-a321-a3252ea6d30c,Educational,0.4310191630964375,6,43,111,779,668,33.2888285171957,2099
a55776c7-9806-4944-b937-75b6c14ec4ce,Healthcare,0.3396009606762882,3,9,360,506,146,24.400037970561698,3117
81d3122e-001c-4811-a70a-0d87bd4fa6b4,Educational,0.23419789000174462,19,36,712,759,47,84.41559593800729,4002
192abc2a-e9e6-4060-b6f0-dc72923dde3b,Healthcare,0.8187330594620669,33,32,458,467,9,74.11284933266262,1081
e25db89a-a355-4a09-82f4-5ad2e12308fa,Healthcare,0.04248178863103458,8,17,238,609,371,65.71899807018491,6544
fc4e7a59-785a-4541-9ac6-2d2ddc5c06c9,Healthcare,0.6961060861488673,43,4,176,1295,1119,85.07162107153593,7375
c3d7ea79-2e59-4925-ad3f-8a4f5c300bb8,Residental,0.91842448307938,26,5,290,702,412,68.59639478241894,6247
bd66a322-d931-4de5-a306-0bfa9f7bc536,Residental,0.1911958631280115,43,39,16,1063,1047,47.75232805061376,1267
469226fa-d7c2-4754-9fcf-c129108b58b5,Commercial,0.825926628588537,45,36,476,1002,526,27.203478124317098,3508
f3606cbf-2511-4098-b6c5-5cd13409e5e5,Residental,0.05664436240239401,30,9,701,1213,512,66.70128323508959,1600
353a01df-fc71-4996-9379-54905d72b59d,Healthcare,0.4470566075216683,18,47,614,1099,485,12.294063673412962,9931
dbdb1613-f447-4df7-986a-edb32c4bd017,Educational,0.44866060238326944,6,22,474,586,112,12.355574293275215,1940
dea087fe-bdc1-41c3-b87f-1faa0b07e6c7,Educational,0.27257256300278365,35,14,605,830,225,73.58617527765456,2390
91550a68-351b-44a4-a44f-6a04f7f69437,Residental,0.4444114758068719,23,48,50,1200,1150,37.419835578703456,8638
96b420f6-1baf-4c72-94ad-3ca102b342a3,Educational,0.11302101181635238,19,10,394,1148,754,70.17747445946847,1125
ceee447c-bfa1-4f65-ac46-d173e541cb32,Educational,0.8936801488058218,40,31,161,1281,1120,74.54347648558571,5768
555099e8-7c30-4d3b-8170-e58b187fee5c,Educational,0.5581930945506464,41,2,461,1161,700,34.35230833768473,4438
6432ceea-2dc4-44ab-8bb0-dde4ab81bc27,Educational,0.8505819744562795,25,48,536,1090,554,50.75697307349849,1346
cac32dc7-57b9-496a-8050-f99df2a93666,Healthcare,0.22161051599579407,22,39,125,526,401,75.10867562616646,5954
555c8cd8-be42-4b32-a80f-98732d8096fe,Residental,0.45946706182863506,50,4,366,498,132,40.81842609859446,1182
86141d0e-81a8-4cbb-b8bb-aaa346ca89c7,Residental,0.9243081112717791,41,20,210,910,700,34.239356962252884,9558
fc59b6e6-5cac-4984-96b6-64e6d8d6b09b,Residental,0.8159509107636088,24,20,93,276,183,77.07014316330886,2213
8a911a02-3065-49bd-bd2f-27a4f99cd220,Residental,0.8487354048107527,46,35,141,728,587,61.689732881877724,7915
a9e69878-13b1-42fa-9995-8b0d46a4ea13,Commercial,0.06323697460915612,18,17,582,1392,810,84.11266861114613,1597
97871637-6bd0-444a-a5c2-d424e977f4b3,Commercial,0.15717410671358756,45,24,166,1018,852,27.77053114875216,7625
fec594bc-5999-43a0-b824-2be0acb2fd34,Residental,0.7562626539796776,1,10,675,1241,566,89.62445030875078,4605
618f0734-21ff-44a7-8b2f-9c90b3fecbf3,Commercial,0.06007704264022096,2,32,619,1216,597,18.795187903726923,8735
6a5815c3-a656-4f88-a546-36f3a56ff7a0,Healthcare,0.11377566787077775,13,5,218,1095,877,32.8756607217928,6385
778fdcff-8679-4828-b8f3-b7ecae58fbb5,Residental,0.21486266447747016,35,31,556,901,345,81.05152235870513,7423
b0e39afd-1405-4a8d-a983-3113aeb24e78,Residental,0.975624535989104,1,4,391,1027,636,81.16852638386011,5605
a826bde8-e602-4a61-9639-7aee2f6782a0,Educational,0.6813073484340341,40,13,390,891,501,66.1550774358853,2029
068aa220-4304-4691-9376-c65c88cf1214,Educational,0.4341361712385824,8,19,51,1100,1049,20.31469739750272,8257
099a344e-9685-4453-a164-5b22bebb32c2,Healthcare,0.34199337795629803,2,25,536,906,370,59.88257139391146,9286
d8ce20a4-0730-46fc-8734-b9052e3a9832,Educational,0.7677921428581278,26,9,509,1042,533,98.92458768447088,4777
ed44103e-b079-40b0-af29-159834466a48,Residental,0.22063326498238545,9,48,435,1023,588,82.4817256733094,7056
e1c4644f-fcaf-4694-8035-e8754a12bcc7,Educational,0.23184036564444455,45,7,520,906,386,11.041097039066267,7135
21483bcc-b893-48bd-a652-92363891e1a6,Educational,0.7528052200237682,5,41,394,634,240,88.76819553373514,7361
96033cdf-60ee-479e-b215-adc4fa4a2a3a,Commercial,0.4405453425613002,21,6,628,930,302,65.73482316470486,2682
87b85ae0-80cd-49c0-b79b-419dfa5f13a9,Healthcare,0.945708125376875,30,38,290,684,394,17.226348731712573,3857
34cc8ffb-0309-4594-a21d-f6f2ed161157,Educational,0.6569915739052696,15,12,220,1326,1106,77.88326958429998,7686
8b1ff33c-1a5f-4866-93e3-d3f991449a82,Healthcare,0.3131163639214529,4,25,86,445,359,73.45524284534505,7300
a3c0d275-2ebb-40e7-aa1a-23f2bc3b405e,Commercial,0.9354338039380944,39,50,90,192,102,51.858460997387674,5640
67f9fbaf-ee9d-4a28-9cf5-5f19746b39d0,Healthcare,0.7257572458636218,4,45,480,1049,569,30.388206819232902,2174
3ec0ca93-515b-40ae-82d1-b255e52c09f7,Healthcare,0.5291071370759742,39,10,53,497,444,27.144253268363297,5555
ec8cade2-9f21-4391-a945-bf8b00559e4b,Commercial,0.15476574107808394,35,48,9,485,476,69.40196014044469,1690
8348495d-1d66-46b2-9db3-8ca14af6fe76,Healthcare,0.8798276080231492,50,14,456,1426,970,50.10986204582389,9971
cad7315f-8097-40d4-8f17-a7386c929a77,Healthcare,0.274625014478191,20,49,689,1217,528,10.230755549463272,3766
45b7677a-b8d6-4880-919d-f378bfc28ca3,Healthcare,0.3496496953614652,50,26,410,479,69,26.59503759195704,3760
b0821c52-53bc-4227-83b2-18a36a2da54d,Healthcare,0.6762976100231036,3,24,477,1022,545,46.88959211897581,8545
99efb4ed-0053-4f05-8db8-0c849e80a102,Educational,0.5069325599179576,40,17,290,799,509,97.03375899942043,6345
14c19207-e75f-47a3-ada1-7bfb8636fdf7,Residental,0.6448142000835152,41,23,323,1293,970,23.875305807569447,1965
4726c9fe-206f-44d4-8816-ea0b3d29ba01,Commercial,0.3861624976168312,20,7,364,768,404,48.79388754994799,3046
52663ee0-4975-4380-a44b-96d0377920db,Educational,0.645348868099899,10,37,420,1260,840,34.942166447176874,2437
1016de47-4763-439b-9358-9fb5657c6530,Commercial,0.059262997698183884,32,47,646,1190,544,78.44944944218668,9069
5c82e4d2-d7e1-447b-ab57-625aa5f862bf,Healthcare,0.9412248260845473,35,44,299,859,560,31.984255761101284,8584
4762211c-2c17-4457-affe-2bbbc1b8030c,Commercial,0.24175953925394889,3,40,390,1106,716,56.370103231729715,6090
84f3ea51-7019-4469-89e6-0c77ba9e57f5,Healthcare,0.5904460620749851,34,24,264,456,192,90.85602010309873,4366
32596878-a0d8-41e1-b951-6ae78bbc2dfd,Healthcare,0.6520229389888987,1,33,620,778,158,55.78912089632613,7586
ecb4b2e7-34db-4e6c-8065-c852cf9345d8,Commercial,0.822442960521026,18,9,353,674,321,49.35055238971016,9117
af7e8fd3-c5bf-4e5c-8b06-5916df38d7c8,Commercial,0.03527356418660721,32,36,318,1233,915,37.89073776009905,7855
055b3263-6307-43aa-b11c-3dc3ea46f38a,Healthcare,0.5278911165701912,40,17,69,1181,1112,32.132386457255436,8872
68d0bebf-0ea7-49f9-91fc-a1d25ed216c4,Residental,0.6775177213090475,3,8,664,800,136,48.11268518780939,2130
7854ad5f-eba3-4821-abc3-32e5050e23b2,Commercial,0.4253839599421453,21,21,342,652,310,51.69131624781241,9557
22133123-0010-4df5-888b-1c7a0e2fb042,Healthcare,0.7339783953174845,12,18,40,1425,1385,73.85906135988255,5484
2bfd7185-385e-4a5a-92da-80eb26c6dbd5,Residental,0.8538594059922366,24,29,678,763,85,34.92260480829422,9791
c9ba7b1d-13dc-4ef1-93cc-05840156eb96,Residental,0.8010432083787542,33,4,582,990,408,98.07442962258976,3140
f4475208-b3ae-4bd2-953e-81cd38f0a7bf,Residental,0.284366595715806,50,49,93,907,814,16.552523795970856,8153
7b1f1493-d904-455d-a1ce-a75fa9b3f00e,Residental,0.05286730756292768,22,26,234,445,211,51.02570681318659,4106
2fa596c8-26b5-464b-b1a4-663143043362,Commercial,0.3459768075545515,19,9,495,652,157,25.072162345711913,6740
e4781040-2a1e-4053-8df0-c169e78be062,Commercial,0.6739649796988579,50,31,563,799,236,69.5197670184036,6824
b4df458c-dee4-402b-a712-3f0303fd3376,Educational,0.15279828223800163,25,35,469,737,268,87.84308600010372,3833
31b330c7-9dfe-4020-9dce-407b5a69b7c0,Healthcare,0.4146811040952014,9,39,716,728,12,87.87553672153098,8841
ae18c18b-24c2-4c9d-923a-9fda2c47c510,Residental,0.6465449956604412,4,9,127,701,574,41.394461463505905,3568
4e7fb537-7015-40d3-a17a-b97f788bca9e,Educational,0.8776548124009403,35,36,40,82,42,31.307175369092636,6698
b41cd39a-7e08-491b-82d8-5fdaaf85bfaf,Commercial,0.16583285622150135,40,31,302,1251,949,63.467849982261,8155
5a13f306-064e-4457-ab4f-ee1b6a2f1384,Commercial,0.729726377659909,40,47,698,1422,724,26.540386932165383,2143
def25a30-c539-444b-9acd-f04ea38ea599,Healthcare,0.7169195616390887,21,32,631,1431,800,53.89530623893649,4456
ffa2ab1b-bbcb-48b1-983c-246405bcab32,Residental,0.0037063036282788397,49,37,210,1210,1000,54.733233948243594,6765
c94bcdda-0afb-4cef-ae7a-d28c5e7d9f5a,Commercial,0.24727634532156628,45,42,431,537,106,25.113784228105075,3326
5b056964-43c2-4e5b-a443-3c51f72f402d,Healthcare,0.2542250302128435,31,2,319,503,184,90.38654922149901,6138
4a9f9ea9-d992-4418-a3a8-4d540a51ffe2,Commercial,0.9116792802142054,39,47,227,1436,1209,12.960074028974757,1915
1067b4c7-6e47-4ee8-80c5-6c31fb34e38b,Educational,0.6364947363970235,45,18,529,1247,718,65.18276040818168,6960
a7cf55a4-c26e-48a9-adcb-342e2eef9e65,Residental,0.2735839895590372,1,30,23,532,509,92.82401569667914,1452
559ebf77-2c51-4a69-b4a6-21c3749ee414,Residental,0.22144750945234304,30,48,705,1110,405,12.484958494812435,3773
56052fd5-9d73-49af-8f32-3d9c6b8632e0,Educational,0.6668583142968024,19,39,618,1218,600,19.838949507966465,1846
ff8ba475-6134-4043-ab04-ff6ace9741eb,Commercial,0.7528492354387412,43,29,82,1113,1031,24.162063072729442,6122
76117106-7951-46f6-bcdb-bc0a2718c1da,Commercial,0.8070835257405994,26,44,219,664,445,69.6204748892533,6224
6eb1cf20-fb2c-4fb7-83d5-7eddfecbfe97,Residental,0.4544315812625601,9,9,165,1074,909,71.39491803218507,7356
4a525936-6744-4b4b-8127-8d0798adec55,Educational,0.019199367110211973,11,3,498,1247,749,20.56782841509872,5673
8d0957fc-2c9f-4963-973c-9b9536de32fe,Commercial,0.7007170366421198,2,27,451,691,240,52.82723995959239,2481
30a322c3-3098-4138-8c28-0279aaf3cbf1,Healthcare,0.18901985581171488,28,36,461,842,381,80.14302706632083,1427
b5792963-0703-4aeb-b196-5ea46b6c337c,Commercial,0.4150713103515088,39,45,501,671,170,41.78261472071059,8636
3c4346ff-d174-4040-b648-f9b5d6b9e408,Educational,0.6285297521852752,10,4,501,809,308,17.40752362598998,3447
ad352095-0458-4576-899c-43d431779194,Healthcare,0.6490484994662361,21,15,609,1245,636,94.99233442293784,3981
0bb45b67-4e94-4706-9362-35b4f55a8573,Educational,0.5235713274642875,19,24,269,326,57,34.05220409089762,3796
9d00ac5f-e330-41a3-8845-4b0887b2818f,Commercial,0.7962161305723645,33,25,275,988,713,37.89157593857186,2669
a8529634-baf2-4d5d-a47b-5ba3b59b7dcf,Commercial,0.40354324220929705,46,15,419,1167,748,62.04843340163786,8300
fe474a8e-c3be-4a37-b354-d2bde078ecf5,Residental,0.08975343283244308,43,10,437,816,379,79.41494712263646,6755
f7716e32-e048-4f2a-9f5e-da6078826c46,Residental,0.11097691503880136,45,28,534,639,105,99.67017395445647,7262
efa74bb1-e2e2-47d1-be96-63de166b9d5a,Educational,0.06782929437422314,11,28,701,1148,447,35.78917777981306,9343
094634f9-ab6b-474b-ab5c-6c42c86ad5eb,Healthcare,0.7450114271870956,46,5,109,586,477,66.80364586416432,4548
b4553a39-bbc1-4fa4-9cce-235a88d1ff20,Residental,0.7260826761040444,46,40,21,799,778,60.56272093089156,7789
6ef228b3-ff25-42de-8290-2f7f812e0332,Healthcare,0.6166227085581552,35,16,586,855,269,72.28874668156577,1340
6b62de74-30cb-43a4-befa-94e3fae32a79,Healthcare,0.43905886929903626,27,4,99,700,601,22.11777459224249,2859
6561ea2a-3e08-4fc7-b905-80e266caeef3,Healthcare,0.6991250260004334,1,3,501,577,76,14.925437812843349,8495
a7466d80-af3b-4dd0-a3b2-6640d5a2f00a,Educational,0.09857215337596104,16,29,264,688,424,95.48221806677937,3530
3363ddf0-e714-4424-92b1-4061f0b7fb09,Residental,0.6400407247037315,16,28,587,993,406,13.602106222107526,2714
9e277d92-12d4-487a-a8c0-9ad408c9fdfa,Residental,0.12106400960426034,45,33,126,408,282,67.24466169298044,8878
6252b5e6-07a4-4bb0-8bc8-b1e13114715e,Commercial,0.1302594786767005,1,27,674,714,40,10.328831061432142,3893
781ee0dc-f88e-47f6-8457-7313b22b2173,Educational,0.27660205971425733,22,36,512,1117,605,76.60161309194744,7624
fb9c841c-082a-43e7-9b86-1b4efacefe0c,Healthcare,0.7830845977025956,23,37,407,1056,649,36.54777241275535,6390
ec2ee185-d2ca-4bb1-80ca-73d3cc8231c0,Commercial,0.39873477025935733,43,8,378,715,337,78.84941976867452,4840
ba19a2ad-ec9f-446a-9727-766deb5deee7,Commercial,0.4338969293777103,48,5,172,217,45,15.054134755187714,9396
aa055525-6951-4ecc-89c1-48b63cd52f45,Healthcare,0.3596761328904199,13,33,704,881,177,34.538983281086885,3906
dc8e2a52-2971-4839-8ec9-26a10341aeb5,Healthcare,0.37928366544241787,13,5,684,1050,366,98.42221467782807,3853
105e6b05-2ec8-4975-b666-5cdfb5c23b84,Healthcare,0.7422630080888178,36,17,263,391,128,86.09471641573685,3352
882ca5f5-6600-435f-8919-0068892bb0e1,Educational,0.06251772631814989,3,46,134,914,780,12.280202924535004,1485
dd1669ef-0f25-45ac-8b4c-39fc1b77d289,Educational,0.7354407474510285,23,47,642,844,202,70.41408989437238,4647
59539965-a483-4480-be53-425cff95fd96,Commercial,0.25752538680948145,27,7,264,646,382,24.71525756753561,1957
33d6f697-c300-4fa5-a3db-0131ec7c9a8b,Healthcare,0.2088275457764488,35,42,611,1133,522,46.49304124568987,4999
cf4d7989-0b9b-4792-bf25-af2f429e0638,Educational,0.5787635067290171,18,42,541,1373,832,60.8255925685269,2435
52b569c4-e332-4e4e-b795-2d07f321e542,Healthcare,0.4647341620107317,49,22,39,1218,1179,79.291673943522,6892
69af4861-ba61-4cf9-a142-50b8c075a3be,Residental,0.2829061006963751,4,43,112,756,644,97.2673114886519,3309
354056a2-6c1e-432c-95c0-31087abeaf74,Commercial,0.2661403603045196,12,30,662,1152,490,84.08159460323154,8880
82ad6307-0472-4f42-80d1-88e2f7ca8e58,Educational,0.626409626131046,3,9,161,1351,1190,70.51505346498527,4566
a2ef7fbe-7f0d-46d8-9b9c-96b334654961,Educational,0.7161472349167648,11,6,329,1129,800,92.8399078430112,9219
4e2b8a9e-5d9e-4113-a6c9-940ee7905970,Educational,0.12183728948107453,2,33,510,1273,763,47.85930530339892,4797
6416ee21-8587-431f-a9c5-a10e79aa2827,Healthcare,0.886443710659952,29,48,77,512,435,33.457413289083576,3540
0f9996bf-d2d5-48d2-b76a-945a2bf1a41f,Residental,0.8117699009127592,45,14,709,1293,584,41.79276279271794,2327
7dbc4338-2f79-4e24-acd8-c2a65c2efd9c,Healthcare,0.6579475485624512,41,10,107,888,781,98.05724298656114,4684
b90913fa-0877-4315-85ee-e54d52a806e0,Healthcare,0.6260534310579073,3,34,422,524,102,54.58537592537447,4952
f7aeab14-82af-4c97-937e-982d8dd2e813,Commercial,0.4133648515738082,26,48,384,1117,733,17.62643157234549,6727
03973f06-8817-4df6-a898-0cfc160cd6a2,Commercial,0.2950188085250056,17,25,257,641,384,45.66272320103347,4869
11e752d0-b070-4d38-a646-44746d54e3e2,Residental,0.7484134604684778,15,31,121,232,111,35.74350558747232,3158
eaf38994-2056-44de-9906-6e634904b117,Educational,0.3087150287223358,18,26,572,885,313,16.989934256688557,3055
32d6d835-9174-4947-9a8c-bf98ed4c4c00,Residental,0.628566729302501,4,8,691,1319,628,66.10164591793442,3222
2c82b83e-57db-4491-9790-4cf3b15870a0,Healthcare,0.44438917778505405,11,50,402,939,537,56.73733201300597,8807
5b79a14d-5118-4ede-806e-39076b252b5d,Educational,0.30034999863379575,39,15,638,1056,418,79.76829147088375,8201
62e51b38-4cfb-483c-a0b2-49f1be16212b,Commercial,0.13529033719881012,50,19,573,610,37,92.90492197886928,7994
277550c8-deb6-4a5b-ac7c-5c638d3818dd,Educational,0.809321854413688,33,28,554,610,56,21.52587641773001,6821
73e5860f-a721-4c82-8ef9-f58900e7031f,Residental,0.7400735350879345,49,35,263,1126,863,86.95741430612965,7845
179a0521-bffd-4663-8fa5-160349263c32,Educational,0.7043160947988105,11,11,218,507,289,26.513426090840998,7615
95feb3b8-380c-48b1-8fc6-5d77553b3213,Residental,0.01583634793061872,50,11,662,1247,585,26.065541888721235,7194
1f6e831b-e0ec-4d31-9407-61b937bf5f04,Healthcare,0.8649346338963081,41,18,526,1101,575,75.80858987263913,7506
41f1af2b-118a-42f2-a51d-68bfe463abf9,Commercial,0.8271622283173529,18,2,209,1324,1115,39.474380315182614,9991
ab44b949-88d8-4cff-ae7b-79ded83f8aae,Residental,0.5792649388807196,4,32,178,799,621,56.76774119562547,1346
77653d69-d395-4224-8f89-2933d1b973dd,Healthcare,0.6834605480184669,5,41,37,700,663,29.179700678952464,3280
75d9574e-9e00-4bd2-9f92-cc47feac4c4e,Commercial,0.12580915195506648,27,24,341,678,337,90.30641717282812,6067
0a973788-3b51-43fb-9101-7233dfd8223f,Educational,0.6859221335976253,41,27,680,702,22,87.01454053625301,2947
d699caec-0fab-4b22-8064-2102f62fdc32,Commercial,0.5486704754206361,33,42,44,1031,987,16.150337122719414,3211
669c0300-fa5c-4f55-8b5b-0be3d724d11f,Residental,0.778569196042809,29,22,113,638,525,57.26594757457531,3430
14c213c5-f8e6-42cd-a6c1-7b7131194d5b,Educational,0.7605623962654449,7,7,27,365,338,54.95854682504323,2936
faa7d697-2c93-48ba-9343-76d06f03dcbb,Educational,0.40774613261213244,16,16,476,1222,746,11.765710522277836,2928
518b5c7b-494c-49a1-a5bf-6c4386befef2,Residental,0.8601007489969007,43,42,195,1086,891,86.13856103288447,2734
73588314-dfdf-4edc-9a47-32d6a391772f,Healthcare,0.7882559211831018,40,10,418,445,27,41.45762328372623,2359
37a40e1b-b9d5-41be-b2a8-6bebbd8af4c1,Commercial,0.4645115493853206,28,45,121,857,736,38.76603098351072,2730
de27b05d-1e85-4e8d-952a-de60e35c9828,Residental,0.7074587580475444,5,42,6,741,735,26.062014879420495,7703
4b77a41e-353a-4d18-a9d3-8f6bc23a4fc9,Educational,0.4889328977503492,10,34,43,211,168,88.53565907437986,3521
c7564ef6-ce48-4fd9-a12b-307f62038526,Residental,0.8763925354476448,38,22,361,1262,901,87.2886752664478,7077
4459093c-b3f7-4a6e-9cbb-cf9818a7ac46,Healthcare,0.0232760483927259,13,37,707,764,57,72.9109399096337,7221
103058fe-e3e5-43f6-b162-7ece963ad407,Educational,0.6544291776500568,30,11,688,1180,492,62.23971611109961,2891
5535cfe0-7697-47ad-bba4-4296cecebe29,Residental,0.3261796199324789,25,43,147,174,27,38.04106900069529,6681
a430d043-9f18-4224-984d-ce5e1f42679f,Educational,0.4804015328380782,47,43,133,1291,1158,35.95831685959436,3189
f9cf0d7e-8fc1-4d64-bc0f-cac71a294cab,Residental,0.4731732615167463,25,24,500,1067,567,84.44357109122085,7994
b24e40b6-85ad-47d6-b969-24237246b87f,Commercial,0.4697518663783202,23,44,234,1175,941,94.97347326955595,2971
02f64422-a1bb-42cb-a529-8a82f22ccb0e,Educational,0.4164990868100781,46,35,6,547,541,74.96913990766345,3937
0b447cea-0eb1-4392-a9f1-894ebc0cbe3f,Commercial,0.2887791487706699,46,37,491,1260,769,75.6224671279909,9030
3ae53477-3258-44b0-94b5-b0ec6cddb251,Commercial,0.4539096333703535,38,13,552,1327,775,29.585469938747835,8442
de880b79-0894-4b1c-bf0a-bdcf6a1152f7,Commercial,0.8748755660266894,30,14,530,930,400,69.83119953224733,7591
a17faeeb-dcb1-4a1e-8765-59e130087e88,Educational,0.8539520253038999,35,22,149,781,632,74.35991165162216,2823
5242e3f9-2308-4445-bb76-767506e86b4f,Commercial,0.880730460687239,17,28,261,313,52,83.46395093042499,5068
bc0a5cb3-f1ce-4195-a552-d55b20d4f630,Healthcare,0.2935123571086432,43,9,659,1134,475,16.61062687014498,5949
c56e0761-14a8-4bab-b20a-09afb9b7f86f,Residental,0.5349438898085539,44,5,643,910,267,36.70371254118573,4373
a5baa621-db72-4617-ae53-dc0b76d82a16,Educational,0.9981633587437184,28,2,567,887,320,47.993995822578235,9284
d43cfc47-24b4-4f6b-aaeb-8f904d3c777a,Educational,0.6485269674226127,31,21,308,733,425,77.84586594607617,5903
e0210dad-efe5-4f6d-b865-10be28d6b7b1,Educational,0.42163939043196574,17,20,644,733,89,29.96792462191187,1144
82bccda8-f1ce-450b-9010-5f3a4130396c,Residental,0.8851981618343511,29,30,289,1106,817,62.36367866195657,8561
78584f6e-ac40-4e9c-9642-5e56ea0f21ce,Educational,0.6270974897425162,16,29,6,248,242,44.684220184827055,7148
1f5e17a7-5a16-408c-a048-1b37b301b7d6,Educational,0.9906845018302955,7,16,136,382,246,55.77429201204825,1928
bc9af3fb-d7ba-4289-a0f4-2b41d3644589,Healthcare,0.6420568501918557,33,36,302,1092,790,43.74355336673679,3071
bb79eea1-abd5-4b99-975f-b3d6f6be3a6c,Residental,0.07167526607696184,36,38,417,520,103,64.69588402096196,8201
0b46415e-3751-41b0-af50-91590c0954cb,Educational,0.3760938045313529,24,10,224,1254,1030,73.75608228267308,8439
3c137cf1-2620-47ca-aca1-27eb91d9a424,Healthcare,0.09175284309203458,37,48,685,836,151,73.86508416706269,7334
8b550526-b3c2-453d-885a-1345309163a3,Healthcare,0.20594515037513061,49,36,706,958,252,73.54532244065744,4661
664e1afd-6e98-43ac-aa05-9d576d022aba,Educational,0.9943515187065227,38,12,250,474,224,49.70433415403519,1327
d2a89307-aeb8-4a71-9b3e-adca8534bb52,Commercial,0.6867812509340671,35,20,195,362,167,72.26853044800389,8547
ad1b7c46-2bfc-4f1c-8cf7-778eb36d2448,Educational,0.17658001882307117,37,38,528,723,195,32.611769706367326,7472
dde48b7e-0433-4ba6-9f18-359810a109c7,Residental,0.9471019932665729,13,35,389,1395,1006,41.20000420784725,4371
d42a03ab-b5c9-431b-beae-65253a77cf43,Commercial,0.6806241863607174,48,36,597,1155,558,93.11020542337553,3094
7125fcc4-23cd-4fd1-b586-f4d481551697,Healthcare,0.022349389848973278,48,48,371,1072,701,96.71545478144078,7471
a0ec7540-7ad4-47f9-8f00-9c21f18abd1f,Healthcare,0.09117043072884667,45,36,635,736,101,25.239786089425557,8567
ffef7bf4-d010-4955-8722-388655488a12,Educational,0.6666194396565489,8,3,106,404,298,52.022244249359645,7901
ceb9efd5-f146-4c46-b0c2-314892eeb706,Healthcare,0.6540302856090069,28,41,174,887,713,66.2820000485174,8609
3a6cb924-7483-4f53-8a0a-63ad4b20fca2,Healthcare,0.00557451941426701,7,26,360,878,518,99.9617448392233,7701
c6fb3024-6b6d-4bcb-858a-9cb2e8a6e9b3,Residental,0.35254718324092127,29,40,512,1381,869,50.53038621548679,5441
c51cd04c-cb19-47b9-94f7-e96cc58f9075,Commercial,0.8984139531959419,45,6,431,922,491,36.27277793130138,8965
caf69699-6843-4161-bd84-4023be27125e,Residental,0.11398613779277877,35,23,295,693,398,10.242593284766281,4120
7fdee7f6-a6ef-437c-bb75-c9f187d21353,Residental,0.5600113950008323,17,36,186,736,550,78.18072728353998,2122
1332da4e-c10b-4e71-a50d-3cc41c69af5f,Residental,0.13438170526230464,26,6,363,385,22,76.52247015517274,6467
9447f9db-cf3b-4e17-a02f-71f8f37ce62b,Educational,0.7628173395583747,14,35,565,794,229,36.41735985644579,4107
58d4aab7-b382-4233-b993-ab9bdc182e26,Commercial,0.9664697537309294,26,31,184,906,722,58.27340498608058,5975
b7e571d6-eb37-4d8c-a505-7d5ff43ec2cc,Residental,0.9827244282290176,39,50,29,940,911,38.06036887066183,2331
9f09049b-615b-4a49-b84c-3042e5185b62,Healthcare,0.45024613293686144,35,30,665,1410,745,62.81438577195333,8314
eddafe2e-df5f-465d-a227-17581c0f4c79,Residental,0.30665248509564313,47,36,612,854,242,88.4494011763195,9436
f1b95cf8-7238-4257-92a6-ad55e6931ee8,Educational,0.4859769674423736,50,13,639,1267,628,18.754381998642465,6366
de7ff19a-58e7-43f5-b9b3-31a73b72528b,Educational,0.9577526760269859,1,8,274,1094,820,89.4988464528248,9772
fffb2364-9459-4e77-9cbd-07d42f37734a,Commercial,0.6658512906273357,50,41,544,851,307,30.46545710137272,2771
a4e9ce70-ffbf-4d60-a55b-55820fec87c1,Commercial,0.8214298438081896,41,8,624,836,212,72.25198506245579,4483
58aa1168-fe41-4950-8f76-d6394a46a43e,Commercial,0.7580390584384304,5,50,681,1070,389,14.639943995939742,8917
c8c52679-7e44-49b7-85e7-fe3a6bd68730,Healthcare,0.6511508401914745,1,15,158,1070,912,43.618354472665494,8163
540e58a1-9856-4b12-932a-449c69752320,Healthcare,0.3546795393267811,18,7,409,443,34,35.067482995893286,9609
5e24e3ef-d17c-495e-94d5-1af502431b03,Educational,0.24036862803320902,46,6,393,978,585,46.07398730048225,4302
174acf56-0bd7-4eff-9c21-6e91c506dc0d,Educational,0.13630416877198848,3,38,527,964,437,54.490315618086875,6381
6a7813dc-577e-4a9b-8483-1a55158ae85b,Residental,0.6424143249556844,38,24,635,851,216,11.748178959002438,4753
67e66ea7-c25e-4b52-8acd-e2e19b9c38ec,Residental,0.7870592093935527,37,27,500,803,303,50.40566560812429,3243
981158c0-76f9-484f-9cbc-13cb34c45bc8,Commercial,0.6022761007591807,18,3,427,1216,789,17.97271659346947,4190
7409f2d8-d002-4f79-87a1-e2f0e0a9d0ab,Educational,0.015724153847199385,15,18,531,857,326,12.221585859303152,4383
f1a3887c-deb4-451d-b202-f1aa06afc746,Commercial,0.9576525956453481,48,23,528,1268,740,99.387907280547,1309
82dcba8d-c24b-4e27-93a2-3b86779ed432,Educational,0.6288234758676097,42,45,553,1179,626,38.84496579209143,1032
3c125002-1620-49be-a0cb-d1c73ac11b97,Healthcare,0.03903958368480698,3,50,467,1421,954,28.96255992563537,3149
4f7667a2-dda5-463b-bb49-1e736d7b7a29,Healthcare,0.26356361929066596,4,39,422,762,340,19.633730948125724,4412
33ed9ad7-cd99-4733-83a8-1fef413d075a,Educational,0.3981180618088487,46,15,418,517,99,42.790863474810166,8071
be36deed-67a8-4763-86e4-6ff50f205b08,Commercial,0.19704047041668937,28,9,602,679,77,13.315846658652262,6598
c0d8c6f1-8478-4b1f-93fb-bdae6e329473,Commercial,0.3988169183910638,42,12,585,858,273,56.77445732066314,9551
b95dbda7-54b8-4be7-9dea-081759c02378,Healthcare,0.7375848835654876,34,14,393,1214,821,48.83748129256355,4119
15a4792a-f92c-4fa4-abc5-75a3bb676fad,Residental,0.9455044879552246,37,2,487,1375,888,40.78832164376962,8708
93e38663-5537-4be0-9642-d15f5fec76d2,Residental,0.6115950318142555,16,32,547,599,52,40.77054210696191,9275
4bf83b61-bf32-4bfe-affc-35fefdabda14,Residental,0.9773294735346651,24,21,112,376,264,59.39325897295891,9304
87da3ca2-4e83-4a3e-a6f0-35a082555d38,Educational,0.11617634759219175,49,44,467,572,105,70.3151714840536,7029
9581b621-0d3b-4550-b27b-717ec0769f0a,Commercial,0.3377718421561011,8,35,380,1234,854,36.24787828466043,1310
7fba76e7-e836-4eee-a368-55579353268f,Residental,0.6093496859703895,30,41,478,805,327,52.87714408887972,1989
0fd17bad-7a44-4156-891e-98fc102dc1c2,Healthcare,0.8145508462359106,12,49,271,1387,1116,98.80938821861393,3900
04fa9e87-4377-443f-8bb7-21370e41700a,Educational,0.32214322338958545,1,29,486,647,161,43.598444187611236,1350
33d45a21-336f-49bc-b10b-a727de569f18,Educational,0.548596025026087,38,41,675,1190,515,11.59765205026922,2450
654433c0-6a95-428a-91ee-ef4c73d9b758,Commercial,0.22598504111781803,19,2,623,730,107,69.49640191360999,3717
a79877ee-1b4b-410d-a846-8c0c0bc81f07,Residental,0.9584691469313233,1,41,712,923,211,44.26931019175586,3443
925e1dd9-5e3e-42ad-bb01-8e52affe3001,Residental,0.34787552978954916,30,31,112,630,518,66.83940105007639,2357
86d20a1c-5f2e-47a0-8519-31a2fd5c299f,Healthcare,0.6535793914424262,43,1,494,1098,604,84.26063823701418,2359
466b7e51-4c25-4783-98fa-a9b7e5c14379,Educational,0.6791166200179983,3,26,661,1368,707,19.613989345892335,8204
54221e65-774e-4deb-9985-6d63102e7215,Commercial,0.05436012247128441,49,34,500,512,12,45.885462812259036,7090
619364f4-4aac-4f27-8db5-f543af5353c8,Commercial,0.48348846869766726,9,21,116,910,794,33.43805365395889,2555
fafa8c08-25bc-40e5-b716-88153b96739e,Healthcare,0.9246950013134464,20,17,424,1412,988,49.004153381916595,9622
52259fb6-f33b-4a4b-8a6d-34c8a66973f7,Educational,0.43417260071321684,24,29,201,767,566,39.059280773026344,1615
b49a8e1a-ca9b-4c96-a1d9-cb45acc574b6,Healthcare,0.14589650545935318,21,13,420,648,228,25.197718572368437,1527
2d260e59-982e-44fb-9cfc-19ed610c655f,Educational,0.9340424411393604,29,6,467,590,123,14.912466672829405,6668
95b04efb-0599-4b9f-ab0e-21fbd1555fcd,Commercial,0.3141504066971951,39,6,450,1239,789,66.20715953800222,8802
2c256473-df0d-4b7a-a90e-9cef0664ad8d,Educational,0.904440729950155,36,6,367,965,598,65.17788014139515,6498
5387e26d-2f40-4dab-b09c-a69dd9d709bd,Commercial,0.1505836467572973,29,16,208,600,392,10.76256175999031,3129
90a6f776-c721-4a46-b22c-f37abc53ed92,Healthcare,0.9142815131020828,47,18,537,1216,679,80.9127485958594,2851
5c686ec6-8c0e-434e-bf32-0e144d1ceb8c,Educational,0.5401405072665493,15,7,50,536,486,30.518806208946717,9380
b4c62329-5502-4ecb-a41f-67a4bd1af910,Healthcare,0.9775612701948354,43,47,106,299,193,20.706202972982197,7193
441c2758-99e0-4935-bb41-243c4a616c40,Educational,0.854651466272421,6,29,330,1283,953,87.79579287178359,4811
1ee5eb97-bdae-46a3-b072-fe823f303f89,Healthcare,0.03513674476861506,33,7,545,1078,533,34.6715858129059,6492
0e7d9dec-fdc4-4cdc-9cc1-4aa974c3f259,Residental,0.7311760058272394,48,30,555,1406,851,26.142450300209433,5255
70a0c230-d2ac-4676-bd53-a564a320fe61,Commercial,0.1510629446404933,39,16,579,766,187,73.72516430883218,6555
b2a146d3-1ddf-432b-9f6f-c50911262969,Healthcare,0.1880743726649201,9,5,568,1406,838,97.18949777221839,9859
aaaefbe4-b0a9-45f3-aac7-21a4ef3f395b,Commercial,0.4091393224472034,25,17,718,1288,570,43.72695059557366,5072
d3d46660-e2e8-468d-9360-6c58bedd633f,Educational,0.7879147558449988,23,26,180,249,69,24.691063361667744,7036
95b54d48-3b57-415b-aea2-6a1447afedfa,Commercial,0.237053502872959,37,3,38,785,747,40.61735575357447,1484
bf73f2a0-6659-4fee-8fe3-c3fb4364e401,Commercial,0.954402431798658,45,13,40,634,594,16.84089083454235,4036
5750ed1e-3f2f-4148-9285-6d4700a18acf,Residental,0.7955497291571944,27,36,136,870,734,85.72545923026249,7712
cc26beef-43cd-4d5b-9dfc-bc4c1d898876,Commercial,0.20407015973080134,39,17,473,986,513,39.89192882911129,6882
35aad8e7-129b-4a6c-8e21-60230cba744d,Residental,0.6788806054647739,33,7,273,1070,797,49.5951631194838,4184
e99fc912-81a7-4bd9-8a79-ef2162ecb2b5,Commercial,0.9227047641700418,47,34,417,1075,658,28.72741019407401,5143
248c95aa-8059-409f-99b3-b781bbcc72ad,Educational,0.9206675443092391,21,13,63,914,851,69.40471749343288,2271
6024dd09-8948-4843-8799-1bc2cfd5a4c3,Healthcare,0.47703845181264604,6,22,33,1070,1037,55.146920227531126,6874
e1c7d67c-5d7e-470c-a6c6-eb9b1d793dda,Commercial,0.7827766548739379,44,23,591,1076,485,25.93397334750715,5994
1b9b7e9a-ae5d-4351-8d9e-e90b9e29ecf4,Commercial,0.7689413646136126,27,4,207,1229,1022,70.78602092485303,5555
6b300ca9-011d-433a-b64c-18dcd48acc80,Healthcare,0.6596901025520501,14,8,64,627,563,19.230153640603476,3725
62ab2ed7-5212-40d8-93bb-a584b22bb753,Educational,0.17421069891468832,45,39,475,965,490,14.011463230127664,6561
d6bf2a5f-5172-490d-b61a-53325090ec59,Healthcare,0.6444223195117291,25,46,484,929,445,78.36197062988917,6218
b99ce8b3-2e17-45fb-957f-64c99b231cb7,Healthcare,0.7150949278652007,26,16,114,485,371,52.50150379983978,9164
144da2f4-ed99-4cd0-8d30-12877a034a98,Healthcare,0.6214388779646625,11,10,443,541,98,92.0794885146318,4730
5014b339-e480-4403-8086-9e8636548418,Residental,0.8919178116895409,45,28,443,1291,848,45.5169270741848,9628
b3e29b49-748a-4fec-a2a4-1d7c0ac0bf6b,Commercial,0.9505095333720499,16,44,310,473,163,22.116545080233706,9961
d9032a64-151d-4ca3-979d-3ce5b343c67a,Educational,0.8855962197412557,38,2,524,667,143,78.42413137075911,5810
b271d339-c66e-4873-bfa9-11b8c6cd49cd,Commercial,0.4303589489110832,15,50,7,648,641,40.844002427090935,1560
a6148233-df86-4631-8782-47d6e0eef6b1,Residental,0.20534319951722035,15,25,131,758,627,33.4827496163705,3826
9b103426-57ce-469d-9e42-79fadeeae270,Commercial,0.16926663187890356,48,10,477,592,115,27.446246512382082,8388
ba0d4690-d973-419d-ad4f-1f6170ad3d3f,Educational,0.45680686228542955,44,30,46,194,148,86.27079982061606,6234
9158827a-bc3b-45c1-9c01-25cf3f548d0e,Educational,0.5266348969130907,22,40,674,1029,355,85.97562156427534,9982
a0ffbb68-ce4f-4331-b53f-9b11232ecccb,Educational,0.8582894012446333,6,13,406,1428,1022,23.607051462275017,6144
b15e04a3-cc89-4b87-9704-c511f1fffefc,Healthcare,0.6335028281819163,12,28,94,1339,1245,53.07015849387045,5552
5ac5407f-ba12-4c99-ac0d-9ea0b4a558aa,Commercial,0.54007593155882,20,43,513,858,345,78.22616964872934,6160
92502f08-4562-409b-98c1-6c713609e05b,Healthcare,0.8436091389382318,19,42,117,156,39,33.56458403461801,6149
1a69f76d-235b-4eb6-a5b0-81aeb51ac2dc,Educational,0.023496531521983388,46,21,356,731,375,24.44564206819271,6666
9ff15910-e4db-441b-a6fb-500f7434d0bc,Educational,0.46877377080314964,2,9,455,1076,621,86.79653481535213,7924
e1cd99d8-6d5a-40c7-a68d-db416c0d39f0,Healthcare,0.13670671882029017,26,33,54,646,592,54.41352980331425,3107
2068d44c-5719-42cb-a24c-6de931a1a3e4,Healthcare,0.46974873127517425,19,27,628,1098,470,63.30662350028155,2386
998429d3-6eb1-4d79-9d46-326814c1cdd8,Residental,0.27916521425858065,27,49,151,1133,982,76.40691918216007,4534
e4b11bd0-4b0a-4a87-a48a-e804e8bb01fe,Educational,0.36874833909339866,33,7,681,906,225,81.43625508156987,8552
00887cc6-3d41-45a5-b211-d7c48781cd60,Healthcare,0.6970867015990647,37,22,709,940,231,11.367986696719113,7172
b5a11787-48c4-4999-b617-01cecf2e85c6,Residental,0.7109171613433998,43,21,714,1147,433,76.48132585466722,6028
c9cbea8d-9c43-4ff4-adff-1322bcabedd0,Commercial,0.33805768010520254,2,37,541,1176,635,69.53265362729974,7479
d7f3e06f-e152-4a51-9a23-35ff698ca0e4,Educational,0.45552305670323856,2,12,627,860,233,50.39054743013964,9620
8bb4637c-d7d7-4129-b7ed-a7bac96c2d46,Healthcare,0.8978952246037151,8,41,517,741,224,89.62257410243471,1716
a1854cd1-19cd-4d07-9b14-da65d3cb12d9,Commercial,0.4797552021959224,11,10,64,813,749,83.6703403029488,7493
7fee805f-f25f-4e63-a115-fbee1aa911c0,Commercial,0.5994749599746456,45,46,429,1005,576,43.706592550525,4566
1adb4243-9d09-4622-a14f-250fd04d26df,Commercial,0.37863781661308893,12,12,395,1186,791,38.74184711245632,4629
4a83df6e-4e9a-46bc-bd75-b632f9f464f4,Commercial,0.3532458946647785,15,17,105,1199,1094,70.03817379096236,2934
11e0fb7c-d00e-43f7-9d76-9b713102b8a3,Residental,0.521332203932962,1,21,592,888,296,41.676575949194074,2529
5ad271d4-b6b8-400e-a04c-36a106627c79,Educational,0.09724920626178368,24,22,521,1341,820,86.87047723531211,3041
8f1e1a5a-a766-4344-a558-b18957770c2d,Healthcare,0.7724252323960574,41,48,688,1140,452,14.67286272241354,5708
67648edb-cc80-467d-a324-5ab5b5bd5fb4,Commercial,0.7123957413684064,43,17,541,993,452,71.37904601472391,9330
e59a6a27-bcf2-49de-bca0-5c8b4d92c605,Residental,0.3065530979790577,10,33,606,1257,651,74.87598776496391,5190
3856d4da-5c9d-46f8-b2e3-43ebc4698645,Educational,0.11186390099686794,3,26,465,511,46,68.17823611447461,2991
ba46d1f4-3327-4627-ac56-45479263c43c,Healthcare,0.47799147318163004,19,37,311,704,393,46.041469855513576,2106
084adb41-a2b7-4d3e-b6de-fa6f290db232,Healthcare,0.47901214547446536,34,5,13,654,641,81.17437258689388,5405
0aa40c54-d7d6-4c1b-a575-937567299155,Educational,0.16673365773778692,47,23,280,291,11,19.936054957876102,3996
5eb180a8-88bf-496f-b58a-f8f0e480b5f4,Residental,0.7001403904680036,21,36,571,1263,692,47.65872900509793,6300
f20b6463-2802-4d18-af1e-17e32e682928,Healthcare,0.45082155597148554,3,7,716,741,25,69.654900093429,8973
e3a0f78c-cb11-4440-b223-123523d7cd7e,Educational,0.34562385651626815,1,22,67,587,520,24.306853074950826,4465
17d8d5f7-fba5-43f5-9e11-a58123d13f71,Residental,0.8254848376340603,12,4,358,604,246,36.79522117904202,3412
bb51da05-d164-4bf1-ba90-d60a57c84775,Healthcare,0.8565889774460101,49,16,514,768,254,82.25829267854617,4574
5549c0b6-6a4f-409e-a601-75320e6a3175,Residental,0.15620603679273848,5,37,525,1276,751,92.8357848326987,8669
bb117af3-36ce-4671-b982-7d6b85595063,Residental,0.3731504057930686,9,33,216,998,782,46.11249815741407,1387
69e35297-ab49-4411-bd2c-2c9b2b648737,Educational,0.3479962522909551,50,23,614,798,184,48.066586570589735,9271
e3a6df7d-ba16-4454-a242-fd787267907e,Healthcare,0.6658113876867111,39,4,593,1128,535,15.938946484262367,5039
ae416a1f-6115-4b59-9199-3ad6cf0ee1ad,Healthcare,0.7840976958705381,41,36,365,913,548,94.14066035480954,8243
e66a85e8-1585-411f-84a7-d466021d5af6,Residental,0.025153973556101605,48,10,699,1339,640,60.98760570442866,2143
a9278a6f-9173-4fd6-b7ff-7ec65bd0c609,Educational,0.049257999662128626,6,5,510,1138,628,26.87994785495615,1193
c0a124a4-589c-4d6e-8a5d-afec5139adf6,Commercial,0.7533791815405303,7,45,554,1352,798,39.62011051560286,9965
dbb9ecb2-1e51-4e42-b0a8-2628dd97b597,Healthcare,0.0420214515619054,13,2,80,1222,1142,19.244105971656438,2667
ec03bf4c-aa0d-4acb-a4c6-b2953f1f9567,Residental,0.8945349150579166,49,23,27,1413,1386,44.35174512721629,2020
651da67c-7e19-424b-9c52-a259d0d8bf8a,Educational,0.5136003038506666,1,45,178,265,87,15.203073667565251,9583
56518cb7-3e48-474b-9b2b-ba1751f2529c,Commercial,0.8412411160275902,13,34,52,704,652,71.66104060335363,4643
fb28f967-3826-48a7-a7ac-cf040488688c,Healthcare,0.7377718266439066,15,15,285,913,628,78.3129536199922,4469
ababd0ce-d37e-4786-b63c-e2216c436e04,Healthcare,0.10851196865519774,40,29,114,165,51,68.27980232305866,7052
6086b160-4cfa-4833-ba8b-b4278645d674,Educational,0.23300283800084443,33,28,129,1287,1158,88.35854527664168,6710
a4daec60-67ff-4a29-b6ca-4398fc8b86b9,Residental,0.6094504219181944,29,28,164,1038,874,36.999042040080305,2309
873a5dbf-b107-48d4-a2e3-1e01dd4b668d,Healthcare,0.4044691208797052,7,30,197,344,147,14.08071327300407,7123
fec16b56-f5de-46d6-8963-a96ad10b9267,Educational,0.9401530481661446,42,11,84,1060,976,97.5617673214397,1935
74fcea22-a980-4c48-af57-68232823f766,Residental,0.6264569983550352,45,11,631,1079,448,41.58914000145555,8406
a95791f3-32e1-4b03-b187-a61ffe1bfc6e,Educational,0.40428718924979323,3,18,144,410,266,39.85350409550526,3462
65f5a14e-df23-4938-8ccf-bf5fe979ec07,Residental,0.33294037755625683,5,2,300,1287,987,11.465879914841864,6358
bfddad1a-4eb4-4531-b128-9fa998dc57ee,Educational,0.5864926968554922,16,13,507,773,266,27.287142674976273,2429
b6d1ca8b-b0a6-4277-bcce-035f2c7c3afc,Educational,0.806893602904812,10,20,163,335,172,18.731384676455754,4617
196d7121-a243-4da6-b787-81e1753be73d,Residental,0.2613644197939051,13,37,566,1239,673,70.32324534204386,4602
6b9f5d4a-8599-4a74-812a-414d0edc998b,Commercial,0.45541966123842736,20,21,491,1367,876,76.17503878799106,6657
d1b41670-25ea-4d61-ad4e-7629fe4a995f,Healthcare,0.9012758159085852,24,37,468,537,69,13.36376074699345,6841
a8b16821-ff45-492a-9f28-a513170856f2,Residental,0.21473484558670308,6,5,326,687,361,24.82551490629691,9009
f68e5ae7-2458-4351-b3a5-4e272b1592fe,Educational,0.7680340978128247,12,34,224,1416,1192,57.677443102837024,2406
c346e03a-5b24-4233-b76c-46660be9295c,Commercial,0.17074972568046454,26,8,112,134,22,61.95038129982273,9229
a994b84e-457e-4f03-acd7-78403d157965,Educational,0.5480570537749906,9,19,478,1158,680,24.85422052655117,3871
e5b043b0-43a3-44e2-9c92-285cea8028f7,Educational,0.7120488295404374,17,12,271,707,436,26.120670512558377,6502
8094d6f6-5468-493e-8a41-5c882a80c660,Commercial,0.36453363015238527,9,42,658,949,291,68.89880597908552,9557
cb31350d-848e-407f-b89e-8a55c330e183,Residental,0.014180413514694346,44,35,246,906,660,87.93726866532464,4840
cb1d9d09-d909-4451-aa5e-eb2b7ca01a60,Commercial,0.5538215318617906,8,33,64,107,43,24.310878326388263,5678
ccbd11c6-2ddc-4b31-85ba-2efb77aac6b8,Educational,0.06539722467357134,45,1,397,727,330,99.55075381321947,7412
8d0aef72-e05e-4629-bc88-133ff72cc8f6,Commercial,0.24793180088792677,25,13,143,837,694,60.6132299512403,8813
f64a176b-8387-469c-a520-7e48b290c917,Healthcare,0.4130539246589059,20,11,145,501,356,92.87312811800756,6954
5daf8cbd-e85d-423d-b0d9-9eaca01b111b,Healthcare,0.8863173067441552,4,19,379,1075,696,33.726909586815545,8452
06d014ee-c8de-406e-8586-1476e4d8cecc,Residental,0.9910219440207392,23,19,273,748,475,25.547670720321147,7582
a04f5556-9b16-40a5-b143-bc9edb68b9a5,Healthcare,0.49510751531374053,33,17,331,380,49,63.29877796573346,8648
37229dec-9836-4f44-a92e-d6fd733c4a2d,Healthcare,0.30537064581316187,21,49,407,1210,803,21.529857581312335,2798
fa33b0e3-641e-4bef-9cd6-ddf423dd3db4,Healthcare,0.27443670281059895,25,5,563,1224,661,73.3774272049748,4897
d299077a-4939-490b-b8e7-a94fe10ac884,Educational,0.11433540225595762,2,3,296,1207,911,98.50850803765447,1031
91d99dca-66fe-4678-a226-56b0c74338ca,Commercial,0.2573075830702527,42,24,461,669,208,33.19125983208603,5995
5df2a3ad-f00c-47b1-8842-ad6488336c5d,Residental,0.8872408505941668,3,2,131,471,340,29.589933001477313,6177
16547830-e65b-4e09-b16c-31a110383c44,Residental,0.2922049791173045,23,28,618,729,111,18.398291929625735,5989
f7ef6b0b-e6ba-432e-9c94-113d61d50786,Educational,0.9426086457124115,25,17,629,992,363,40.066474697496176,9018
d6a334c7-ac0c-41ac-a445-674ff6a90de3,Educational,0.7671994424339531,8,2,147,346,199,22.728597622791405,8930
1753325c-67fa-4701-adfa-473ae576cb9f,Healthcare,0.21964502824887788,50,39,675,818,143,42.40596259552853,2746
215a0818-b1ee-44f6-b7cc-e67bf34679f0,Commercial,0.1828390516554239,11,41,574,939,365,55.15340244484917,1381
612e50c1-f849-4206-ae7d-513795960528,Healthcare,0.8999553014068581,34,15,519,831,312,58.912808091397444,7894
a5106171-20c5-43ea-9a10-67a762f41b42,Commercial,0.7504306390995488,48,46,143,945,802,28.09665847093909,7973
9d70946e-3772-46a3-b454-df3e85b79035,Commercial,0.384253594357446,18,36,510,1017,507,32.0876589505048,2567
3eeb9f10-ca08-47d0-ace1-5a11ca70d19f,Healthcare,0.914654391972877,4,11,513,1123,610,62.952841962516715,2975
d97a53e4-e1b5-4c4f-b7ea-bc40c95488dc,Healthcare,0.33084549649052863,22,44,89,431,342,60.85900791958075,2049
d3b8ce18-db13-4d9f-8b69-f64b73651c11,Commercial,0.16104994287765828,18,6,248,339,91,65.63499107134209,7041
66dfa417-5622-4ac1-8987-ea70db462f48,Commercial,0.6300917135524654,5,28,568,1363,795,38.46085429356948,6661
f66c7136-9981-47d3-ab55-c1080aa0c2cd,Residental,0.4128321320697811,9,12,650,783,133,10.343709027057425,9820
577ad70b-fca3-4108-99af-909d5fa6a576,Educational,0.6207812687825758,4,27,587,1074,487,43.575388751275916,6772
f57f3d8d-1224-41f8-b618-7a8a0442416d,Healthcare,0.1291802218123118,19,1,28,569,541,89.55700209523482,6331
9d56e181-f10c-4e60-a917-8280d8506005,Healthcare,0.25673300751558514,21,43,262,618,356,56.264649761770336,4334
f1addd15-1ee7-46eb-b205-a39f00148b73,Residental,0.95141284620292,24,44,366,976,610,61.57379128723794,3330
c70e8c1f-fcc1-4fea-bf26-db28a07c1e65,Commercial,0.5263014924456634,27,44,458,602,144,57.85959676586761,1636
6c04e618-42a8-4bd7-9c2b-8d7765eb118d,Healthcare,0.10902230341983687,27,13,717,1105,388,89.75467978532295,3870
9f3e967a-a2b7-4c3f-ab24-100742bdbf21,Healthcare,0.17967676954878886,49,7,449,831,382,94.59346167716475,8854
13ee27b2-6cfd-4e74-8e93-3bdb9267fd48,Residental,0.2207338352000291,14,25,708,1112,404,55.65346815477385,2563
45b27c5c-d107-416b-bf9e-7128ab380dc7,Healthcare,0.8397345748805831,27,37,25,1148,1123,78.98816978302449,7224
406f1762-aa77-45f8-ad46-e30e0d6d73c8,Residental,0.20284914993362146,34,29,45,434,389,35.487584340612386,1043
28a3bbf7-5a02-4c39-8cc8-e47dc86b14ad,Residental,0.8651433341210449,24,21,437,909,472,55.06073282328226,3898
1bedf3de-3a14-48b4-8c5e-d55d6dfd2c37,Residental,0.5528513634279263,9,17,81,356,275,44.25357395080054,8990
b18d3a20-02fb-4243-a07d-94b438735f4f,Residental,0.3574824783816407,28,27,352,557,205,79.65931210115698,4434
e95ec955-aede-48b4-9f63-6a287d7f8267,Healthcare,0.5380623231600786,39,18,198,893,695,14.294658278407727,7989
54ab8f1b-7c8e-4ca8-a006-532b3ee29206,Commercial,0.24554629709854292,11,3,96,672,576,19.572660466292835,6063
67a250b1-8e82-4f10-8fa9-5509b542cb61,Educational,0.16079936082484692,36,27,385,1076,691,13.496664204298074,1875
3c401bda-8da5-4729-90d1-8744333505bb,Healthcare,0.42506018033841864,35,35,707,770,63,76.23201739866803,4189
741a429a-3751-491a-97db-6ea8523f8b0a,Healthcare,0.5334261278986061,27,9,44,530,486,49.019354359418934,8364
625ebb64-d139-424c-8278-af30123c9bc8,Commercial,0.9599944112291131,35,39,435,1266,831,88.59729769370892,6707
19803c18-9dd7-4e2e-8cc9-c88e21b53a08,Healthcare,0.8390758560568726,44,4,542,611,69,36.692342362565554,8838
f65fe225-4fff-4f36-91c3-d68113a407b7,Healthcare,0.454597390703777,40,43,171,1353,1182,69.20946065535469,3495
358f8bae-01b2-498d-b248-b3a7ee64cb32,Commercial,0.985114831336755,42,23,338,703,365,68.72388576918091,4483
33438207-3f36-46e0-ad94-fa14c961eb58,Educational,0.996878524344183,47,50,606,1256,650,46.80216951888558,4621
3e06654e-713b-4a34-a56d-730611a306e2,Educational,0.6928539116993113,7,33,554,1438,884,90.33025962320208,6499
54a334ba-8500-4932-9c3f-ec351565697f,Healthcare,0.1001233514806883,22,50,503,868,365,88.93612250554231,4671
448a1492-9190-4a62-acdc-8181d3bdc2a3,Residental,0.10378503465895506,1,50,183,830,647,94.88887384182112,9228
f4ba67db-be99-48c2-b89a-b7f84b20589d,Educational,0.6524460597306003,6,36,377,1260,883,52.16353144488137,6444
69cdd6a2-31c6-4a9c-9e46-d3505e010042,Residental,0.76574420653713,43,28,528,1221,693,41.553046509289885,9004
9c9ba312-dd82-4420-9f4e-97da4247cff2,Commercial,0.2128755438261155,48,27,17,644,627,31.816783228661045,2708
f0262ba9-e0bf-476a-80fe-d54195dfd491,Commercial,0.7487880158592158,32,50,576,1297,721,53.16712246371473,6138
c60de550-79e7-40b3-ba71-3e518bbb9b32,Residental,0.21575302963345167,1,32,531,851,320,83.42666996661337,8741
21946b0d-44f9-497c-b001-4a6046281059,Commercial,0.7105743328968205,11,12,408,893,485,24.847936613323412,7635
f819dd72-768b-454f-8af6-72b2ef5e7c6b,Educational,0.4042713788973845,47,49,624,638,14,40.354682470150536,2187
ba177876-cfc2-419f-8b28-9b3b7b7b374f,Educational,0.6720795608258171,13,40,348,720,372,74.95370319022666,7050
3b8ff498-85e2-47c8-aa1f-2395561390a6,Healthcare,0.7336437551161955,8,2,508,775,267,66.05687696827586,4455
c22ef6ac-d1c0-495c-ba74-e333db9d3876,Residental,0.018849833810901218,14,4,642,1237,595,19.11139778174175,1103
159ffb72-4e3f-44ad-a05b-27083ffcccfa,Healthcare,0.22062124674979489,8,48,492,1419,927,31.694423052507222,3828
efcaea1b-f0db-4c22-864b-f51ae28fa081,Educational,0.44204136109096803,21,4,518,633,115,54.06265972214253,5571
17e2baf3-adb8-4750-b724-29f6f4dd3108,Educational,0.033587869748477495,30,2,397,619,222,57.57610119552508,8423
07da43b2-4f84-4c14-8eaf-0d373e58c4cf,Educational,0.11666318659198471,12,11,225,1111,886,75.3991642402664,3754
c864844c-a27e-43f1-b354-c05d95c76246,Healthcare,0.9059919409461491,18,18,580,1371,791,81.34087201611948,3481
d685f0be-c1b3-47a7-89fe-19e2d73e5401,Educational,0.19074817435074676,20,49,622,881,259,81.70771261219541,3061
51a0b4c2-509d-4578-8059-174e1f706bd5,Healthcare,0.6212020722852294,31,15,344,661,317,83.66769714886401,3414
c3078a1a-8d81-469b-ac0d-5e2c500e6f48,Healthcare,0.6674239849248392,41,12,352,953,601,68.03057469693698,7518
db65bd4e-a61b-4518-8072-94a69b482c6b,Educational,0.7821406102881937,6,31,240,572,332,26.85339301353778,4662
881154d9-935a-4375-ac7a-c2b2cd3cf972,Residental,0.7198996368062169,14,21,264,1051,787,90.81335656192756,8878
2964cc8d-f955-413b-9377-abf4775fa6ae,Commercial,0.5582983391736863,21,29,345,730,385,41.46016223676109,8167
d7b84df9-3f9a-4c78-9790-7208b3b106e9,Healthcare,0.7634092203862906,50,41,486,602,116,38.764090310181594,8941
672b81ff-6911-4ae1-ba54-4a625d0c4a1b,Commercial,0.14538253436718107,39,46,244,733,489,38.31102383820732,9422
6def1347-3898-4ab6-9719-101120befe10,Healthcare,0.2857862619334741,50,12,111,1176,1065,80.46213623193148,5360
8a415e37-f54d-4207-a0a1-719efa430ee1,Educational,0.6091788507727048,43,13,184,1301,1117,26.920692927503072,8622
c51b501d-ddd0-48e9-83ba-8ead2ef5a283,Educational,0.4361375062698275,35,14,348,1326,978,77.45271309662287,6607
dfb416e3-04a4-424b-bcbb-7eaae9070552,Healthcare,0.640256715049002,48,7,59,1115,1056,58.4965644117488,3730
b488a13b-8b9d-4275-abb0-fb91cf6ffcd4,Educational,0.9261730934594008,16,36,194,1432,1238,21.188214585260884,4748
237e7f0a-4a25-45e0-90eb-07cc4fdbee45,Healthcare,0.7648312612191569,19,19,437,665,228,32.099127274028326,6748
94c566ce-b3f3-4d8a-8809-08a53f87c88d,Residental,0.6200284439508565,38,38,31,1021,990,69.00535867067421,3317
1b95e7d9-ddb1-46dc-819b-46c090851d7c,Healthcare,0.9801222200594647,47,31,129,897,768,13.683038074489719,3528
a420b197-3713-42ee-b2f1-9265b0b73768,Healthcare,0.3210914971417477,44,9,374,700,326,16.464479433770496,3977
a24d093b-ea4b-4859-813b-7080c0f9cbdb,Commercial,0.5349620033352995,42,8,571,829,258,22.203278798108705,8263
e561ed14-8ef6-4130-af58-0d5910d03589,Educational,0.27648453486251623,7,8,81,691,610,73.37270257202002,5890
8df35387-9d03-487f-8b2a-31a8d2e2d69f,Healthcare,0.9958040787279769,28,5,425,1048,623,58.131207817587786,4706
cc7057d3-41b5-40ad-bea9-166ac11ad9b4,Residental,0.5739437585732922,49,7,547,976,429,35.54406251587014,9484
760d516a-6db0-4092-bc08-e6f5b246333d,Commercial,0.8468845098873174,24,35,26,313,287,28.68295768285019,6924
195cc6eb-900e-4ca7-86b2-453bd79a5eed,Healthcare,0.4798318896825048,41,31,658,1338,680,24.216480447554687,6216
d6f186fb-32c9-479b-85ab-2fc585116f08,Educational,0.6552309694154134,9,2,645,1153,508,23.203153791638908,6824
e8a09da3-56fd-4f88-9ee7-a38cbbdedf48,Commercial,0.8916020372112687,8,4,223,1161,938,47.839816220462815,3737
1cc08251-4ac9-43c7-a29f-47d1a5b60059,Educational,0.1574075628269267,20,34,503,1019,516,96.51795648356469,7801
3f13db0a-f058-4a6a-ba0a-094a20a51233,Healthcare,0.4833398936162132,18,13,146,972,826,70.89162379159978,5855
51989e8f-3b9a-4f9a-a9c0-78de95ff8dfa,Residental,0.47642254806428175,35,44,141,205,64,49.315098889136046,9921
c7816a3e-3cbf-499f-b879-6fa572464aab,Educational,0.6892053042777677,25,27,485,970,485,61.83504317987589,5544
746b0825-eabf-4d55-a665-bebc8f17404d,Residental,0.054181568072469655,28,38,649,1302,653,36.694437005018415,5600
fe4ef316-3a40-4abe-8360-bd0cd64502f1,Residental,0.5223251232955377,11,23,244,1372,1128,56.39974517400867,7425
550420da-6c4d-454f-b3d5-fe333a4df28f,Educational,0.13396189965019023,13,13,357,885,528,72.56812791525397,4717
97311d08-94eb-4a57-b91f-ac5552b8f643,Residental,0.2148033229241364,41,49,161,1381,1220,18.406664136707114,5132
eaa8ce83-cd86-4ffa-bc01-7983d2394686,Commercial,0.1552907556799531,45,43,157,357,200,69.22096216533285,3933
93d78275-ca15-4bde-ab1c-c93bc2141323,Educational,0.2775924818604716,18,9,677,936,259,55.64664964008809,7629
fe014faf-d394-46f5-9a1f-849d7c98cef8,Healthcare,0.45362799588650227,32,38,538,925,387,49.16728366620496,1568
1c01b8a3-3ef9-444e-92ba-522c8578b043,Healthcare,0.295763679981877,33,11,137,821,684,15.70202949652159,4464
bc7b2fa4-5324-4ffc-9957-0c968a2f4396,Educational,0.4025315904273582,13,7,215,1392,1177,75.06744822998998,8200
f382d623-3722-4146-9f4f-b42acd07adaf,Educational,0.159251308702147,33,26,225,285,60,28.77926928141831,9165
d3c2a3e8-2742-49df-a23d-0eab517d6fc3,Healthcare,0.6271188576051926,47,17,67,660,593,83.1196574202193,5376
e2b78293-e7ea-4c14-80a9-0410d5a1e2bc,Educational,0.12648124348025302,41,48,610,703,93,56.19520286948822,6808
634cd6d8-0062-429a-9608-505285cfe5b0,Commercial,0.8897916675893444,31,4,219,745,526,60.957667270790346,6145
4bfcddac-35bd-49f4-9772-c4da58fa41a7,Healthcare,0.42576587092063367,48,41,331,700,369,26.812307842405364,5873
654e8f78-e38b-48eb-bcbf-129cd56061dc,Educational,0.7942810404007026,37,30,528,757,229,66.28646911243135,4624
ea82f31f-6658-44da-9d71-d730063b248f,Healthcare,0.556974521002714,44,29,406,747,341,48.15879211207051,8371
03e29445-acff-47c3-bb5a-e6288da9d3b2,Commercial,0.6375477065596485,49,49,255,336,81,21.3379256473416,3512
1c567e83-d796-4843-ac06-efad19919cf5,Educational,0.9705614372737312,18,18,261,759,498,85.04067442439327,9888
0b072827-06d0-4d8a-9750-249335e0fb82,Residental,0.8518953030684174,7,27,580,815,235,95.53134656316108,8644
95d4c59f-d023-4e3a-9a27-c81d781dddf9,Healthcare,0.8801447179922292,21,26,274,754,480,38.53868772327229,1115
fa49c121-e007-48fb-9058-f97db306a5cd,Educational,0.947802802644075,26,4,144,1271,1127,22.010373343210787,9554
51c12254-c019-4ccd-a2f8-2d55ff6c0f76,Healthcare,0.6291439114951013,34,18,692,1229,537,40.48927277939431,3525
0321c26c-bd65-4a4c-906c-7caf7ad0039b,Residental,0.9880619632483789,36,30,182,380,198,84.15714402206254,3642
06f31895-6b44-4a1b-bce6-8e536845d653,Healthcare,0.46047913930226236,7,12,720,858,138,47.0167557399813,4585
bbe1fbec-3465-4ac5-8d8b-d57d0890549c,Educational,0.06213451611601872,15,39,254,328,74,26.719300858620255,2768
80812c59-6e6f-40cc-a494-fd08341c48dd,Residental,0.4513514921161813,25,23,274,422,148,37.59593012888282,8474
82ee46e8-3c5a-42da-bdea-07b4b7b787a0,Residental,0.09254015444716923,13,36,154,623,469,71.98880332782663,1158
9dd7f4ee-29f7-4947-a030-1a0b10770505,Healthcare,0.8417222128322788,16,39,376,1055,679,16.815895639156352,6163
961bd400-eff0-4638-8d9d-dd14d1aed974,Educational,0.7924561176755544,21,39,149,1158,1009,59.16035400128911,5100
0bd46f66-0ac0-45f3-bd9f-cf3936fad408,Commercial,0.8104477236036929,28,3,345,445,100,82.39711853672748,7342
630e1eb5-faf5-4694-8022-1db4f1e755f0,Residental,0.46094520019948293,29,38,253,760,507,66.49350615673302,2660
44885a80-a39f-4bc5-a79f-d171f88b07f9,Residental,0.599142650163221,36,17,700,1254,554,68.26934179034888,7586
e945aea1-56b7-498c-a31c-29fd77e129bb,Residental,0.6893557317206771,26,35,501,1309,808,43.83145928972567,9592
8e2d218b-fbac-43c7-9a71-41ac4b9bf85a,Educational,0.6238486619078761,34,43,716,853,137,25.048470942514246,2514
39652a60-f121-4854-b98b-3831b2d888c0,Healthcare,0.320321543262847,23,36,67,1422,1355,48.07002307140696,3422
d35a8fdd-a03f-4353-9ee9-7b6968e85daa,Healthcare,0.7749127713587154,35,17,596,1021,425,86.85427486547972,8466
06a2a5ca-078e-442b-b906-d980d1338253,Commercial,0.13002683229858103,6,2,477,534,57,67.6072342494315,4734
5d476d1d-f1ec-4028-9bb8-9a01a21b6f37,Healthcare,0.20187513736598428,46,7,329,1264,935,43.89301054765812,3108
c030fef7-9301-4043-8f88-650c2ed8a0e8,Residental,0.6820758422419951,17,12,568,1405,837,42.44559928140104,8158
1b7a30da-2161-4401-93bd-65fdc953a923,Residental,0.6720007312690988,36,15,711,1149,438,56.76956943324658,9091
c6f58b34-37e7-4871-b484-a03ebe4d1301,Healthcare,0.05652918809174656,50,38,570,585,15,19.422641396576307,7692
8dc94eca-3099-4694-8a57-5512aa2a702a,Healthcare,0.06379995146958095,5,23,464,1067,603,71.17565826276385,7762
df815bae-c28b-48e5-be55-99011019f0bf,Educational,0.787040323945608,38,43,403,1111,708,91.10995553530195,9967
a5967d1c-5244-47dc-ab85-b3937f6562b1,Residental,0.6003223194855135,3,31,329,889,560,62.1011424598822,6690
66e0a7f8-ba8d-426f-8e44-889c24ea1b59,Commercial,0.6427472872669765,41,12,377,627,250,29.561281129854706,7170
16e0ee5f-6b85-40ae-bcea-c2a4b6282a30,Commercial,0.34044414444636484,13,43,246,274,28,42.21518878426758,8619
ab7f1ed3-b762-414c-9b17-271dfd77c38b,Healthcare,0.5557397095670614,44,13,635,1264,629,13.431582903439253,5228
2d6310f6-dedc-47f9-b3a5-8458d0f99469,Commercial,0.5029304154752446,29,28,162,999,837,69.47565686541981,3612
f480f48e-7dfe-41b9-8159-78d86498511f,Educational,0.17900524147124186,48,2,404,1195,791,20.99167313195258,4943
8e548267-d057-4e49-8a6e-c02234b1c4bb,Healthcare,0.702003283542085,32,23,438,953,515,23.895530899384617,3659
263f141c-985e-4efe-80ad-33062a083e76,Healthcare,0.8082288594361142,33,1,144,640,496,28.090914482436123,3977
eeeb406c-2fed-44e2-b4cb-f77d013a8918,Healthcare,0.7652047097669076,7,34,290,675,385,30.528684779857198,7797
3d41b7f0-6a34-4025-b68a-2a88e9596b5d,Healthcare,0.23296381227082785,27,46,184,270,86,82.64661049969214,8517
b2d20b63-a9f9-41d2-b6d6-9ba0a1edad41,Commercial,0.6920290956303412,14,5,460,1243,783,22.931174540060585,1957
245e6018-bf3c-46ea-bf22-cd59f4037945,Commercial,0.05916727555899248,36,11,100,852,752,55.408659568836335,7491
0531565a-c3b5-4afb-bd2d-f5bfd651c9e2,Healthcare,0.5185434927093602,5,40,668,935,267,69.1161403643697,8390
4915e8f0-9e96-4563-946f-9597571e7a88,Educational,0.09098411706532339,9,18,512,561,49,84.6994991637309,3371
3924b631-769a-4361-9529-5512dfa4ab3e,Healthcare,0.4171240135511788,44,15,509,1002,493,47.72127585368353,1352
457e46e9-419c-4edb-889a-796290562717,Healthcare,0.3405926886787852,19,16,215,960,745,74.08742554376644,5576
6d03ad22-5952-4c41-b417-82d714062850,Educational,0.7495415849375383,39,7,601,630,29,81.3473815071924,9884
a8a07b7b-6968-4b8a-8c3f-c666e1a93e44,Residental,0.4675440722953941,28,50,663,769,106,29.62750053992741,8480
96b63a08-1596-4a7f-bbad-f6dcf623397f,Commercial,0.24815488103661298,2,8,391,615,224,35.13585044724892,7612
02c4c896-353a-4f4e-a711-b168a0dbaca9,Educational,0.2612390817182694,35,29,455,891,436,68.25669571186498,9761
80148355-fa4e-4c81-8e14-664ab7a4f643,Commercial,0.9844427068564866,1,12,360,479,119,19.996399046773995,9412
0c543ffa-e8e9-4d53-8eb3-20ff7f1a79ac,Healthcare,0.3932118560691962,49,31,60,1338,1278,36.23465276976788,2397
ad0383e6-1506-4a39-88a1-8f7e20b4048d,Educational,0.6573116639996024,22,7,587,1065,478,61.71042190482046,8890
2ffe5627-0a49-4152-bbc9-c49cb9974271,Educational,0.9875204278552268,31,30,132,976,844,50.026977178050885,8304
53bc1757-586f-42e6-a3f6-6d9a4d4dd23d,Residental,0.22104142764744716,1,29,184,530,346,91.99335240719509,2732
a799c73a-0c4d-44eb-a2c5-cbed3c544928,Residental,0.07155890624326677,20,13,131,642,511,97.34007501117226,7858
99829eeb-80db-4bde-b670-a66942758e6f,Commercial,0.16899627351765278,6,25,47,445,398,11.892604983401181,2087
16e69ec1-ef58-4df5-b274-3eeab60781c9,Commercial,0.3209290870776317,12,21,437,547,110,30.553152181224977,9720
3d8ced22-ae8a-456f-ab86-4db2e682a33f,Educational,0.3250730554473451,6,38,196,1132,936,31.089057574824757,1421
14a2abec-c654-4e71-a698-1543c21723a4,Educational,0.7902055318784206,19,49,399,771,372,57.54353119371202,3440
97ce7fef-c59f-43cd-8320-2cb432d568d6,Commercial,0.2693736196151658,29,37,177,686,509,71.13554466573004,6762
b3af71e7-a905-4aac-9d29-64f06a280123,Residental,0.417942063338662,41,15,421,1300,879,64.13228645699036,9464
489a1475-d657-4d24-99ee-cec86ac0f09d,Healthcare,0.5593514745497411,27,49,516,713,197,12.464372736857126,7256
d7fcf4f8-ccc4-47bf-9320-8b64afd0b265,Healthcare,0.42010514178401925,35,22,185,681,496,49.43383398872573,2954
30b4caf3-ff37-443f-8ec3-bbe514f89e8c,Residental,0.705026632246229,10,42,637,816,179,99.5394877824986,4579
956fe7df-209b-4092-b0e8-4a2c03f89264,Healthcare,0.41569081210563097,13,33,103,1292,1189,12.20096603858735,7400
8274e8d1-28fe-4ab9-8e33-cc8f804ed95e,Residental,0.4774431150739066,35,23,414,716,302,57.66367395763349,8124
65971c6c-a4bb-4df8-9d37-f5acdbdedc20,Commercial,0.6263536891199892,21,19,314,909,595,73.64311097589388,5218
7d54f39c-ddb7-42a3-87ad-e850005e177f,Educational,0.629216384586454,29,37,69,431,362,45.97451287067839,9823
766cf807-fed7-4957-a136-bbcb24dbc320,Healthcare,0.10738767885921874,22,7,76,316,240,56.5284189421557,6675
3a14cd5c-072f-4942-8312-99b308d16e33,Healthcare,0.8517738812376248,1,16,17,389,372,36.932443612778414,2888
25f01baa-bfa0-4433-b241-e5e2722f9831,Residental,0.3130989131276384,21,49,632,1124,492,44.954519250633204,1462
f62a6e39-cfcc-4d98-b8e9-8e3406b800d5,Educational,0.18117018465666523,6,25,474,1267,793,48.09244575865581,2503
4a8b80d0-6e78-4386-bf9e-647926de6f84,Residental,0.29518623845397063,34,12,419,503,84,97.27249258160927,9744
f4fa26c4-1379-4905-a3ea-71b37d0770e1,Residental,0.1971593676547837,6,20,61,355,294,19.48346937820288,2190
4318f819-3535-4ef8-8eab-202be33da4d3,Residental,0.3790504634906532,25,23,605,706,101,53.902095521830866,5470
970b3242-f282-4ee9-8a48-be9d5afe372b,Commercial,0.32755205519378283,37,43,475,786,311,64.41962751586514,5151
f1a7b331-97df-42c2-9734-4d76283d24ad,Healthcare,0.9798089777259056,20,40,145,1364,1219,99.1857804206005,9456
a7865b5c-29ee-4162-8cf9-6cc84851b700,Healthcare,0.24027670861645078,15,30,277,944,667,27.325356522683528,1469
6a4ee5fa-c431-4270-9461-020de2fd89da,Educational,0.9927171720724502,6,17,396,1238,842,92.2348476393043,6813
bc9ae446-2712-44de-ae7b-0bcd3ba6eb69,Commercial,0.6269050002901929,5,28,180,1327,1147,49.37036711206646,5149
e411b044-5900-4167-9f6d-15921cf5788c,Commercial,0.36661682986761623,48,34,291,578,287,11.97745436669629,5127
0ae3e743-2153-4839-a639-1783ea92979e,Residental,0.7802592989241929,8,17,275,655,380,98.04299162236174,6947
3fda3db7-124e-458c-90a6-c92b799dd8ec,Residental,0.8905402914866289,42,3,591,919,328,64.34644652247977,2646
5b8877ba-1369-4794-93aa-1b18d6b882f4,Residental,0.9053585160921717,42,31,500,991,491,37.59919877205839,1990
7954d26e-fbe0-404d-bf0b-08285462617f,Healthcare,0.762572292892859,33,38,105,1159,1054,39.21404962629283,2059
4ad32abd-052c-4610-a0f6-2d6f8eb784f8,Educational,0.11895776676763992,14,19,573,1205,632,41.70189573160802,4309
87a447f2-e6e2-478f-a029-928142123f4b,Residental,0.5632719816186451,19,12,676,921,245,77.82815249927435,8849
ef071129-9354-4185-93a0-91f5539cd76f,Commercial,0.009255368026813038,19,38,561,817,256,93.04676398461005,4188
f566548b-a283-486d-8195-826dee221974,Commercial,0.19686129956506493,47,43,346,1256,910,13.581605157394883,1752
20bf681c-6ab9-4302-a7b5-d836d6aca1b6,Educational,0.06330925342956917,33,13,340,1324,984,78.46885629649708,7073
354713dd-f18d-4922-bb15-4fb4de5859f3,Educational,0.7898574816934028,44,27,262,477,215,35.7472172489268,8995
0813c5fc-35d4-4115-9f76-61dcda4c67af,Residental,0.7781966200077626,20,43,527,972,445,68.25154111958682,9212
4d51f28b-783e-46fc-a371-8f7d0e328ba5,Commercial,0.1375812256587482,27,16,6,378,372,29.14552441025789,1111
5dd3b4ca-66b1-41e4-824a-ae8a03f75888,Commercial,0.6261097877655103,24,3,10,700,690,25.369936088109323,6816
27ac4e33-c430-49d3-b4f5-e2dd5f8aea32,Commercial,0.4947082769956648,41,23,400,855,455,73.48600038062352,2140
79429fe6-4671-4961-b171-24decbed79d0,Residental,0.820044261888786,4,23,391,1340,949,46.33773645159102,7345
18ef69bf-1d62-48ba-9202-606c2a32a6b3,Residental,0.040134457865701245,29,42,11,787,776,47.06735811517113,3244
c1372535-a596-4649-a259-5c68ff9273f0,Residental,0.08876466546890849,10,24,50,602,552,28.604888544749475,1317
54103fa5-7a3c-4680-a9b0-c9ccd9b34ab5,Educational,0.2586599063683699,30,30,518,1349,831,70.28641873735947,5933
6318b42f-aa8d-49bd-b906-b775f0b3fc43,Educational,0.9495994704850945,45,6,241,527,286,30.346492116368214,2975
3eb632ce-87f9-4860-9917-a610e10f583e,Healthcare,0.1510676413414097,9,38,603,783,180,50.15927515383391,6961
4f665152-468b-43fa-a033-f67ea658219e,Healthcare,0.4370689219524614,15,24,36,1302,1266,40.96955823740274,5113
25bff396-c5ca-48cb-ab5c-8615b6404e39,Residental,0.9371367588616107,23,13,185,464,279,85.70066361786289,6136
f29f7119-bdf8-4ae9-9dee-e45c24dd6af1,Residental,0.6899694296663866,12,38,110,950,840,35.00825404433666,8259
360d9234-7be6-4a2c-bff1-1e10c7e4064a,Residental,0.5383063084734031,37,46,198,222,24,94.66203714964173,3735
b3668a57-2f1d-47a7-a00b-1495b517df05,Residental,0.9266532416234293,46,17,369,1196,827,33.510159179070385,8537
f2e83924-d701-42fa-aa04-ff3eafee48e3,Educational,0.33062307492908616,39,16,73,515,442,97.47455634171459,4910
a438d5e3-e059-4cf6-a294-9059ca623229,Healthcare,0.6647862793774191,35,36,677,1065,388,34.19020280469255,5296
8978f2e4-79b1-4e8c-9e1e-37f98e2d33b6,Healthcare,0.3604342791964019,33,50,597,1220,623,34.47865677053248,6203
77c200a5-98c1-469b-9195-d52e56461b1a,Commercial,0.6596515630941359,29,1,339,717,378,68.43585289470481,6142
3d5bb63d-c6cc-4aad-859c-2af91bdc5e25,Educational,0.03344099915666543,41,19,587,959,372,78.29553716692013,5526
3b3d57aa-5aee-446d-9893-52537412a453,Educational,0.827025916820843,45,23,437,1191,754,15.206487128820704,8903
d792ae98-88fa-4eb7-a82b-455c775d9b02,Healthcare,0.9444756283482006,7,17,467,1372,905,88.48789806527071,8655
74605eb4-22d1-4754-a9ca-42392f16f3fd,Educational,0.8828897551987033,44,38,530,1075,545,53.211209903495885,1807
93395fc2-c816-45eb-a72b-581804dafd37,Healthcare,0.7982829314666872,42,41,267,1190,923,67.00885506176559,3946
2f066b2b-de6b-4b2e-8bb8-e93309e166e2,Residental,0.35173556898639036,2,20,44,119,75,74.96572022718891,4329
766fbad4-d7ad-4e85-83c2-2f3d81a0ba83,Healthcare,0.6021409280896377,29,39,57,1390,1333,15.737328943739161,3716
847cd881-0ba7-4832-a911-8b43ef738432,Commercial,0.018295748727067518,4,26,57,840,783,46.55938238634597,5780
864ee01d-26a1-4d84-908a-a470580ceecb,Commercial,0.16310493664746772,45,3,100,353,253,92.86014593287263,2645
d90d58ee-50c3-47a9-a0a4-f16f20452091,Educational,0.3288667176834461,16,46,135,1358,1223,58.61238703672622,8128
6df70260-1ab3-401e-9f0b-fc67d9c8bfa7,Residental,0.4784815640068486,33,25,91,1284,1193,17.036102880943385,7048
2874bc89-451b-4843-a60d-20ae6634fbd7,Educational,0.8278843010280889,5,11,57,343,286,95.19842863585865,6712
aff95439-2a8c-4d0f-b6b5-60d628ebb8e8,Commercial,0.009683766986841369,41,32,120,1092,972,24.252092342977438,1721
3ecce241-6333-4f90-b9d1-34883cf6e2cf,Educational,0.14652963273121766,26,32,420,1241,821,95.49833731450204,4185
c7556847-e791-4b17-8462-a5ab4a1f5b73,Residental,0.9780645688092185,14,42,242,511,269,21.706747481428046,1311
3afeaa95-ad69-43e3-a191-1821c7e6554b,Healthcare,0.3803925551723293,23,41,97,1209,1112,61.05817609706451,8169
ca656337-3870-44c9-86dc-e9506f05a311,Residental,0.4833195741044921,7,5,402,580,178,64.61015418196578,9259
0572023f-0be2-45ed-ad1c-0708462e031f,Residental,0.26988191343156276,10,23,521,905,384,28.724685383979804,3577
2ec68c7b-49e4-4f15-8cec-abd7e2970492,Commercial,0.07976489417544008,25,22,266,979,713,98.87953989551514,5230
a2d2c0b7-e975-4c34-8360-1abb26b26cb1,Educational,0.33792689930806963,21,7,493,791,298,82.34312429769135,1472
114c276f-d682-4e32-9728-3c560f7fcead,Commercial,0.8335428738805214,39,1,208,717,509,93.14730639903038,5234
e6929afc-cc3b-4a40-8b70-69d1675ef4c0,Residental,0.21274156013057255,44,35,406,417,11,91.77172490480186,7352
5392def6-1f63-462f-b912-d7658ca3196a,Healthcare,0.6177870666903786,3,4,666,775,109,80.66645472689302,3386
b3d56199-7470-49cf-8bb1-1c746ae0fdff,Residental,0.7898929701038826,16,5,71,764,693,55.146309189505146,6160
4970ae6c-47e8-4f38-b695-9c27803ea362,Healthcare,0.13113472083772848,49,28,145,1136,991,94.95210170690635,5099
1ce093b9-76d0-4328-873f-34a7087ab966,Educational,0.2806130852583618,44,24,559,774,215,36.346654328055266,5859
1359e0ec-fb82-4c33-b13c-9ff5a5226b8d,Commercial,0.5527142982812954,8,6,240,1275,1035,71.23790269871432,1848
edeb148f-5d06-4a4e-aeb8-3d539fadac34,Healthcare,0.26303239623097785,31,27,613,1416,803,14.477314208137852,2284
b813a263-075b-4e8a-885a-fc3dafaaf09c,Commercial,0.7236564157562928,35,29,9,827,818,11.42648815311517,6921
bba8802e-54f4-448a-b185-f51bacc76a79,Healthcare,0.6861821165145803,11,13,97,594,497,56.31295564800781,7091
5ff0a2f4-5493-441f-80d7-e6788aca315d,Commercial,0.6508680584881172,25,8,17,155,138,16.55066564135587,6069
f028edb7-40a0-422d-ae75-b091c05881f5,Commercial,0.3149850316118261,14,43,146,1046,900,77.22839206961324,7297
e7628859-339c-4870-9dbe-2c4735f9e27f,Commercial,0.30897137662211094,45,46,702,1282,580,95.19198288696839,1796
0b07a7ce-a12b-46e8-a567-f3c5725b46d3,Healthcare,0.9098110475062905,45,9,712,1018,306,77.53858847974251,9359
65bf40d3-2cd3-4dc0-88a5-280749ab7f82,Commercial,0.033240031203551346,1,39,701,1310,609,56.17116780733539,2408
c33c3a0a-aeb0-4801-9e51-cffd36a4502c,Residental,0.8311991377495097,11,28,326,578,252,97.77625786365934,8665
bc8d7a1f-3fa5-4131-b199-5752b7b3bb50,Commercial,0.21249667657610316,8,32,286,527,241,82.9484220964493,1301
60b2733c-0783-42d2-b489-14a0e2f0a6d9,Educational,0.5160798741000897,46,31,464,1191,727,91.62606566122268,1323
0c5d1685-444c-46f2-ae3a-ed477141294b,Commercial,0.4003865872486442,3,8,533,1017,484,62.858502305164045,3475
aefce355-3696-47d2-9cda-534bedc30113,Educational,0.0293380097296978,45,9,474,496,22,17.89207253622457,9747
d662231f-b27b-4363-ba6d-053f6e7a42a2,Healthcare,0.7333415466967621,17,13,527,946,419,81.62729775889517,5889
d0d923f0-5683-4647-827f-fcc49e9e34e1,Healthcare,0.7352238008851659,13,9,300,1395,1095,96.49775324184908,6912
507adcfa-50f6-41ac-8c74-ce025780c4df,Educational,0.7901829989665642,5,24,384,711,327,77.09076108664519,7293
b55e9903-dd13-422b-99e1-f602983a139a,Residental,0.07087400052713688,39,32,324,1245,921,88.95214016584417,2992
145c57e0-1d53-4b23-bae5-9b3701c4155c,Healthcare,0.3634093315372272,31,5,677,896,219,27.534147308445544,6495
b40e3a80-3e37-496b-9fe4-981b2ed970f2,Healthcare,0.9716551616752884,3,6,165,610,445,11.911910869308109,3395
bdda9ffe-4b28-4f26-b938-c764633950f3,Commercial,0.40891452410449736,12,28,458,653,195,70.6284347609104,5329
bc335bbf-b2ce-4a30-bb58-539f882fd992,Residental,0.3795200068846507,2,19,68,260,192,80.07777006166226,2882
667f050f-34b6-491c-9f10-add405de61e9,Residental,0.11280958246514006,19,24,196,986,790,78.00044144358638,1769
ae27461a-c97c-4f12-bf66-b176c0cc66f9,Commercial,0.565285056207608,25,20,249,707,458,66.25914735477865,7492
fad5660c-50dc-481f-81be-d39a83fa5214,Commercial,0.4261408267497693,21,2,17,1021,1004,10.05315883339877,2937
f761bde1-0837-4c93-8a1e-4ee9071582e0,Healthcare,0.0818883307638586,35,22,168,197,29,26.908066130580227,9813
5a956de7-6e1f-4205-97f1-d5a891f4d5b6,Commercial,0.2590178711254353,33,37,650,1337,687,44.10742397855426,3212
8eb714e6-5460-4f9e-9dcf-31b38bbb9679,Residental,0.362298494189773,40,33,5,480,475,74.64966674303673,3678
1cb942ee-65de-4732-967b-aa20c16bf39d,Residental,0.39178945180105085,37,39,529,1092,563,16.738984993947042,4002
8769ab4e-138a-49bb-b6ee-116e137fb392,Educational,0.8007910836100025,21,18,358,1412,1054,33.03073226033071,6482
66f57cf7-d588-4aab-ab38-925dee52bd97,Educational,0.6802940442507345,41,29,124,1098,974,24.821189485084467,1527
9f0efea4-f4e5-44e0-97e5-140687c1957a,Commercial,0.21345909829980714,13,12,222,1361,1139,76.37473525977131,7510
d704e57f-ebac-4706-ba34-6a033d59c068,Healthcare,0.08118918105680617,20,21,624,850,226,20.065615558096084,5994
5459b339-3daa-44dd-a4eb-7d541c5e1e67,Educational,0.7213374219845348,48,43,694,1308,614,17.957523553836424,4254
63d9780f-4eee-4a3b-b00a-5b87ca6963f1,Residental,0.7212265306288375,35,22,316,925,609,29.211933791905537,6620
fb253194-ca29-4a00-99ef-b050a834a965,Commercial,0.08093577678503705,22,44,326,495,169,87.29858805855405,9446
429dae48-bf6d-492d-92a5-6f22ce3de5fd,Residental,0.08990686076164545,3,38,427,1416,989,60.31027842008307,1225
8288d813-30b0-4dbd-9540-d4623b845f34,Commercial,0.021924487095148715,15,30,569,990,421,76.23000515335386,1759
c758faf5-299a-46cd-81f0-9b38c89c4506,Residental,0.14576921880835136,2,33,501,917,416,95.57219454212232,3474
16020197-8734-4597-8366-f6ce583b2853,Commercial,0.9103222445855726,33,15,136,704,568,99.79758920666684,2681
489c88d7-2622-4184-8ed0-be51e95b12bf,Residental,0.9962965667426009,43,39,482,970,488,30.05516309052944,1060
8b8f9a16-e726-4a61-9275-11040b155cbe,Commercial,0.6716540089367918,24,13,47,1208,1161,39.82555905237538,9623
5188bf17-fabb-4e85-a415-fe5b5c8a25ef,Healthcare,0.16603603752709728,26,1,90,1053,963,11.182986025769893,4083
fd115caf-e962-4e44-8c0c-06248052d6b3,Educational,0.6962035819387852,17,36,330,404,74,48.843105918069284,3422
a8ff31f0-8592-4905-808a-5473e5698bee,Commercial,0.9223369613238825,42,5,32,823,791,37.278240235562734,9212
e51b59f4-4cc8-42e6-88b9-dc15b3624725,Commercial,0.5088041713290975,41,42,134,1191,1057,81.45325784807953,1231
0368ed42-7674-4787-8bcf-fa711800586a,Residental,0.08313489875070879,39,27,407,1091,684,37.129649023865184,3657
f1dab02c-4f8e-4c4f-b452-4cbb85c585a3,Educational,0.5262544539800104,41,46,302,657,355,36.89547983582597,6254
9b3843e0-43c6-48a6-a464-c58095b1c669,Healthcare,0.05043209658057346,46,4,194,550,356,91.39650332301986,1975
0a862911-94cf-4763-ad1a-cc7f89b882bf,Educational,0.2651395428795186,3,25,76,1160,1084,53.683744026616615,2493
308bcb93-f16d-48b0-9779-20296ff2a94d,Commercial,0.686775078631251,26,24,684,1056,372,63.86181403742019,8227
325b9981-2fe6-4f75-a467-e5fbd5cbd335,Commercial,0.40602964183519874,22,15,594,769,175,70.09617292014937,3981
6a48cd76-31cc-426d-a831-35f009aa8519,Healthcare,0.9098158697927905,3,50,123,734,611,40.09520980236038,3407
74efb703-45b7-4a86-8dd9-0d6bb5efa17a,Commercial,0.024961374314538265,40,41,165,990,825,83.16785030173202,6556
752fb936-5ee8-42d5-9e9a-52648276f24b,Commercial,0.249788427198816,49,30,552,1027,475,88.87387341569386,1303
5add4730-9a79-47eb-9c0e-5141df962017,Healthcare,0.4818751122452163,15,13,163,307,144,83.15292830425582,7024
5f92efd4-5995-45c3-818d-3d9da1d0242b,Educational,0.3003827258806536,40,46,188,574,386,62.16731629082551,7124
c36f3b14-917a-46ac-a78c-a857d450d8ae,Commercial,0.9961795079381246,22,11,490,689,199,73.15013531987597,4448
0326150d-70db-4921-a11a-65bd8388abb2,Residental,0.5436000987067455,14,38,18,243,225,50.79447288303467,5429
2a922dcd-7be9-41c3-879c-ba307a6449dd,Residental,0.9423488998285976,38,39,305,566,261,25.776336001899537,1680
58b760a7-bd6f-4cb8-aaaf-0f8a74333407,Healthcare,0.20990496928705515,3,46,372,1146,774,60.66440836015511,9785
54446ea0-1e81-4488-aad9-9cb242b88d63,Commercial,0.01352742374826943,23,22,163,716,553,61.96930182268428,1226
3f90e66f-5f39-40a6-ba8d-92c233675cc0,Commercial,0.16335027072454833,1,41,433,434,1,23.059378587022753,4929
5e254f13-9ea3-4c0f-b2d0-f2c3b8b7bef4,Educational,0.24231190671174196,17,22,21,356,335,51.70687344445029,9592
ba2139fd-bf2b-4858-a8e3-5f5a6897bf4b,Healthcare,0.7637645473917898,16,46,254,630,376,37.4991248451272,8816
e41e3899-2d35-4ac5-a362-c3fe1bd61a12,Commercial,0.3070362323600032,43,37,531,1410,879,15.72525622085285,7729
d322de19-caf3-43bd-9f86-77ee7a3d393e,Commercial,0.9561834212934862,34,10,293,328,35,98.76820227795562,8326
9d2c0e49-99cd-42ac-9930-d51be69416e3,Educational,0.617059361216949,25,45,393,984,591,37.3895590691705,4993
bcebdf93-fd78-4092-91fd-15221d1db3dd,Healthcare,0.6797460273354274,28,33,207,404,197,63.42777303505054,2927
1d740f10-fe8e-421b-ba84-2d05976d6d99,Commercial,0.7844625725595978,9,34,274,1389,1115,17.700345628563632,4259
2c6855a6-a414-4cd2-96b8-c93130b8ecde,Educational,0.7219149686404572,18,32,621,1027,406,57.12304006130494,6845
49ba694b-5be1-4f31-b4cf-b0f379a057b3,Commercial,0.4641380004598826,12,17,279,544,265,17.982728493517115,5065
4d3e9414-2e8c-4318-8c8c-e394324db133,Healthcare,0.6191895974421342,7,7,666,1089,423,94.16638829684226,2642
bd776989-5464-4132-b72f-dc729915f923,Residental,0.48664106853941347,6,24,88,667,579,71.7572749991082,1918
8c4a8b3d-0220-4129-8912-3fe535ffadf3,Educational,0.12292125691766131,47,15,308,981,673,92.3284202667269,1463
2949e9e8-0846-499e-a49f-5cd128da2af4,Commercial,0.6419517964618078,21,39,18,506,488,54.01403719634257,2583
daaa2fed-dde4-47fa-8f8a-8082900ceaf2,Commercial,0.3144713060263795,15,16,410,453,43,44.26865416278414,6793
03fb506c-29b1-4c67-92ab-dd96fb251e79,Residental,0.8290738201422688,17,2,441,1149,708,73.19221178630693,3376
9bcd75da-d7b0-41e0-8fca-4d8b31fb2f26,Residental,0.9927343990959379,15,34,449,774,325,73.69623980505668,3803
efcc6705-d5dc-46c7-8350-56eb83d78ca6,Educational,0.6413679225349378,46,8,704,1208,504,86.27201010470314,6159
a13d1f12-0280-4329-8228-c49465d20c08,Healthcare,0.6364390904060061,8,6,560,1019,459,65.46848890086609,4755
12d28fc0-b79f-4cec-8ddb-1e18529234a7,Healthcare,0.290805578963929,12,33,476,1069,593,50.089674211140476,2117
12fd495a-bf97-4f37-8143-e4f1f409480c,Educational,0.7265957612348024,32,16,132,515,383,94.1565231887727,8456
3c6fe4ca-bb19-4f23-9555-a5d7d797ca90,Educational,0.5758657012160859,50,4,356,1080,724,17.101463139556163,3514
12fff6e0-4419-41e4-842c-680b54ed4490,Educational,0.010830206428366518,29,24,714,1389,675,24.350953116980556,5733
6ba078cf-da79-4444-b6f1-131de17ea119,Educational,0.3261906737086384,16,22,180,605,425,74.3422130690631,6634
bb605abb-ced6-45d7-ab4a-34f6e2a87950,Commercial,0.908848832842295,20,37,52,635,583,84.00270440720313,3145
75752dcd-be0c-4716-8580-e09818b7c511,Residental,0.6303801386673893,22,41,297,580,283,83.48934424693805,2850
3e745006-0693-4081-85e9-e299cbc43e78,Healthcare,0.7464664629534515,2,14,530,1099,569,55.628286768383276,3639
d504f13e-b8e8-402b-8193-fd070394c095,Residental,0.8025354330615058,2,34,348,1053,705,54.51053486074997,4979
44852361-bf03-4fa6-86af-a0383f093e09,Healthcare,0.791718713229853,7,15,235,842,607,58.22148819471199,2021
1da37063-f2da-49fb-9f4b-c62951f7ffcf,Educational,0.11104651607267102,29,37,172,799,627,75.49723795698522,3471
4ca4442c-09fb-41ff-a6f6-23ad57032a50,Educational,0.10577832563087675,46,4,673,1362,689,16.973639774143912,4587
d2b7a7d1-4f05-463c-8e76-63931825e746,Educational,0.6569576855885486,47,49,684,1392,708,36.09303615314725,7039
5c6db41f-027e-44f5-a1ff-d9213ff9c0d4,Commercial,0.5311947882350946,44,28,585,1232,647,51.85836532640135,9530
6eb93bba-b663-42c2-931a-3a36dbc24566,Commercial,0.4595881396449384,47,46,143,603,460,23.035007013125764,9264
145b1c34-cfcd-4005-8332-a010f18f5779,Residental,0.32697110611608315,50,20,539,1383,844,94.95963312268042,3671
73e6503d-edde-4784-aadf-7d67d0e35e16,Healthcare,0.5882595678056325,15,16,573,722,149,10.031668429951932,8013
2fe5be5a-5d8e-471a-8eaa-d201cae8144f,Educational,0.5394486580666987,12,40,97,1420,1323,36.013618140054916,8830
8878584b-db1a-489d-9a8d-f5926f931182,Residental,0.07791680194569073,34,29,625,785,160,14.17954236161259,7925
7b00b4fe-d1b8-4e50-b868-62b176b77c4d,Educational,0.1400070926366106,13,34,237,1336,1099,19.454839113547692,6231
5ddbacf6-9312-4d07-bfd6-37298de5826d,Educational,0.0858720641900953,12,2,159,674,515,65.73331449658808,9664
7fd4ebc1-6e02-4e67-a473-41ba954c171f,Educational,0.17825170257731116,19,42,520,639,119,79.3596270278031,5072
d1f8cb04-3678-4963-9388-3faa5b9ae168,Residental,0.8235121562889862,35,25,675,1414,739,77.35742182544473,4569
0b077b3c-a6e4-42de-9884-48bd5b2a82c4,Educational,0.7496445202424535,11,41,512,868,356,49.43329487299667,4808
d091c47c-aa65-442f-b0a9-2eec9a202205,Residental,0.7232658290376908,23,15,691,1158,467,61.55173636163441,4577
1a8fc895-1ff9-4839-b853-d3bf4bc25f8c,Healthcare,0.5258865136384052,46,46,305,1427,1122,96.72496765051747,1282
dda26911-0836-4770-9728-aa62d0813454,Commercial,0.6450430391505243,36,23,677,920,243,96.97743290848902,6940
31082b56-afbc-4490-bbb2-b563e3631e6e,Healthcare,0.5685139719516513,31,46,316,448,132,19.89731140446739,2006
8d30bf17-9e53-494e-bd8f-ae0000060c2c,Commercial,0.200064790578095,48,31,34,1246,1212,69.02794461505975,2082
b508e9a4-d3dc-4fd3-a494-de0915af71ce,Commercial,0.5962604735543515,11,33,696,823,127,23.791440651120933,5438
ca80f156-43eb-426b-b4d5-15e841fca5a4,Residental,0.9083691381960992,31,30,83,662,579,60.461656977202395,2877
0f04b0f8-e690-44e1-9190-bd06d35c01da,Educational,0.09969264140685452,8,9,664,770,106,59.79877378992483,1069
9e585adf-69dd-4c4a-b797-82a551f6b63b,Educational,0.5616861160486099,16,3,164,836,672,77.29875281574333,9911
c9296b6c-5b7d-4840-bb1f-cad3fef82932,Residental,0.9897755925339804,11,44,258,399,141,93.14073132745297,6532
459b58ab-5502-46f1-9801-7dd1888d887c,Commercial,0.964743394682699,10,30,678,1365,687,25.05854969427297,9673
ad6da8b6-40da-46f2-a366-3a233c433673,Educational,0.9691567766468682,44,37,243,1014,771,29.04724905044557,5734
5f02551b-f72e-481e-9ba5-9e5ed60e28bc,Healthcare,0.7298074204097457,33,41,260,687,427,50.462621349763566,2963
dc55dcc4-b503-4653-826a-cc9ecf6bb2d5,Commercial,0.03976408859163061,13,45,702,1367,665,68.345142606339,4677
f21b09e0-a2c1-4a22-8926-e26b318df8dd,Residental,0.49416583803894143,3,11,30,152,122,54.09696473600921,6149
90d1832c-7618-4893-8ba1-c8830fdc9176,Educational,0.4572359437097654,13,2,586,917,331,32.59231126887292,1298
26e5e01f-8eda-40e2-bcdd-1728da06328c,Educational,0.3054364755148131,47,20,635,1097,462,55.72756157100882,4980
e0ceeb89-7848-4d06-a18d-e46dbc3ac363,Commercial,0.73406987512955,23,8,699,1432,733,28.223546291441263,6292
acea8045-cef0-44dd-a1c8-d482a6b80ccb,Commercial,0.9046337707178183,8,2,31,511,480,25.366286824128153,6248
9dcd5995-a749-4ddb-be92-db78243174a7,Healthcare,0.5880995655861008,49,46,161,825,664,21.83062588857492,4213
0cd2a59b-95a3-4739-a70e-596325d5ad1a,Commercial,0.7045375995169509,34,16,564,1413,849,21.220865059974766,8419
8ec939c6-8a74-4a58-8951-dc3d2695cea1,Educational,0.7741667987218563,48,30,197,1187,990,81.80418502690452,5855
d766a4b5-0bed-4aa9-8e36-f2f8dbecd09a,Healthcare,0.48836027023731987,50,7,687,1058,371,57.16248175940676,4328
4acddb79-400a-4d14-91c8-da4c7d7e889a,Healthcare,0.43629407123487207,25,5,595,1237,642,72.9089755215181,4030
ddf61120-9120-4b8b-8c85-c7215121417d,Educational,0.8244022423257016,3,34,566,1082,516,62.18444382019921,3422
ac9fc569-d70b-47f9-acee-62d7e0e191bb,Healthcare,0.3426504505706266,2,47,94,823,729,14.140422965048568,9086
4f20ac95-a4c5-47b5-b461-425c1fd0ff5e,Commercial,0.369764761769124,25,19,18,1415,1397,37.780743294429094,6278
ca58623d-f9b3-412c-9e7f-33c50f111803,Residental,0.3623780437978208,3,18,294,1070,776,56.411947882117516,4889
be4e292b-f976-4ba7-bb8f-e9623a3dd40d,Residental,0.31943449871378915,47,21,451,459,8,60.3419382851102,2447
f0b8f7f2-e488-4864-b099-f7cfe94584cc,Commercial,0.42764650711061625,23,21,287,1213,926,74.06610959058949,3233
5673cf17-90b9-4ede-8a3c-47001a1c682a,Healthcare,0.2479834108366541,30,2,283,1406,1123,95.06981325490231,5434
f1d3324c-9a00-4fbc-b560-595fe42e2f53,Commercial,0.8603249807774367,42,21,144,145,1,85.91003229591279,4482
70f9e065-a4eb-4815-9252-592412ceb4a1,Residental,0.04889842904698116,49,42,334,501,167,78.05364861649802,6142
8d986eba-d820-497e-a0b6-e8e6ed01bb0e,Residental,0.3458879549193009,4,18,225,650,425,96.58886072206921,1872
2e97c3dd-c84a-468f-ab4f-c8e48db1aca7,Commercial,0.777597842754772,28,50,607,952,345,22.237207686771384,2771
2c6e7844-9707-4e74-9075-afbe73974a25,Commercial,0.003635237927448909,3,3,445,1348,903,91.48621509514608,4369
f864207b-fb6c-49a4-a751-a9f7bd036f0a,Commercial,0.6896061637636084,31,7,359,786,427,99.91756070741047,2312
890d31c4-9216-4ebf-a17b-878d395490af,Educational,0.8929471483975994,4,22,24,1051,1027,94.67443164300305,6356
191428ea-d536-45ae-a26d-b4066eb8ca5e,Educational,0.23568069953362092,26,33,33,937,904,55.39349702788968,1660
87e272a2-d077-476a-91b7-cfb558e79b3f,Commercial,0.17320511713633924,2,14,94,1242,1148,82.89540320657854,9403
525464d8-8cde-4151-812c-4113f24f16f9,Healthcare,0.5657834114445545,27,38,218,1324,1106,49.04826501898374,4437
d41db134-94e5-449b-b42e-8a2b9a398eac,Residental,0.544653955317275,43,13,275,1412,1137,15.121899339868133,6530
3c4d7916-4732-469e-8dc8-b3bdf8309830,Healthcare,0.667817039808361,35,18,135,569,434,24.641989638137122,9195
dc0cec56-cabe-4780-882a-7e17cc4fde60,Educational,0.849856988616505,29,21,291,523,232,52.5207088043862,7644
464901d1-af41-4c13-aa32-fc617156604d,Commercial,0.9638494045602217,44,3,23,1125,1102,94.08806201147482,5158
5dee5c6c-c150-4d39-bc16-638641c6709d,Commercial,0.9358547485118465,30,46,241,1017,776,65.93303190397263,6148
5fa090df-2bc4-41ac-8864-b91603f81792,Residental,0.43668070619492094,40,14,497,960,463,56.61848053918087,2626
7d77af4b-ecae-4f5e-90ec-b74360538de6,Commercial,0.70884479720776,15,26,153,996,843,96.96935814195191,8259
f63e4817-982c-47a9-9bd5-6e83ba64b4cb,Commercial,0.6405647212886191,9,23,684,1273,589,23.533431742055395,9009
94978ee4-de35-4620-b100-d46b1477867a,Healthcare,0.7985507452113797,25,10,490,866,376,51.27616730196236,1873
850fc2d0-4e42-49cc-8410-27983cf2199f,Residental,0.8260854131787421,38,9,516,895,379,43.302913189904395,4348
8055f7c3-ab11-45aa-8e08-b9c0b6723ca1,Educational,0.23835124839152255,27,13,24,304,280,85.03328603259293,5725
0c1337aa-0657-47a5-8d75-1d02abd5cd3c,Educational,0.13132091656979883,27,33,117,214,97,64.58956882760663,7348
7ea8a587-e909-4f84-91b3-8c5c9b3158a8,Commercial,0.15769528009667555,1,31,139,590,451,74.57949868364832,7566
da853cf1-b537-4431-9c66-dad8e95accc0,Commercial,0.8778541408773574,29,13,33,1051,1018,27.57172253448183,1240
538ebab5-810a-457c-a0a7-01c2c3cdff33,Educational,0.5449451903183224,47,17,271,654,383,51.5035592472772,7119
e09cfa8f-71fe-4045-989d-1a86105abf13,Commercial,0.8106119483856912,43,42,71,244,173,85.29308612096547,9348
b54cac29-08bc-44b0-b88c-ea02be541a8a,Residental,0.6272091794670563,27,1,281,391,110,58.86801733191898,3193
1f722e0d-de26-4342-aa89-d9acc5d88aec,Educational,0.6952272875543476,35,33,313,496,183,87.4000204865853,2976
9b5cdc0d-b1fa-4688-825d-1f1970737c63,Healthcare,0.7923138294352834,43,29,77,859,782,68.80078362450053,4913
bfcbdc75-98d8-4c3f-ae90-8e66cd3642ff,Educational,0.03845531402558733,42,38,378,704,326,18.09746092520713,9228
6c3005ba-4523-48af-a888-d5fab7082cba,Healthcare,0.22973356996987515,23,41,699,775,76,89.08671614113213,7782
dab6d4d5-0dff-459f-9a0e-b9280fae3970,Educational,0.861265342650599,43,23,286,1099,813,49.745745211862314,7900
75b07a4d-be9c-437b-a29c-c8b96d587087,Healthcare,0.3099940067814677,25,3,679,1292,613,72.07925255512804,8736
ca19b10e-efdc-45bc-99e1-ae13224ed29c,Residental,0.6401081871260001,34,9,228,442,214,36.87823194813191,3708
92b04df1-178b-4291-8c97-5ddacd1d736d,Healthcare,0.6505401269483417,12,3,546,1410,864,70.65747379781733,3456
bd76f9d3-4813-4206-a513-3b502faa2219,Residental,0.07003624202234604,46,12,6,1124,1118,96.23354442218393,5327
3e66114c-c2de-4828-9011-5807fcef0d49,Healthcare,0.9616435614654438,23,28,300,373,73,68.4064993469673,6718
127dfe50-5166-4f18-bf50-87bff2ed0f49,Educational,0.9097091861100863,46,30,494,1206,712,25.645464225539037,6834
884b2263-baf7-4815-b02d-e7e1563adbc9,Residental,0.7789151691023556,17,21,507,1314,807,68.90759639752626,4916
6cb3e27f-fcb1-4856-b410-40e46c1b2a40,Educational,0.06732128941253668,34,20,524,1060,536,84.0025707060617,3709
a02622cd-09cd-42f7-82b7-db382d8df1d7,Commercial,0.955415286121319,47,2,163,918,755,90.48944214127518,8114
cc36a7ab-0674-4000-aa87-df3edd6722f1,Commercial,0.036984391220502566,8,19,120,754,634,78.3740666351779,5352
69b15e83-eeb3-44d9-ba03-e17ab7c0fa27,Educational,0.2894960684969602,44,31,52,478,426,96.58550059453583,7036
eabf839e-fb87-49df-9cd6-b201a5dc244f,Commercial,0.851145602987985,3,37,362,908,546,25.6850471903778,5169
1d906a8e-c18f-47e4-9397-6cbe30545f88,Residental,0.3189439513117971,38,14,537,1279,742,62.700864954568196,5187
bcd51892-cd9e-473f-aaf6-d8d485b0dd6e,Commercial,0.47249450683652916,1,36,329,1392,1063,61.51718630294089,8894
fd6965eb-c517-44e5-88c2-ea5567698d3f,Residental,0.985695356949132,46,5,177,1035,858,25.16641424929772,5752
94e5927d-dd1f-4aa1-8758-b4ede2000fd4,Healthcare,0.5834746149585962,39,29,346,1391,1045,53.92566340646814,2752
0ae838e7-6b80-4753-bb69-c93dcb042db5,Residental,0.4848305325943121,29,2,568,1400,832,60.700698352158824,2663
0039592d-cfc8-4238-a847-82a614f8375a,Healthcare,0.07555293473544977,38,1,251,1261,1010,21.50945427508016,7625
35b388d2-eb94-44b4-bbaa-cc6df258740c,Commercial,0.34623438258086725,43,6,209,948,739,39.37244578127077,2654
632c84d5-e3d8-4745-8d03-fe288f6f764e,Residental,0.6123049265384976,3,33,556,559,3,41.543943111787975,8040
9497604c-7268-40f2-9ad4-996391790c1e,Residental,0.45413182850152645,17,34,706,890,184,26.516183862042357,9092
0aecb75e-d0b6-43e9-944b-4d9e90a5ab44,Commercial,0.8025146979335386,37,12,522,1105,583,70.90020846425607,1033
051bf476-00ac-4e5d-8d5a-6a9fba955e5e,Residental,0.10647935751230253,14,12,295,1180,885,42.52488278545682,7530
85f599a1-145b-41bb-a96f-cee251845f64,Commercial,0.985254300011751,21,29,56,1216,1160,75.80127932059186,1824
7a09c51e-a9f2-472a-8811-3a8634aa8054,Commercial,0.8623513823950673,29,34,537,1221,684,55.348783966927066,2955
5b3f30ca-8767-4f1c-a6ed-08b73ee43527,Commercial,0.5711986834671413,44,33,327,711,384,75.79529123255769,1356
3c8736e7-f115-4882-aa7a-38051898986a,Healthcare,0.7643655725563671,15,9,451,497,46,92.6212488655207,7215
b14b6e1e-0f08-4de4-b3cc-195b860bca64,Residental,0.8346379063294022,49,16,681,1330,649,31.768261811614728,2240
067b82f2-57a7-41d3-99b8-03c8d9abc856,Commercial,0.7211273386784288,20,45,525,811,286,32.63880318582825,4652
c8882885-f79e-4c91-b862-5d014afc90e5,Healthcare,0.32555653245174787,18,48,476,813,337,87.31378796964968,6139
9a90f64e-9fdb-4be7-9165-36584e4ffbc0,Commercial,0.9349471003106369,44,11,276,1428,1152,54.152005642548616,2528
f3677011-0c82-4a05-82b7-e978b1a2d42a,Educational,0.402976062901212,4,14,71,400,329,95.1700692873942,1246
a4018c93-0bd5-4004-b5ba-3034d3733880,Educational,0.536213965252239,48,36,315,1331,1016,42.26601084370982,2874
8136b44d-a365-4b66-a226-abbb079862f4,Educational,0.5316351439705703,20,5,585,919,334,87.1654348473793,7809
c0b99059-f796-466d-b6f8-10a4beef9c33,Educational,0.24768774882141753,37,13,534,1066,532,71.52321982872363,8714
1000a48d-3436-4d86-97c9-e3a5309c4891,Educational,0.20218209936645848,11,19,180,872,692,17.363258713517574,2792
60da1fc3-d7e0-4950-a4aa-90298f371b4c,Healthcare,0.21448047675575466,5,39,563,1429,866,54.92978191765726,7073
fab0a359-ea4d-470f-b0d5-8e1532cd4b48,Residental,0.01594855546815921,36,49,489,982,493,53.63570630156197,5285
c173f38c-78f1-4fd0-9125-23922f78d732,Commercial,0.5085062785900619,37,37,3,1143,1140,28.1368581936245,1001
873a3af5-1a72-473b-9911-82fe7a85e6d9,Commercial,0.047466607186341214,6,27,691,1364,673,53.128532862033744,9803
79bcb4af-d7cc-42c3-9b0b-13abb8dceaa7,Educational,0.7209655086628629,9,44,541,879,338,99.74301872065467,6898
d57c8548-0425-4225-a806-9f7a082c265a,Residental,0.5823469349570357,5,16,557,1341,784,83.58352277258071,1198
9f3bcf7b-ca4d-4226-9146-5d4094ad3624,Commercial,0.8021177586604691,37,13,682,1038,356,47.48532138977227,1142
953ed59f-c56d-4e46-8986-e4149d646da2,Residental,0.349473672377013,3,41,302,1309,1007,64.90301295006665,8357
c7d9d125-40cd-48fa-8f5e-77ed6714205d,Residental,0.14926149336606143,12,48,379,1266,887,32.00465794674762,4009
20e3e786-9bef-4f22-ac44-007e98c80f24,Educational,0.6653274570637044,45,35,132,767,635,24.12419433493576,3042
68b06f23-819d-4dfb-ad07-fb68ce7cb431,Commercial,0.9756607492671092,41,21,241,1376,1135,45.153340664005576,8674
0b510621-3219-4bf3-83d0-bf7e183ad37d,Residental,0.9915124941010698,22,9,240,1049,809,66.9329168334029,5866
9358c7b4-89ff-4545-9d62-7d7ee64ced7f,Residental,0.6936039824893369,25,7,53,146,93,85.90184313104355,4904
b0741467-1cc1-443a-b4b4-e2c154bfc931,Educational,0.6588062356607977,4,34,521,865,344,93.73339240431012,7095
d3906c1d-479b-41aa-adda-8033b557903f,Healthcare,0.5654542970182723,10,40,170,1288,1118,83.05451112145788,1138
7ea0b630-7579-4f89-bd37-9762279ce2f2,Residental,0.16574106106283815,24,22,4,1198,1194,51.910473042074564,6798
fef742bc-1855-4491-9108-c9b0281a3d71,Healthcare,0.20120449517232986,32,43,286,577,291,76.49258066406686,6683
85ebb583-9619-463a-ad10-9e3c3fa57041,Educational,0.16458466979329933,30,22,494,931,437,54.42775856858069,3751
7dfaea3b-bc17-4e7e-aa32-4238d6e30e8a,Commercial,0.8382770827250454,44,36,428,1044,616,58.67691211437955,9469
89a6ffa7-0ea3-48c6-9327-ca5a3954be22,Commercial,0.47378390675850335,27,4,618,1110,492,59.92441629956183,3333
b6cac166-37e0-47e6-8e9e-3520b7e2c10a,Educational,0.19723276441070448,36,44,396,420,24,33.75867627825929,7645
780397b5-ac77-4a26-a40b-0f45750182bd,Commercial,0.5837853101803004,43,1,629,894,265,70.13052837743794,4308
17a1cf5b-553e-493d-a958-942f1baf5d2c,Commercial,0.03049566109755264,11,3,629,852,223,32.80273059963271,8162
eb6a322b-2a36-460f-a6cc-17911c6782dc,Residental,0.6614002831036615,18,38,446,1244,798,80.86130838663281,8497
d7e1e397-038b-4e9e-b5df-48355d522156,Educational,0.5104256331279018,23,16,348,989,641,92.8092828265239,6336
e21daad7-a0dc-4c09-b6d7-6480a862f9c9,Residental,0.6484832199173942,16,49,214,366,152,39.456830369495776,9415
00c2e06f-feb6-4363-b169-9a62860be44f,Educational,0.8807317503670482,13,24,578,793,215,70.30592762904574,5685
769c4531-9a20-428b-9ab1-19b7d6abd088,Residental,0.6386134895353475,9,27,59,1349,1290,53.94540006591529,7363
d1994857-ceb2-4b9b-911f-52ea0c9d3219,Healthcare,0.9501417911169536,48,6,18,53,35,58.6166381430813,4813
7a01f652-353b-40ee-97a4-040f229c33f2,Healthcare,0.9058052023076211,15,32,173,266,93,63.833432605386115,7594
864d98f8-ccc4-4aee-bab5-20ccc51a3328,Healthcare,0.44727082435569665,6,3,435,598,163,49.56261642344329,7518
ce28e036-0b5e-47b2-85e8-a27176f9761f,Commercial,0.40821563357939794,4,21,356,1275,919,51.79501919293123,2987
c6541382-a712-4be2-9561-f432db24594d,Residental,0.3653040994798076,12,22,211,1329,1118,73.82921672405968,3535
2c44f7a7-7220-4a0c-8c4c-09a3a9eb0ee7,Residental,0.5453904008296204,48,29,609,881,272,29.136662585842807,7893
113978d9-3021-4a38-a425-02d19c4067e1,Healthcare,0.007703069177742439,37,13,82,566,484,98.55631937574033,1193
4ebbf7f8-4f7a-4899-b95e-ec6b3bb2f4a4,Residental,0.3903869769679629,17,39,171,256,85,89.98332011950896,7955
a053c7d6-a5fc-425a-8f1e-14af824808c5,Commercial,0.5458970716268877,11,5,253,1345,1092,38.81869829946675,8638
ba05a41e-ce04-4a2e-8a5c-787be1fdf6f7,Educational,0.5883570580666095,6,39,132,362,230,37.69397068338701,9779
d215e7b6-de55-4645-82f3-59f6a8161008,Commercial,0.858557684383925,50,24,549,682,133,36.97540751711542,7527
5d431dab-dca0-41bb-bb7b-70fc58ee816f,Educational,0.7098127030591971,30,45,665,1292,627,17.341961538107796,2298
82f4d060-2ba7-4384-b333-cf479f7904ac,Healthcare,0.16872040225468699,9,23,270,1197,927,81.19785086915725,4426
02b203fb-bb25-4120-b39f-63903cfba48f,Healthcare,0.22972977147294238,3,45,340,1357,1017,21.617012968264667,2428
04ae4394-2bfe-4f9e-bed4-65ae51e165fa,Healthcare,0.59479026929355,17,21,466,554,88,90.49240458971053,6070
ea65d0f1-f4df-4add-9c9e-0ad045506cd8,Commercial,0.8542872185176997,13,50,41,627,586,68.3047300714948,7438
4eeae28b-a520-49d5-8068-8d69f732b3d3,Healthcare,0.33866629238600965,2,17,346,591,245,82.15072601920036,8887
4f466a51-98e5-436f-9257-e65c2eb44766,Educational,0.9585792604350463,14,49,360,367,7,48.35146793632271,4869
5c1ff833-d091-49c7-8186-e3bbce090315,Residental,0.7433787941824198,50,10,504,1235,731,54.83274325358343,2215
760e401e-cf1a-4c11-9505-9d73c06c2953,Healthcare,0.7200101817303839,38,50,74,1344,1270,49.36261536204572,4169
998b14c1-6f4d-4057-9ff6-3536d6cdb6a7,Commercial,0.08942921948015958,6,8,455,683,228,89.2974106693769,4803
3c6a4add-2df4-412e-99b4-a324b98eac25,Educational,0.1441893926298251,50,8,138,233,95,73.78504903986592,2321
6bb98881-f655-4561-a82a-64b703604ff3,Healthcare,0.7306707508107189,12,1,176,473,297,21.278702756840616,2765
891f35b2-2dc8-47bc-b22c-44d7c1c87e4f,Educational,0.8620755543773843,49,32,692,805,113,75.34968370316446,4491
1697c745-cd68-4a05-94d2-e7eca35c1081,Commercial,0.4591079238396262,9,43,38,1333,1295,25.27186342282586,5944
a31bb8db-601f-4107-bed8-194048db1100,Educational,0.1078379502650465,13,41,24,1133,1109,50.690451424650554,6408
80ba5b0d-ea78-442f-8296-acbde2f4a2fd,Residental,0.7181706843540205,29,12,507,807,300,32.97824039830368,9998
258fb0fb-bb8a-41b5-9179-91be8bfd372c,Healthcare,0.696320948113359,17,1,371,1405,1034,53.185137484201704,3337
c979577b-fe91-4894-b70e-e9e76fc30606,Educational,0.24295748229886283,50,29,524,1425,901,52.378209287284925,3235
83ddf9fa-62cd-4e56-a244-afbaf1ce5fa8,Residental,0.42836946438094026,41,18,667,1233,566,27.57676288796052,3374
216e8e2e-7b47-4314-b191-b12ba3789bbb,Healthcare,0.3375555637797437,1,28,689,1080,391,17.015755845353368,5363
d5c4601a-df27-4a50-8508-45cd5c7692c6,Commercial,0.4566936662823772,3,18,307,1430,1123,49.92320080079258,1094
848c6227-04c4-4715-bd53-4400e124ab07,Educational,0.7520456112338303,15,33,597,711,114,61.38700581230884,3801
6276121f-a130-4a5b-97d5-abb1e5976aeb,Commercial,0.7989209106561151,30,42,402,980,578,30.18029052303299,8606
b499e2d1-e0f6-4f34-a61c-aa77c5b4c2e5,Commercial,0.6043025669165685,5,43,695,704,9,58.29469392748898,1130
c0e9a774-c8d8-4fe5-b480-0c8a438e0b6f,Healthcare,0.3136739403405987,41,7,415,532,117,66.71628688565204,4482
1174d6b9-411b-4498-b0a0-23f9474c2021,Residental,0.6315540888300565,13,3,518,1113,595,75.84058365266297,6086
f54c6cea-3105-4a5e-b8ea-a29786ed14bc,Residental,0.46177810722013435,28,17,683,1064,381,30.02355646777276,7550
c69cfd96-656c-4c88-a02b-20c244cd39dd,Educational,0.9714722846040373,48,44,444,1291,847,28.974704812661965,4421
ede417c0-01e2-475a-a183-85a1f2e01420,Commercial,0.155044875328874,48,49,370,1334,964,92.39881658669809,4685
7527f621-82be-49f8-b8e3-99b686f93b93,Healthcare,0.1921171611669784,38,47,280,778,498,35.43649255896813,3882
8245981c-4301-483f-8087-b277cf149d13,Educational,0.23346577921353517,25,22,610,919,309,72.00383151564924,7196
6266e101-b748-4684-9cfd-14b2144735a8,Commercial,0.8158863974630997,49,18,107,830,723,79.11542429804067,7278
91f3208f-b801-4f92-b591-797ee09bc0a7,Residental,0.6883856837524588,32,50,143,1163,1020,97.36283876781147,2187
c4610f13-3987-42a6-8ff3-31bb9dac7697,Healthcare,0.27026253871895367,25,45,414,986,572,66.29881820145728,5005
dfa2187f-9392-4376-a6d6-a62ed3bb9483,Commercial,0.6066987311752194,46,12,559,1139,580,65.74797920539504,1425
7b4db265-abc8-453c-9476-a70655f7c62a,Commercial,0.8844821563534174,11,23,259,1221,962,87.30086657460092,5056
a9f2a48d-ec0c-4ba9-9ab8-ae8a45ed8ab9,Healthcare,0.9051243419338774,7,36,455,1141,686,54.09799332862177,3314
8377aa16-d51a-4c71-8291-adf0ee6c35fd,Educational,0.228461004445477,39,4,569,953,384,41.43085615046114,5626
9a706d27-8b6c-4f19-8d25-644c6730fc9f,Residental,0.060631105188289514,48,37,72,1330,1258,94.31734743558405,7418
3094c117-9b37-49af-af7e-4014bbd21d0f,Residental,0.25819708745307746,45,43,456,640,184,70.15966143149917,8133
3eb022d7-d4c5-4073-9aa5-8584ee32e46f,Residental,0.0967615703943373,18,8,199,1330,1131,40.325492507204494,8309
207a70ff-744c-41a5-9f51-e39d723497eb,Educational,0.005307963453770048,20,37,439,910,471,88.33474079294314,4610
bd3bc5a9-fe1b-4c57-8684-c0a1347d77c8,Residental,0.5299349819442005,9,38,287,1254,967,99.33449823289631,8080
0b6ce0b1-c955-4f7a-a21e-65e7c75aa2d7,Commercial,0.008430772340718873,36,48,648,818,170,54.13565101149565,9096
414885d7-893f-4d12-954c-805f81e3ba6b,Commercial,0.8303373740388699,26,6,445,524,79,72.68990732688718,9579
885e056e-20d3-48c5-bf42-3fab2bddebef,Healthcare,0.9899191381941193,48,28,209,488,279,41.19168711836639,4874
12faa440-651b-46d1-9ffa-dd2a72b97189,Healthcare,0.4623165132870706,28,40,488,1436,948,56.13520040751874,2692
5573dbbc-fd11-4fb6-b5aa-17060456fd05,Educational,0.5476850859416362,48,48,281,862,581,12.359539377357745,8937
c6d5b39e-ac92-4ed4-8cfa-576c800d56ac,Residental,0.8392094997161533,40,1,232,1142,910,89.74683438888775,5072
2da0d556-bdef-4681-8a40-a66c5662b99b,Educational,0.39522065283521546,4,44,29,647,618,71.175639191882,6195
410dda6b-1d44-41b7-981e-cc56974d4744,Educational,0.2800686681072654,16,46,485,959,474,11.139751294240687,1115
c2482201-3851-4669-93ac-77a4b3d1fe12,Healthcare,0.8246942118070087,50,13,570,1183,613,55.05192103003303,4791
6330a17e-557c-45c3-9ffd-fe03473b70e0,Educational,0.8967582613870578,39,38,122,473,351,92.2577637900993,2775
0aef447d-c798-4500-b3c6-95259ed37213,Commercial,0.4204023544949458,13,42,77,459,382,50.22139766043299,8196
90837d71-6892-4a11-8e7b-15b44eb96854,Residental,0.24621831368057345,32,41,615,1152,537,76.37796351660691,3392
5ef1d825-67c3-44a7-8174-f34a827f8f3a,Residental,0.8113360026664008,33,47,427,1390,963,13.449018222755207,9374
5840465a-fa35-4e2b-a693-66c0ef30f7e7,Commercial,0.5937142725514322,44,19,377,465,88,27.618062725883707,6993
c85a92d4-c460-43ae-8cb4-16cf3f775031,Residental,0.1729994188564158,8,41,596,1207,611,88.14479916669667,9975
4996d64d-6aac-4424-aa31-6835b68de980,Residental,0.7248025445575558,49,29,477,737,260,93.09528252365727,9710
4e6ce8f8-8094-4290-bfe2-52b30e8b737f,Healthcare,0.14001632164915068,5,45,377,778,401,52.3490368895587,8761
0fb4bf99-3618-4a47-b309-b80c69e92af9,Residental,0.24094545913917742,21,18,445,1095,650,95.55850915993587,9298
4ab8497c-8f04-4b62-b823-b6054d84910a,Commercial,0.08450431643369327,35,18,273,1236,963,60.14704788092685,2058
eaa09585-c15d-4612-9afa-1676c6a40565,Healthcare,0.730248069193533,29,30,134,169,35,28.245786223777493,2477
de287b3b-dfe8-4e45-86bd-418535366158,Residental,0.4901677906786214,38,43,288,726,438,14.685341889237108,5131
ab0698d7-c311-48ff-ab65-593933e0cc43,Residental,0.09519526568245629,15,1,458,656,198,26.562852153771786,5595
00eb8deb-609d-4ce2-bdf3-38e850676c05,Educational,0.8184860283212528,10,8,388,613,225,25.34512572936619,8704
149e2ad1-ebc9-48a1-9d35-8c35b40560e1,Residental,0.10748388107271101,31,22,521,953,432,29.93501783466079,1449
32f1cba5-eead-4fc5-82e2-e484ccc2d42d,Healthcare,0.6487232224757974,6,40,254,1421,1167,31.531991965240305,4678
a2ef1423-496b-40af-aec1-fcfe9a9e7818,Commercial,0.41521702814262607,30,28,450,753,303,94.16775209705958,2254
5da36f96-6e6f-4927-9ffd-85eccfd90ce9,Educational,0.7077325606999267,27,18,512,1274,762,74.22147480951665,3259
b10baa7f-911c-4c25-b2a6-9cf7ae834c6e,Educational,0.8627303449560004,18,34,116,444,328,18.617681961126934,9903
5fd997f3-2e2b-43cc-89f5-79a7a21afb10,Educational,0.7902805441939996,41,15,668,1112,444,55.55932237115678,1966
abd78b1d-4462-4ef9-aaf7-a363c6907681,Commercial,0.5518209736128221,28,50,344,1131,787,32.05634954334957,5922
31ab9a22-93a5-4a50-bd09-f0a5f61036c3,Healthcare,0.473101331720318,19,38,122,460,338,50.027292044605616,2175
be34332a-a795-4af5-9f39-507ecfd90034,Residental,0.8219230987348294,40,28,483,680,197,34.3000528082454,8501
76dc3ad1-e8e4-446e-a384-0ab3aff826d9,Commercial,0.6231064717974429,27,6,177,263,86,46.41589909965538,8066
95b47651-205e-4430-a236-08d42fb586ac,Educational,0.45404317603898114,15,31,181,1154,973,64.67813418100094,5663
e82ace7e-2b12-4fe8-9489-aab5aab12754,Educational,0.7208554656728079,45,37,479,902,423,99.05604825817967,2678
04ba2d85-0b5f-4a40-bf23-de605e00deba,Commercial,0.4628019008739753,30,3,463,1108,645,83.83029874195356,4300
e0abfeaa-85ba-4faf-9628-09e24c116038,Healthcare,0.7282685012248704,4,39,266,1208,942,66.48515813227783,5754
980e2d5f-afcb-4da3-aac4-e950e7821086,Residental,0.9049103372955939,20,10,654,829,175,75.02848551393717,9568
38703f61-a9ed-4a32-a6e7-737f83810f4c,Educational,0.7853369331080445,35,37,666,1152,486,53.880204804385315,1100
34a77ec2-d809-4fe0-9bc1-d344a94d0687,Residental,0.3035867679622256,27,30,3,775,772,95.18350855825761,2879
ca69308a-8d65-48a8-bcd0-70c4691aa0d5,Healthcare,0.12475216832100355,35,11,530,1368,838,78.32859576483177,6776
7eae05b0-47ba-41ce-89f8-aba26def0d13,Educational,0.3369776936996284,28,39,314,1209,895,32.706624905452436,5622
3146607e-f9c8-4a04-8d07-82e9cb9a1958,Educational,0.8385907677625358,26,21,187,399,212,60.577215178546034,7786
4446b9ea-ad4b-4ed4-8a87-feed9865817d,Healthcare,0.10892691423335132,47,27,299,399,100,26.223758150925704,6681
603f5a8e-db17-472c-816f-b1e3cd270d97,Residental,0.039282504091656234,21,20,238,550,312,34.92621950463728,6962
0a2816e9-47d1-4a8c-a0f6-3e4e754cb66f,Residental,0.07660439811026187,21,15,539,713,174,17.875775688832896,3135
1c42bf60-4cdc-45ea-a855-510603eb3d31,Healthcare,0.930583305296881,45,31,184,1064,880,96.01926016069659,9525
9e28320e-5838-457c-905d-94c7c611b5c7,Residental,0.5124261319148261,44,5,559,1133,574,61.26923458649407,3653
8af0e9b4-ae8c-479c-9d4b-2c8b29d8d686,Healthcare,0.9892741659172027,15,43,623,1003,380,48.635208527189945,7714
cf06a1aa-93e7-4a51-85bd-024cd45bab10,Educational,0.5958199389357699,38,6,387,734,347,91.24335915627863,4551
3b1c858c-e511-408a-85de-62166fea9907,Commercial,0.9327726817538811,47,8,327,932,605,78.32579268486846,4200
544d68e8-2f6f-42d6-8a9a-36a3dccd3b44,Healthcare,0.8240876385912017,26,4,291,470,179,31.18533700787909,3400
bba00b5e-19eb-478d-9ac5-cb50af0f2be9,Healthcare,0.4242017505749107,23,12,157,1362,1205,92.11283718408964,7602
8b7a98aa-860a-4da8-86f9-05cd5abc8bf8,Educational,0.12737604445914152,12,39,584,1002,418,92.16870972547304,7691
3011d6a1-e0b4-4137-9e71-8955fe653bd6,Healthcare,0.27669796920193923,22,47,520,1210,690,85.69806054794716,5236
88b8b476-7ba7-4389-a4b1-fbdc4b78a9b0,Commercial,0.29969021876932,3,22,179,575,396,95.32872654927681,7614
98283b25-d920-49e4-b894-f2e677b4ec82,Healthcare,0.37603243981262735,20,48,702,1261,559,91.45250052378536,6977
cc26b2f1-4f29-47fc-b41e-a2ef9c215570,Healthcare,0.8091706414704937,28,48,719,1420,701,83.2000824627732,9191
1c9c694f-8306-4372-bbb6-85ba368079ea,Commercial,0.35452700075167,42,3,717,1106,389,69.19411258668444,9615
c2157b91-0289-463e-970c-bd74e23da652,Healthcare,0.4298939298574641,24,23,344,566,222,86.09966841985195,9233
4e280779-834e-49b1-9d98-d6bfc7f28522,Healthcare,0.5140694703148788,37,35,719,1331,612,73.68490706483371,8724
b65b13db-f6ac-4347-b358-be0ad0df767c,Residental,0.693505732380568,7,14,567,1041,474,18.672464524073924,3603
bade09bb-322a-491c-844f-58a7a2e4cb7b,Educational,0.6362741688662802,14,50,337,1235,898,74.38214868188892,5056
2ee21227-a1b0-4fec-8fbd-0351ff8dc608,Commercial,0.48448582392910555,31,49,422,1170,748,47.1338495551771,6310
5ddbb713-2baf-40a7-8848-91bdb623f72a,Educational,0.030647272497070555,24,41,202,1081,879,21.045705976370748,4677
9e42e46c-3e6a-4af9-a25a-4550f928beec,Educational,0.9852439856063285,35,40,641,837,196,36.91923132686376,9124
0a4ee17a-b9e6-4639-adca-88604bef601f,Educational,0.08423088260808331,8,19,638,727,89,76.03249270418986,4642
61da28b3-30eb-41c6-9001-47a6b324828f,Educational,0.19518312220739342,38,38,695,1098,403,80.01461358414599,2233
44c8dcb9-8a6b-4eee-b21f-866f30f4c83d,Commercial,0.5266905330771372,9,36,172,1337,1165,56.0622084233939,5693
c526c25c-f6dc-4d29-b3db-ecbe9b76e138,Healthcare,0.9844919918096569,45,28,234,662,428,55.936551528576054,3296
446aae8e-5b6c-485d-a5aa-e01f60dd9d5c,Commercial,0.7024475222998062,30,42,565,768,203,12.723628986322648,3427
219b04b1-e1b2-43a3-b0a6-489b1b77154e,Healthcare,0.058718504420347206,13,43,610,917,307,79.17152980702276,3312
2d43321f-9c8d-4723-88ea-b079edec0b7e,Residental,0.0652787813009893,46,20,21,1357,1336,21.153287333041625,8335
f50d4107-7d70-404b-82c7-d6f952aa7b29,Commercial,0.45369009814133066,35,18,445,507,62,42.379639528538455,4588
c15b4880-dd5c-4163-abb2-2e68c8545ba3,Healthcare,0.9134727970750373,28,39,281,1327,1046,10.318104984852827,9182
5b928e49-dfdb-49bd-a7fd-72f7b46a0345,Commercial,0.1872389185577169,25,38,23,885,862,92.92895486361718,6894
7d4c5828-b4ef-4e4a-889c-ed8e54ee1283,Residental,0.5726002165961636,27,40,546,1058,512,54.74656371611098,7827
d85072c7-f3ef-46c5-bf83-f47faf118554,Healthcare,0.6143329791777732,36,6,707,1048,341,61.61059886287786,9789
4d25cba3-947b-4245-b672-77347a2809ed,Commercial,0.4535224402690953,24,46,20,1127,1107,84.37829679402074,6821
842e2a62-1a8d-4276-955f-f47946dee02a,Residental,0.36456104549921353,9,34,168,1336,1168,92.00044968381027,8536
f787011a-b598-4688-8ba6-f1649400fa4b,Commercial,0.29863497803441685,13,28,110,645,535,19.47362225884403,1242
18d17600-8e6c-450d-ac6b-6a76afecf03a,Commercial,0.5234949551070064,28,36,650,922,272,52.23412842612597,5811
09474243-bd9d-44e5-99e3-7ba2245cdefc,Healthcare,0.7453120484962529,17,20,224,944,720,83.50334278190236,4594
9193e08e-0ae4-4dfc-b4db-bfc386fef55a,Commercial,0.42577742469638313,44,7,608,1241,633,56.66946888468716,5624
4645e900-d09a-4041-bf5e-1ec106452bbb,Healthcare,0.6180668068934212,11,34,96,956,860,84.71371995648359,5662
8f4e3c7f-478d-4bec-8031-851118d9667c,Residental,0.5619155906387021,19,5,635,1119,484,82.60096678002644,4567
5c86fb24-0a74-4b08-a8c0-901de1180607,Educational,0.8782241982423389,24,48,650,959,309,14.2622382507144,1859
5ec02c08-02fb-4e23-b953-3c0d6a847a32,Healthcare,0.1951502081928772,37,48,293,800,507,97.46299807623157,7277
23ea5ba0-190c-4f0e-ba1a-f0f80f8b4519,Educational,0.5051845767293617,43,14,380,1127,747,38.16663180629997,1522
39a4362d-2d6f-40a4-abff-f01f0a2f4b14,Healthcare,0.8458591317767754,34,43,646,1439,793,42.09394014327697,2622
d0175106-729a-42c8-8b6f-67f8d82bd4fd,Residental,0.17758732992688953,32,44,368,999,631,40.33686199463031,7128
b9b1b59a-fb4e-40f4-9433-446d39be3431,Educational,0.17932992440912654,23,7,154,1195,1041,44.182233556484334,4257
fb25c5da-b073-4e22-a1ca-c3dd23c2d307,Commercial,0.04653856760636166,28,42,268,761,493,62.203659112163756,6197
9c95e30c-209f-4e34-8ea0-df822200ed12,Healthcare,0.605933044892623,18,9,513,985,472,50.40776807112443,7479
e8353e53-797b-4aa6-aa48-680a5d8ad4ab,Healthcare,0.12300879145966692,45,12,305,1335,1030,19.776877277972055,4616
e95c961d-30a6-4653-9fc3-c154b6323195,Educational,0.06322200288520397,32,3,695,1307,612,35.97251874381524,9678
0d077927-13ad-4470-88e7-8c15280ebafd,Healthcare,0.785996222251771,37,29,104,1181,1077,26.54098492455356,7786
bb68552a-190c-499b-8a94-a42babcba7a1,Educational,0.09954273122430657,48,37,223,705,482,59.18263584650152,5867
e289b06b-036b-4567-a28e-2d86f572d43b,Healthcare,0.40138141756394585,33,37,665,1141,476,80.06410678458036,2880
083726c0-4453-4b12-8ab0-fc944d9931af,Residental,0.7804305361139872,33,14,610,663,53,35.662147602508554,2281
ac543c44-4355-4d34-a00a-f521214ee7c5,Healthcare,0.3582408433711962,29,29,112,913,801,81.69583568774323,7120
f3f48ba0-c057-4c21-9805-7faa18ed4688,Commercial,0.07002069704559422,29,11,127,1405,1278,58.765765594948206,7580
224286e8-07c9-47df-9665-f71dbefa4634,Educational,0.49024549137941065,39,24,717,1140,423,48.92762753690937,8633
3a7986f5-7347-460c-8a98-34c8a65eedf3,Commercial,0.8324949795971951,26,48,594,1434,840,57.72228973085443,6136
02f1c889-7920-4c7b-b729-9512f8ac49e6,Commercial,0.18437069752270208,48,6,489,1278,789,35.675553005232494,6489
921cffb8-6b9b-4706-bb00-6ff3cd296ce9,Educational,0.13845004833582575,16,46,542,1020,478,94.73863600969192,2570
1a35129c-d308-4d34-aca1-b77703591d2c,Residental,0.6841276594591948,22,40,3,591,588,98.70042449818925,4999
740a5e2c-0371-4f83-8e1a-b9dbdf7d0150,Educational,0.5316125904672232,27,33,573,1049,476,23.103667732157756,4672
ac8d1562-c6b6-4899-8399-d9d2d3703d4c,Residental,0.6481935442782597,14,8,109,1115,1006,58.175463206467,4854
96a71eea-61d1-4d6c-98ad-604e5383faca,Educational,0.26915203617065064,26,27,204,248,44,27.631868413872887,5550
20731455-5738-4530-a8b1-4070854fff26,Healthcare,0.07756209514523404,12,35,115,308,193,82.94876816438371,7820
24503437-615a-481c-9c4f-e1b896cb6e68,Commercial,0.21333258511259268,25,24,347,525,178,44.17966990901628,4884
83aab95a-18eb-4255-be95-eaf59bf4c9de,Residental,0.9908258772856134,39,50,465,1302,837,89.58311015579432,5501
a2879680-f69d-447b-8d8e-3db1c1f4f781,Educational,0.7806648315076596,23,42,489,912,423,12.912925968493584,5583
b8c515e4-19c3-482e-80ee-f41fc6e1702b,Residental,0.8771494573961705,40,16,441,901,460,60.02320756189748,9927
47c20158-0040-4f4e-90e4-dfb4779a1530,Educational,0.04004231776827161,39,28,22,444,422,60.35459416542999,5500
74f517d2-fa5c-4ad1-8dec-7a81f72c2d60,Residental,0.981960098162041,5,46,394,585,191,15.220620253424038,4197
1125fb73-fd54-41e0-ab55-a9b571a237ed,Commercial,0.24397556574613866,13,20,636,759,123,35.377718329086655,1477
51692bc9-0ecf-427d-b95c-2cd7877dde95,Educational,0.03388624173059551,39,30,495,839,344,71.67918576714938,9912
73932629-7053-446c-95f9-7eaa32955756,Residental,0.8282995017376094,43,49,642,937,295,94.32314732535319,6335
82b51cab-1cf7-426b-aa8e-607dfb23f14e,Residental,0.931839498219087,12,18,178,342,164,13.831312120331408,8510
71207405-2484-456c-a42d-ee8c819c9889,Educational,0.03118201042697022,24,17,85,966,881,79.54590136635079,5282
7804fc63-629c-465e-bc87-d4d63dbe2aa0,Healthcare,0.03398506729419615,49,31,697,1055,358,26.782044427263738,8075
6c25ac5d-df48-45c2-96a3-d4fe49bb44ce,Educational,0.860257003134922,5,18,495,797,302,98.5418644623004,7852
894cc5f2-1d24-416a-97b5-4736cb74a592,Residental,0.4426690730523567,29,46,663,787,124,83.91175513081814,7895
4057ec42-462c-473a-a09f-2819a8aa5792,Residental,0.15235382072171944,4,12,168,306,138,85.96514386990555,9643
99fff826-e289-45d4-8747-d6e0de48dd70,Commercial,0.37690291383490826,25,22,423,794,371,14.86222224556281,2506
a1aaf8c7-43f2-4638-a7e7-2fe5d314192e,Educational,0.586985064563485,11,18,23,163,140,88.30990161029432,6464
4c4674ab-8dc6-479f-b7fd-b9b4fd8916e7,Educational,0.17374943504639517,1,18,88,799,711,31.861759905327443,5491
ebe19414-9c39-4849-b593-866621e6b66e,Residental,0.3107885760739316,15,22,231,275,44,80.82795580586884,5312
97784d87-3453-49ff-8c0d-0d4ece5cb742,Residental,0.12423958734237062,32,45,325,1062,737,74.40741294490105,2892
667a1104-0bb9-4ff4-b5d1-ea54c475ac4b,Residental,0.14905269674744515,40,29,1,206,205,78.5626392701845,8321
04233ba6-5931-4e83-af5f-91be0289a785,Commercial,0.501127189027071,8,46,343,1025,682,58.566734396497004,6538
59d5f0d0-f98e-47a6-8fde-ef5cefc26a15,Residental,0.09220828799309333,7,25,685,1258,573,58.853304506317244,2668
1dd022b2-ae92-4354-b549-0c5a2435faef,Healthcare,0.22532621213131754,6,34,608,1407,799,22.8958716184682,4772
a206f6c0-b73a-4fd7-8269-6c4dbd09f593,Healthcare,0.3984161553432505,19,22,654,729,75,86.30212098005465,4492
7f6c89d1-1cf2-4f76-907c-17b67cb89dcd,Healthcare,0.5345702098313418,30,19,720,1431,711,13.68738154793464,3224
c848c5a3-24ea-442a-a367-9d652862f391,Healthcare,0.770546676263993,30,37,410,1308,898,91.19858145382791,6708
6ccede89-1179-476f-bdb7-ecd10bc0fc6d,Commercial,0.590720263441475,35,15,284,1281,997,13.520355846599665,9443
0252f110-7d36-4b8d-b9e7-0fa4f4ec5615,Educational,0.276827203631425,2,29,333,1098,765,14.319651294721222,7801
7af61f9e-1d75-41d4-9eae-29f96d8e8f0f,Educational,0.5617253195442704,33,14,470,539,69,10.057581192152108,8358
fe08e602-c936-4ca1-b2cd-42d3bdfbd4b2,Commercial,0.4279882270691697,15,25,489,1286,797,57.35080899559063,1147
3b7ec99a-5f7e-476b-929b-11577fa1f7f8,Commercial,0.8147050906278389,34,35,243,1255,1012,29.004832879625596,1304
ed4b55ab-e04d-46b2-84ee-6e551e9ddf3f,Educational,0.2650575181411646,46,14,289,1377,1088,12.407797892567048,6857
5f6effec-1439-43f8-ad85-32eee1e64aec,Educational,0.9587613657065621,8,17,30,159,129,23.988994910671977,8461
7c849e3f-f628-4507-a990-481a06b304f9,Healthcare,0.4703791923440648,42,20,501,985,484,51.05617588690633,4502
146c5b6f-1ff3-47c0-98ad-a8ad65174598,Healthcare,0.30280194604582966,32,45,57,615,558,66.22207552757189,3118
1d87186d-a491-43b2-9a43-9bb20b5249e0,Educational,0.9578032431372425,3,45,654,996,342,22.660620559583634,8640
b1b3ea21-9cc6-423b-8d32-3cc88b88e92b,Residental,0.024801055595410126,49,46,290,525,235,58.57578106979678,5115
edb266e0-71c9-4096-9f86-376754bb09b2,Commercial,0.5325391747275522,45,9,653,1137,484,53.916536097048464,2763
dd980b9d-9bf3-4c94-a4f2-d121627fa3af,Residental,0.4321273897474791,22,12,678,1106,428,48.501832736083536,4059
0af2458d-3411-47b0-b85e-d2e6db39ff80,Residental,0.3660574726144936,31,35,626,640,14,99.71543515504659,1565
400ad9ea-76aa-4b1c-a209-0ae8917d62ed,Educational,0.1555666600462805,8,9,95,744,649,48.575214421438666,9735
cbb5dcb5-88b9-463e-a7ee-9dfa33f5a30b,Commercial,0.18170186516111209,16,22,322,817,495,31.56738332264247,1656
f5f86766-15da-4345-a907-12a58d9ffd1a,Healthcare,0.14816168958649278,40,34,637,1106,469,48.578912236836835,9320
5b8c49ad-1b3b-48eb-a1f5-cc1d51876adf,Residental,0.31013109494586577,1,35,341,853,512,11.344794172363324,3637
9575f1d5-a699-4b8f-8864-ec489022c8ea,Educational,0.043869392976529586,29,36,2,826,824,78.59277403230175,3495
0bbd60bf-6566-48e8-b166-ce410601e5a0,Residental,0.6796814802431719,47,34,159,562,403,56.65667871719922,2322
9d326fba-c4e2-4662-b53d-634e166df92f,Healthcare,0.8245556475346564,30,29,37,1257,1220,38.337741567430264,3809
1e8a9066-d230-481c-a1a0-fc9e267e8290,Residental,0.7591335124998462,6,46,247,1419,1172,55.07961437440448,4724
aa52feb0-4075-40d4-9353-c971124f5cc0,Educational,0.35681374605716065,21,37,683,1228,545,42.53398694555628,2008
2a6bed5c-406b-4038-9fd5-6cd077d36b05,Educational,0.3739714971564534,22,1,162,463,301,39.09215146090351,7438
62577cc2-e369-49ca-83b1-1e3381c91c7b,Residental,0.5141559053501592,35,11,169,1230,1061,93.27273198831381,7984
caaae509-d966-4766-b5a4-90ba7193f8e7,Residental,0.5116131794653785,21,50,660,885,225,76.09453050989585,6824
7ed863dd-271e-42de-bcb4-2d02bbf384f7,Residental,0.004243591672843938,32,16,211,552,341,86.94733115215718,3553
2008f1c4-ee9d-438e-bbf3-a8d1c611ce6b,Residental,0.6949162274781385,32,33,95,360,265,44.32615411985311,1578
77782cd1-daa9-41de-84f3-1c2afa1c1e48,Commercial,0.998171581337316,31,38,175,323,148,73.53082852559687,6803
d9e880fd-2b41-44b6-be5d-512bc28c4791,Residental,0.7091915588888177,45,50,308,429,121,60.86364152950474,1714
34ac5c29-0e43-44cd-b4b2-c56eaa1372b5,Commercial,0.21581246596513992,7,45,339,647,308,29.406311157769743,5667
8a7ca168-590a-430d-ad66-a7a925c7697a,Commercial,0.7916246046171024,29,25,686,740,54,85.67855987294963,7324
01dd6537-cc8e-4ec1-abf3-0286f58e8a0f,Residental,0.2542051066717177,40,16,188,911,723,64.71659602650679,3029
9db6b941-c8fd-4925-ab69-75a56fe393ea,Commercial,0.538681515126297,21,46,463,656,193,39.225619627121986,5730
e5608eaf-7c10-443a-8fa2-b4c5cb5adc07,Educational,0.29135413616957473,1,13,364,1372,1008,82.20941882276047,9348
a08ccc11-f545-4d9e-a812-206a5f19581e,Residental,0.49185197752889476,12,12,324,1133,809,45.90514768963424,9418
94a1273a-f0c2-41bd-bbaf-79b2e842b737,Residental,0.8179911360260276,7,48,120,917,797,37.69847737521194,5002
a62415ce-d5ff-4f6c-b0ad-c314a369ea39,Residental,0.005090958717575256,44,39,288,780,492,34.73403017981875,2227
c3dacc3c-96b5-4ece-a48c-50250afee818,Healthcare,0.9967870154815894,37,28,474,850,376,37.78189436989253,2092
7dcf1012-383a-4566-a9b7-97510f144aaa,Residental,0.3932169078315849,46,19,99,815,716,27.483595677282757,2146
2f712579-eca1-4c78-be09-ec9b7dee9fea,Commercial,0.6784257953380751,24,32,33,507,474,82.55351310314639,8273
f5e6203a-0f6f-4045-bba9-47d3144dc1e4,Commercial,0.9883570293265935,49,15,572,1326,754,59.41507651433722,4772
b6e48744-8dec-43b5-b4d3-19a1007b5bf5,Residental,0.08631430835392229,40,4,86,235,149,53.577508286708664,8457
cec2cfef-c9fa-4eb4-a5c3-860f82047054,Commercial,0.13943307328522803,25,3,560,1300,740,50.380137208021196,8747
63c52151-cdcd-416f-95a8-9ea8ada62c6e,Healthcare,0.27515714726508333,15,31,363,610,247,44.686693633409064,6045
0bf401f0-bae0-490b-9743-ad192885f5a4,Healthcare,0.7428279523041033,6,34,28,884,856,14.694992925824147,6304
01a3958a-47c0-4981-8836-5ae7c944077c,Commercial,0.665555339578762,41,18,67,635,568,22.622378943185247,5612
aa5e6360-d52d-45d6-a0a3-3d36bb3d553f,Educational,0.8500636938474041,40,34,95,241,146,55.02464308134299,4573
9565b96b-2c86-4044-8302-38096d529f47,Commercial,0.00402388040547641,18,49,492,1193,701,46.45665552442751,3668
712acff7-4c68-4316-9bff-0462df9d4672,Healthcare,0.4001948722592781,11,23,330,1092,762,35.07576176092462,9775
30dece8b-00ef-4de5-b656-a1fe5d37a371,Residental,0.1734002612856893,28,27,592,1374,782,67.7156063949475,3051
be22bf2f-bbda-4669-89b3-732259342da0,Healthcare,0.1565480809218196,49,38,641,1437,796,52.480920353583834,3310
e7932eda-862a-4b11-8d87-ade0f66040f7,Educational,0.23353342082210027,38,19,510,670,160,54.66756903596792,3473
31853f36-bfd4-4bb3-8021-63367c4aaa9e,Educational,0.9888387526423462,9,32,683,1064,381,34.90172761130743,9470
1fa6f9bb-d4e7-4458-90da-e3927ea4bae2,Educational,0.07493572654297731,47,6,653,899,246,27.695557649363963,4594
b16194ca-750b-4c68-9d4b-916d5869a2a7,Educational,0.6646477452917182,23,19,410,561,151,13.588398315503685,9791
40351f05-d432-40e1-8fe9-7e4b293e4103,Educational,0.7866299373831922,35,13,396,1138,742,54.20649508011251,5117
9d7da4b8-fac3-43e7-9a65-6dd1b9e69917,Educational,0.798757323944704,15,7,657,1290,633,52.67538802633241,4537
ae706729-c1ab-46c6-a60e-a7d355a27caa,Healthcare,0.27752114697377994,44,39,575,688,113,29.921854272320296,9919
0d9742c1-7610-4a5a-b064-62e9a3e7de64,Residental,0.03852487147438022,32,28,717,832,115,56.94735249389597,6592
02bb85d4-e970-4d41-bf2a-d197413a1dde,Residental,0.9337133682360416,22,26,150,1072,922,63.04394085099233,5371
cceaaf2b-9f0f-4d2a-9641-3c507e8502de,Residental,0.4454994383207518,18,23,615,1396,781,84.05856241803525,6673
797e40a6-88cf-4921-9751-3ea2cf750710,Healthcare,0.8063881664814971,14,49,696,1117,421,88.18555411687036,8578
9f7723ed-a69a-4fde-bcbc-d440da825fb0,Educational,0.9693133141254026,10,49,57,727,670,63.95349517541343,3158
2264c0a3-78cf-47c7-89a3-9c6c1fa138d3,Commercial,0.6222078205395932,30,24,395,1080,685,88.71720303340209,6010
60fcec90-42bc-4c8f-98bc-9f2370cb3bd7,Educational,0.9304044390217991,15,32,343,626,283,95.50687034144674,8006
ddcc51c8-7246-400d-b5c9-ab19740d5d57,Residental,0.669654549045871,1,5,382,433,51,52.44462883027803,7868
691079fb-7c1d-421e-862d-155a237eae60,Residental,0.6923706792337482,50,45,561,1193,632,62.802221319416546,9618
4d106131-e05b-4457-8a32-2479cb138f7c,Commercial,0.3811610515531837,29,18,659,946,287,17.495044605121198,5779
20ba7128-ca81-4a30-bab4-d9654d815428,Residental,0.4888542120013253,39,20,671,1416,745,94.97836563930572,8149
c317f7d8-4b50-43b3-814f-e437cde681d8,Educational,0.5958803865046736,4,50,222,716,494,97.06266525307214,4221
4c56657f-d04f-4670-b8b5-b20d5917587f,Commercial,0.9767976589432537,10,25,631,970,339,98.2030171194009,8587
f0007e14-b98c-4fe9-9147-4ecfdb1ee05c,Residental,0.3141011680303436,12,3,394,1317,923,66.83952127257582,9321
2048cfea-0766-4bec-b8ae-0f407fe233ce,Residental,0.2991594077643699,21,34,467,1154,687,57.753924267575826,4216
e5f55b55-d3e7-4919-9efe-620a47fc0c2e,Commercial,0.5357311550764943,41,17,699,1327,628,15.50766933511438,3639
e3ee22a8-786c-44c2-871d-02573548778b,Educational,0.36946148376248156,17,3,662,1128,466,97.2890988684445,4480
2cf3b1b6-445a-42eb-9a6b-8e5db6d2615f,Educational,0.6416219739914993,2,38,136,738,602,67.54773215823832,7500
52e2a23a-feba-4e75-9e3a-08dc436f5620,Commercial,0.7869258675669151,25,4,76,1414,1338,76.19921201953912,7378
47dad1fc-772d-4437-b83a-8e51e22896c6,Residental,0.3085779621567426,18,43,641,1141,500,37.191607722212055,4573
05d45a98-f3ca-414b-8e3e-1473ec0a4844,Healthcare,0.33462264627465643,35,35,558,1422,864,46.74059702344614,2833
8c8f7789-be71-406b-aa21-0bace9667d43,Commercial,0.7119925126521672,50,41,555,1233,678,41.19531238579735,2794
dc84c468-dfdf-444f-a5ce-30cda0dabd29,Educational,0.4229518059835289,5,19,701,1006,305,29.62851876089635,7406
b2276023-a190-4e39-9272-d6ae1fa5b567,Educational,0.26876441013249275,30,23,296,1198,902,45.540644220668135,8821
53ee3fa5-02c9-4d96-9a00-84c72cec6e8a,Commercial,0.8455080933181264,29,18,639,994,355,73.12654426519869,9351
785d73ef-f227-46a3-a041-fb376e93fdab,Educational,0.9265483219342213,8,29,241,278,37,85.23121153875445,2277
34325c01-46fb-49fc-ae23-4ac937f0b62f,Healthcare,0.3143380022337471,26,31,25,214,189,23.144544099708106,5679
727e1f9f-f88c-4a42-a367-bb259c51c9b6,Commercial,0.5838312952990005,35,23,324,1161,837,71.45832363751514,3504
138e68a2-a4f4-4bd4-a1d8-213aed79e9f1,Educational,0.5299817647194184,10,2,485,880,395,27.655649903165568,6820
0a04cce8-018e-4f30-b70d-c6fb914ac317,Residental,0.5756255326461412,42,45,93,1024,931,62.079729035392006,4004
08158680-3ae9-4f2c-84dd-148378e19753,Residental,0.2047568432111322,24,32,26,62,36,14.336591616414438,6914
9d9007b0-49da-4115-8ef2-d30a5d04db7d,Commercial,0.27063876536397313,3,15,140,1431,1291,18.95979189602062,5448
29c4f265-97c9-4731-9096-1d6217a196c1,Healthcare,0.9353584638534851,32,34,148,699,551,47.04899873844134,4405
0c61d5f6-7c7d-47c7-9ee0-18111ba8e652,Healthcare,0.6718655350883056,28,2,264,1281,1017,48.28942517769791,5326
5aee49d4-ede2-41d5-b632-80becafdb62c,Educational,0.13353195644638527,11,44,592,1265,673,52.32019122339224,4870
e2f57550-fb03-4940-99c9-02c2996d8582,Residental,0.2835368847494444,35,21,174,1264,1090,34.57729578845047,2984
0fe0bb57-997c-4ce5-a246-5beedcb66873,Educational,0.4139992313028501,37,4,94,1063,969,60.08580958714868,4664
41beec02-a6cc-474a-8f61-529926424e57,Commercial,0.7004961141340574,14,34,185,555,370,18.882971317562866,8896
4f98e06f-93b9-4a49-89c3-bac92afa939c,Educational,0.11015768874917342,30,36,576,1372,796,65.46996323932899,2204
111a039e-2ee9-4e1e-844f-2772d302ef18,Healthcare,0.865779871928295,26,34,13,460,447,58.92975584527733,2011
1e10fb2e-8613-403e-8e7d-f59943a2f280,Healthcare,0.6513930005873336,25,42,577,1316,739,62.238074594381075,9726
17e11ca1-a84b-4039-8fd1-da2e48ee1c82,Residental,0.5453312699143558,24,44,635,1023,388,55.71473010291404,4025
be254c92-5eeb-4386-81f4-1d6c05ff0d92,Healthcare,0.4953716857341147,16,50,213,1321,1108,19.14742351992644,5734
9d4e302f-c836-423e-bfa2-8f89dcc65691,Commercial,0.9754432455173623,10,48,224,759,535,97.39937667264223,5123
eaa3b7eb-32d8-4ef9-a515-7c23fa58893c,Residental,0.2940424530800255,43,50,419,893,474,38.54267972776334,3760
dbff7287-cd18-43af-9288-ed50759e4a2c,Educational,0.3388816786923039,15,21,130,441,311,75.38360237040507,9514
cda219e1-b3ec-4a65-8e81-405acc700c81,Healthcare,0.8525433810195854,25,48,165,1256,1091,60.193043564914035,8062
a98cf024-7e61-4ebf-a1fe-c70d00390865,Educational,0.48921894380240183,13,38,206,400,194,48.881358655001826,3990
eeca5700-cba6-44fa-8b8e-a3d99fa419be,Commercial,0.866162933261995,41,34,480,695,215,43.276808105751854,4318
f2c941fd-c31d-4d24-ba25-3c3da750213e,Healthcare,0.6699924816219072,26,4,716,764,48,56.6230371472071,4428
16775980-f2b0-45d1-9722-0244330b01d2,Residental,0.5969852263882477,12,22,369,872,503,22.785214162939106,6269
6aa7d1fa-5728-4489-bbb7-45f4a85a6de3,Commercial,0.22444719529640644,26,36,706,1010,304,96.30777433376383,2475
5e7cdf4a-a7ae-4c6a-a82d-0e0baae6b41e,Healthcare,0.12077640089485953,8,17,89,1328,1239,31.974657865477504,1202
8e07ba77-8301-49ff-b17d-93acf2051782,Educational,0.5600258519941621,26,37,406,857,451,58.93455462609917,2530
7e19c2f0-8683-434f-a3c5-baea8a3fca67,Educational,0.10278784216885128,12,8,562,684,122,80.54337713498923,9201
9772429a-e3b8-4ab4-bc7b-4b2f6603ca34,Commercial,0.8232829401115842,41,46,200,669,469,28.48819985198371,1899
b9b7fdf3-9e06-45e3-8edf-0835f8aa28ac,Educational,0.9715545341700033,38,12,161,1128,967,39.91137572817751,7147
bcd48c26-fde2-4142-bab0-dcf046e2114a,Healthcare,0.48009348986485734,8,29,94,182,88,30.56374927915811,5387
d4ce8076-73d6-4eba-b0ec-6979055b82c2,Residental,0.9453319758309705,8,48,275,1162,887,60.342263399837556,5191
227f4d1a-99da-4155-836b-ec3ae61295a5,Healthcare,0.3188944222075202,18,31,204,335,131,19.832450501881922,8408
9a54aaf2-5501-40be-aada-36adf077d283,Healthcare,0.5213191082415134,16,24,364,1152,788,28.591861381984742,3016
3c63ebc3-394c-438f-86c4-977697b35d39,Commercial,0.15170156385278755,47,29,478,883,405,51.450170441326975,9931
6c2b2601-c825-456b-a7e0-e0bef11e499e,Educational,0.630690267739807,15,11,60,810,750,32.3900118069015,3007
7a361662-219c-465b-8ab2-4d8523c7ca9a,Educational,0.8613314695157297,8,29,404,1193,789,42.23938976126157,4000
25d02f75-f836-4d71-85b6-2fad7abd029e,Healthcare,0.6244516837769513,5,36,501,941,440,18.772389178944763,6571
0aa33e29-b98e-41ef-b54f-a21a2ad0afd0,Residental,0.9252820610110817,28,47,261,760,499,25.29042786514568,5051
bf1743f0-8b18-4706-9b12-2aef58cce4a7,Commercial,0.5975113991707348,8,40,555,1434,879,67.58536770465645,4068
94d27768-2d29-42e0-8d27-bdcf540fb6cb,Educational,0.8614483766810636,8,35,166,842,676,84.71832596384952,1804
f3a1db63-7fec-4e57-a95b-93a0216c8107,Residental,0.03684086048670221,15,9,286,1044,758,10.060404874015777,3975
bfb83ea9-0e54-4058-b9db-122c476798a7,Residental,0.25722609494088977,44,48,157,1129,972,36.54624236065709,3490
434c35ad-5341-43be-90d9-4a5f2ab1f0b1,Residental,0.6907012595534325,29,19,394,466,72,41.410253424712025,1186
bbd566fc-9292-4e1d-8c70-12aadca60b1d,Commercial,0.2993689915204588,39,25,136,194,58,26.53191364881343,2528
b89cff71-69fe-4286-9258-bf508d5699a0,Educational,0.8610658052870137,26,20,271,552,281,53.80981273090311,3004
6d1696c2-94ed-4222-82a0-3ebede1fc79d,Healthcare,0.5332808255104259,46,45,197,402,205,17.828696025330316,2734
be3ffb60-8198-4405-9ea2-0da13f989574,Residental,0.3211341961786214,31,3,375,1011,636,17.121289534557746,1031
ec0be16e-4f92-46bd-a59a-b456428ff1c3,Commercial,0.37204642029912005,48,13,473,916,443,53.170382418854686,8719
f6a14f9d-c405-4d76-bffe-a5c62bac5ca3,Educational,0.7626552622259222,14,50,658,1152,494,66.65998916420162,4356
7c90087e-b04c-4b0a-90e5-02d408936721,Commercial,0.22235426225429855,34,35,89,1208,1119,43.2769633161622,4911
bf9f7890-fec7-4461-8600-85db6596670f,Commercial,0.6240209585294608,39,1,72,288,216,92.66853369702189,9686
3d3c5ce0-0461-4cb7-9826-26b28e22f42e,Commercial,0.3504951051267501,33,43,676,1408,732,55.89813209787143,6809
69f2ce94-8648-4d59-88c3-39ecc0345f4f,Commercial,0.7871504415283993,50,11,549,1180,631,55.47765722932753,1410
758ebdb6-80e6-448b-a67e-8881b0ff88d5,Residental,0.6942087501768931,13,32,492,714,222,20.9919782040417,9691
df00a58d-bacc-4d55-aec7-2d0a105b5724,Commercial,0.30092693913705126,48,9,23,923,900,21.844378589403952,7396
3fc5f8c4-6e42-438b-be3c-3afef97a9b0a,Educational,0.634968511810847,44,41,357,751,394,64.10480263634645,7594
37307bbc-c6fd-4635-809d-75e5bb9f2392,Commercial,0.07374271918311293,32,18,453,1238,785,56.03550228727415,6787
7f46135c-89f9-4258-9f52-66065c1bf966,Educational,0.8487322523689657,7,47,590,602,12,50.45538786946508,3683
75920be2-bbdf-44c7-87b5-2a16c4864180,Commercial,0.07163305046624902,34,9,519,1236,717,38.72060318616248,9973
2298d320-65b5-4517-b369-4b4855a36689,Educational,0.3362560396666021,5,31,182,800,618,13.25280500966548,8512
2456c848-5f1d-450b-9e79-75616c1ea88c,Commercial,0.7491674492588415,41,45,182,1306,1124,32.57092729326706,3068
99f4e400-d0a5-46f6-97a6-0ac2f8cb141b,Residental,0.12322442616494156,37,16,119,1124,1005,19.294767515789438,8269
11e18578-73e9-4c83-9ae0-0bf7080c333e,Healthcare,0.3786089582982409,13,17,350,1110,760,81.5184934038635,8863
23efb13b-d568-4c1d-b532-9713e647f14a,Residental,0.2603494080984713,44,15,42,334,292,40.62369955064094,4807
3985236a-5643-4597-8ffd-a3a0ed1d742e,Commercial,0.9798562659552182,37,41,172,1265,1093,89.27122306469239,1511
110b580d-e8ca-4b8a-99b0-9b947d98d195,Healthcare,0.6833976161945562,8,43,457,582,125,43.71652793718146,8870
62db7fe5-eea7-46e5-bb14-6693cf6a352c,Commercial,0.6161720150747266,31,5,583,790,207,10.75988136886239,6605
13c84592-c38e-476f-9a8d-2090fb48b03f,Healthcare,0.5025119057718003,13,5,498,1013,515,91.26546159815308,9378
72af914e-2162-4d51-ad23-a89adf9b818d,Healthcare,0.5183961100714457,12,28,79,883,804,13.287350514308859,2621
947e4eef-95a7-4b2a-9c17-82f11cbc36df,Commercial,0.29278176631249275,41,18,452,1040,588,41.052291985379526,2543
75127d07-27f7-4366-bdca-6fd26d28c28b,Residental,0.5017010659727106,8,19,675,1258,583,15.063830235971198,2364
31d7c32c-4f0a-41ef-ae6e-c3f54d85ce57,Educational,0.20646020218060324,35,37,65,587,522,45.951722903545615,4884
3481f8cc-6caa-49dd-9b0a-daec68f61559,Healthcare,0.008309300937162867,33,24,521,685,164,18.679770517188487,8288
4ce41390-a57a-4845-8f63-ad2750573c38,Residental,0.4094235232253767,25,14,223,559,336,17.678093107108914,7277
a6a360b8-d356-4227-848b-02226ace112a,Commercial,0.16391790840159093,19,10,528,978,450,84.38868855671456,2434
56278d60-b9ad-47d2-9510-34d405915d30,Commercial,0.5931410543382859,41,18,556,955,399,65.75408323868241,4072
028377a8-be99-41b5-b2a0-dd67e05a0469,Commercial,0.2683269784748479,32,2,273,1275,1002,13.042893722968337,8777
8aa167a3-64b6-47d4-89d8-6c7451a0278f,Healthcare,0.8905783773940591,45,42,295,883,588,43.62706915756163,7296
9a26391d-8894-4132-a181-374523efde96,Residental,0.7302816004569826,5,37,212,1156,944,11.827325838570564,5943
483f20cc-219b-4f10-9baa-558aa30d1d8b,Educational,0.1829020407993519,31,1,396,1010,614,50.16120689622573,4981
08584a1c-bc45-45b4-a6e1-d93fe0464fbe,Commercial,0.8413020092096264,6,4,414,1247,833,43.773275218168735,2112
5efd7c90-29eb-4079-ade4-3ac77bb1811c,Residental,0.6612912689586322,21,26,710,1244,534,62.970699519919876,1587
6097d2f8-e1c7-42d3-b4e5-2bfc735436a6,Healthcare,0.3216625189713893,5,39,260,1066,806,86.83547908007974,1249
b631b48b-94d3-44f8-a441-0b916e02207f,Healthcare,0.10001007034253095,49,34,444,897,453,24.901206263951327,2259
37ae5461-2c42-45e2-9912-64435f40580a,Educational,0.12900129025192453,49,21,205,1397,1192,38.74450621875383,9577
5aa7d2cb-2143-44d2-8e65-f9da8b793c6c,Educational,0.002631578157164083,26,25,150,711,561,27.000400970332226,6054
28325ff4-181f-47a9-b04d-368e66e88728,Healthcare,0.5321831687859538,6,38,402,1100,698,38.43386524694466,1035
1d872a79-3e4c-4fc8-9c26-471e61db2678,Commercial,0.5220219111807853,28,44,578,967,389,36.790175385411004,8701
7edee7f1-47fb-4250-84b0-db0d6eef52cc,Educational,0.401355470828901,2,44,194,866,672,57.7226797621982,4612
e5976095-74aa-447e-a02c-a2f490d64274,Commercial,0.9242586130354649,7,30,149,645,496,82.21009393806554,5725
a41a6fa5-2ca7-489e-8083-a88820d71ca4,Residental,0.013339632893191289,47,7,416,1169,753,29.059250599178846,8498
8df59ea0-907d-4abb-9ce3-ceac8318ec80,Educational,0.0019712421765623045,50,32,563,839,276,32.970350314117795,3162
a4c9682c-c307-4c29-9b57-5b2dcf038e0f,Educational,0.3370789886626513,35,32,24,588,564,46.26878919019024,9793
9c3d3a68-649f-48dd-8451-99971b01c471,Commercial,0.15328074821087,24,26,628,1006,378,90.91080094093813,2835
4ecd4a47-2a2c-4424-be0b-eeaa68ab64f9,Educational,0.5337706009646868,43,42,664,1004,340,46.96909338538603,5952
c8d2d674-bcf8-4422-b17a-77487a22dade,Commercial,0.6014578461655223,34,23,633,761,128,60.802418203654184,1038
7937edc9-a833-44e9-843b-e313e589284b,Commercial,0.2490248595490263,21,5,258,885,627,25.544940688456194,1198
9f4b0fb6-09f1-4f35-aa3d-d24f2519928d,Residental,0.8063851014395155,47,32,675,730,55,87.86733563353586,8601
5e596e22-07d2-46f9-91d9-dd0ad503b35a,Commercial,0.8146964729262496,14,42,123,402,279,43.812470360212544,7710
bce3b04c-3d9c-4437-9f46-f067157abc43,Healthcare,0.7318261165180164,24,23,577,1057,480,95.7559562008269,3023
7e66d3cb-7e37-42db-b1ac-7986052d03dc,Residental,0.13232218953585717,20,32,365,771,406,66.96640445189422,9197
d24d6da2-9ef6-4fa9-921f-dd7b7965ac66,Commercial,0.1801012402248462,39,31,538,1388,850,87.9115342671312,1419
ae505122-b7f4-4438-a474-15c1c4a7d7f1,Residental,0.2632928180220131,20,36,458,1272,814,54.3057048530904,9483
64da0451-4358-4c0f-bf68-463e082e66e3,Commercial,0.1631692131046928,43,7,88,346,258,73.70559146128278,6705
8368315a-ef94-4b7f-8f49-09477dcee86b,Commercial,0.1854347420674145,46,30,548,1433,885,22.01450273433467,4596
4ab99ce1-a092-46b9-a389-bc26892a527f,Residental,0.49353761786749617,37,13,280,849,569,77.30889059215339,2523
d4ef9180-d950-49e6-93f9-f6d9cfeb954a,Residental,0.32051272013916055,49,27,520,719,199,65.96875064117151,4971
f88bee5c-af45-4096-adc2-1a99907cbfc5,Educational,0.8255831347249595,27,36,558,1066,508,25.26490387364521,4355
ad73297d-1f19-44d9-a502-59908dad9603,Residental,0.777839623649922,14,28,381,442,61,22.11721203187754,6092
3a43d162-bc22-405d-8668-1c7c0ea55d8b,Commercial,0.10948912547383205,10,16,182,219,37,70.63529113253932,2858
70f361e1-8703-4a7d-86de-388f793536c3,Commercial,0.91948620707423,33,14,500,1049,549,24.506879615316283,2727
5d6450a0-f7c7-4fa9-b1f8-be5d601bf30d,Healthcare,0.21160447743795352,36,43,559,1371,812,91.12954955756214,9461
f17a4309-5ffa-42ed-b1c9-421158158483,Healthcare,0.7334015204209402,8,47,364,1366,1002,59.97536346077282,3743
b8432629-2d58-42f0-95b9-54efe7695cc7,Healthcare,0.14891959652599218,30,29,394,1118,724,72.89595755304914,4738
b1537346-de12-4fcc-aeda-e4421fd760b7,Healthcare,0.17681519948651958,36,11,366,1196,830,44.58175367632287,7116
c9f87ddf-4adb-4679-aa95-ed7ff71eb519,Healthcare,0.8148034114363263,2,46,96,368,272,66.916447237451,1095
8942db8c-df0a-412d-bb5b-f248f3c6c405,Commercial,0.9464100473094995,50,4,40,842,802,91.14583425060447,6338
f956b3d1-2bf6-40e6-88bf-369c2b0eda0c,Healthcare,0.3664498016290507,22,37,643,819,176,88.41925637271589,9941
1021b3c3-c89d-4785-9b2f-d5801f9b01ff,Commercial,0.20184791718975204,25,12,161,599,438,27.790270427258495,4919
67ae10c3-4c1e-474e-ba57-39a5dd6ebfde,Healthcare,0.8729137541423008,19,9,539,977,438,90.06686561951173,3267
d1b8181b-b521-4671-9db0-0b011240e5c6,Commercial,0.345180231265682,14,50,621,1086,465,38.12193644296687,3578
e42a1b8f-4fdc-4a3b-998e-72de2bdcadfe,Healthcare,0.14976628067436193,26,14,619,1323,704,70.58544865002037,8256
f05f2a97-8c62-46a5-bf0d-42f72637442f,Residental,0.7037534538878034,25,39,599,664,65,46.455813008417124,8189
3b8d76a0-8cbb-439b-bba1-b7692c96bcab,Commercial,0.3551188728475967,35,50,333,712,379,38.630836288202985,6657
fbcf92d6-0995-463a-be17-01b44785cfcd,Educational,0.963365106046628,36,4,208,787,579,39.811792890133916,2526
469d358e-4c67-42f5-9a4a-287d928a8adb,Commercial,0.8304823670740484,18,43,516,700,184,24.293876090454404,2110
cc7be515-5bf5-4379-b2d8-5fe9fcfa0736,Residental,0.11583941567545586,23,26,421,606,185,49.79465460677319,5787
4458c71b-717a-44a8-bec2-e35d2575ba7f,Residental,0.2083429945896551,4,9,436,671,235,94.45536450225686,9309
ddba26de-44e5-4ebd-8bd0-53bda793f40b,Residental,0.32342418198036305,20,36,3,395,392,63.29242595486948,1308
f858c1e4-1d3a-499b-8b74-21fda9781938,Educational,0.16741833763140024,31,3,335,1070,735,37.19115681261326,5296
e14dca41-d4f5-4173-b6c9-0dde5db35ed7,Commercial,0.5583655429924668,10,19,565,1352,787,64.69874607660735,2616
15a5ffcd-c001-4d9a-b7a8-fc8ff8e02f51,Educational,0.05792696958831045,45,14,577,1356,779,70.90080841292533,4085
a00025db-e698-4a79-8c56-aa46ed123276,Commercial,0.9778745914398249,9,23,510,1310,800,67.86355225915958,5308
79e2e759-3033-486b-ac42-c643f336123a,Commercial,0.6096296113300739,15,24,179,937,758,81.61402380748122,1258
12463cf0-a832-4907-9d9f-380c25021ef4,Healthcare,0.3962676361023051,32,30,483,945,462,75.43329927226267,6642
cc249b42-8d7d-4fd6-862d-9d4808ef0dc2,Educational,0.27360347127859874,46,17,147,1018,871,50.30358778196046,9966
ff4a6f09-c525-4359-a155-e4fb65e6df5f,Healthcare,0.07818318545428271,41,15,180,1350,1170,32.6549530204724,7143
4e1a1020-47ac-4776-a4b9-b004110b47af,Healthcare,0.5367721412365516,23,21,377,449,72,59.586128432623255,3073
0948ef88-6774-45ef-a214-912f455bc933,Commercial,0.6995872729729191,39,40,97,631,534,72.71460127051918,1759
f5925f09-0925-45f0-8114-f7509d7dcd19,Healthcare,0.9269989584447688,29,10,514,647,133,12.413226347711854,3786
6b946874-1614-4cae-99ac-50312b88ad6b,Healthcare,0.25959644304778773,26,7,620,1098,478,87.00414121612172,3904
d080b574-28c6-403d-8fbf-4486c8d4a333,Educational,0.674737616921564,8,42,187,1043,856,28.80126278278518,1351
a4484b19-ed65-44b6-aa50-e4bd2d635dc6,Educational,0.9263699555218794,8,3,658,837,179,43.91984326039816,7826
e83de62e-4c93-420f-a6db-62440e381b86,Educational,0.4525849605045308,26,27,411,482,71,27.17474891688152,6384
75bedfbc-85ae-4b51-a1cb-d8d638124d8e,Educational,0.34992387694338045,27,47,633,787,154,12.977536608188252,6702
7bdc9b0e-2d83-43ef-8847-8645211e86fc,Healthcare,0.675257665597599,30,16,639,1401,762,44.24293156448059,3393
c1274cfd-eb33-4fa0-822b-21f5af272bb6,Healthcare,0.6878549711056231,21,19,452,1278,826,87.35006302620103,5134
65e6678b-83df-4b73-956a-3a697cc0a44a,Residental,0.9474462479012506,21,46,11,533,522,75.54485003534592,3697
a388f13c-5c97-475f-9263-15b9ac4f3019,Healthcare,0.44927416842899937,26,1,275,1254,979,87.76343186003135,2513
64c66d3b-a632-4a15-9521-3407cddb4327,Commercial,0.6588528665236081,6,44,106,1414,1308,17.493518159185495,7578
99260e0c-051d-49cb-bd12-8ec43c9bc028,Commercial,0.07508437491567754,28,12,332,1298,966,95.58797565529352,4491
3db6397a-a435-4948-9bef-6898e6ec02ee,Healthcare,0.7222363969618851,29,15,187,616,429,38.959363580675316,8978
a62bc852-e6e1-4b57-a1f0-0ee80b908249,Commercial,0.6600385692381638,12,20,435,951,516,78.71995637934403,4473
df5314ac-2079-4412-8273-6e3190c39e59,Educational,0.08462323767309332,17,39,625,1319,694,44.35330406088841,5832
8569d207-f4ee-4c92-8ff3-5fc74f7b8146,Residental,0.9436944793609139,35,14,349,1333,984,81.73454695868521,5866
62d85482-e8e5-42c5-a4d8-9ec947b0a225,Commercial,0.9664636249539994,28,36,57,344,287,79.21492049770018,5209
3c3d6d11-2afb-4dc0-9830-7318bcf5ba84,Residental,0.16455744407125494,47,25,456,1188,732,95.65026551411017,3239
625b2dae-0c36-42ee-a264-d1213cbfd588,Residental,0.05354280768182773,7,41,280,1212,932,32.30850280509249,7061
0a73b9d1-fd86-4cf6-a93c-841fb0e537af,Residental,0.3451260244431287,17,34,423,1177,754,19.05245291527987,2219
0759ab40-0ea7-4444-87c4-9a15b36d7be1,Healthcare,0.6636175118937422,25,31,663,1419,756,99.12754598358725,2301
63d0af32-abdd-400e-b888-25582cf58653,Commercial,0.13198966862383854,44,7,272,1163,891,13.959753628066508,8992
3b42edd0-4f89-4b8c-a51e-b133e9db0125,Commercial,0.8600043101085302,44,5,711,928,217,92.57803341819907,2484
bb70e7de-c276-4910-b95e-b45a4432cfae,Residental,0.03651675360783868,29,43,596,1246,650,93.36114912218937,4029
467ea823-d024-49dc-8899-769522889c5a,Educational,0.8488822117031596,25,47,386,1148,762,95.01380974830457,9554
f4481b03-9ede-4f5a-a578-198c625afbf9,Residental,0.5158309571970671,7,42,652,1172,520,59.588442484606546,7332
a5928a8d-7df5-4422-b43e-caae0efacf45,Residental,0.13529942247592064,10,17,169,174,5,14.7048348322503,2744
c792e8b0-d848-4eae-a83e-baf27a9a21c2,Healthcare,0.682424472906179,22,7,406,1139,733,94.82130500430375,2596
439bcc30-121c-4e04-b514-b92b31f97c5a,Healthcare,0.3494577011717679,32,9,52,1199,1147,85.91688381008682,6213
67bd1f0a-42a6-4940-8e9c-77df4747fee1,Residental,0.12093889983972461,46,34,662,907,245,60.331814475103805,1669
44f35f83-2218-4891-87be-e0d6bdb518c5,Commercial,0.4862863564394374,9,23,629,1391,762,80.12549844910934,1548
7e4543f1-f548-473a-881b-904701ad9119,Educational,0.6986761702302422,25,25,596,1378,782,45.629770820044584,3832
d97d0c7b-6878-4ec8-b020-39820db05ffe,Healthcare,0.7516785730853784,7,25,529,791,262,36.768750850840924,8725
e32a8132-b8ad-4e8e-b904-feaabf2d0b46,Healthcare,0.7953625424522927,50,45,187,1358,1171,80.88859461224746,4005
c65e2628-87be-4e5c-820e-e5bf6ad5b8d4,Educational,0.5340376563675734,28,11,73,141,68,10.802715079579079,2812
6efd6aff-0771-4389-8ed0-69b9403c2d8d,Residental,0.25844405605075793,47,42,567,1249,682,18.920646788056576,3870
f0096472-c24c-4940-91dc-02ec748de713,Commercial,0.30322672600748524,21,17,579,802,223,11.497726522504662,4083
5e663ad3-572f-4bb8-8e1f-097320b65306,Healthcare,0.41976592490945186,21,46,419,625,206,52.11775483462635,6764
8fd7be57-05f7-4e4e-9f51-1412301ced67,Healthcare,0.10504957436810003,35,43,618,814,196,70.78526236083565,3608
a765db8a-76c0-4278-bb7e-486e46449cb1,Commercial,0.4355587333103874,1,34,509,1381,872,92.39391884560247,2298
6f0fc943-1945-4419-8671-8cd511952594,Educational,0.8744648376807217,40,37,38,1186,1148,13.535572658291054,5174
28c615b0-3fbf-4567-be5c-0b3ea73e471f,Residental,0.07903003497410543,31,32,439,494,55,32.30682049641767,6693
63906bfc-e9cc-4ad3-afbc-d6300c515c13,Educational,0.9384990018803847,33,20,380,1034,654,29.02231186911524,1566
7247255c-4866-4817-a628-d9bb96df1805,Commercial,0.08656468525197936,2,7,651,1335,684,67.26018959318668,5223
4c74645f-86d5-425f-91bf-0585b022c813,Educational,0.230257335800084,41,46,281,646,365,98.37535368653079,7546
9fcf5dc0-ea62-4816-a9a2-5d390f6dd851,Educational,0.5806270730179096,13,3,201,1340,1139,16.13406406174324,6934
7a4e844c-fa6d-48b3-a0f2-2d1a336e9f23,Educational,0.25208877628400406,6,2,28,518,490,74.9982848401987,6744
e1c7d480-7261-4cb9-ba5d-61147f332739,Educational,0.019387417038418397,12,36,100,269,169,54.76250274290943,5691
d85e8542-f461-4433-aa30-63821641036c,Commercial,0.9191239651678872,38,22,543,931,388,45.09893509543232,9029
26e4666d-be86-4149-b906-73fc2ba0db99,Commercial,0.988307566969414,41,5,582,810,228,38.48342342257163,3368
d2b68849-9353-499c-bd98-cc6a493d68de,Healthcare,0.12449435827988098,7,36,154,196,42,38.6487738148175,8908
97e4387f-f76d-4e38-96ef-eb74fedb6a35,Healthcare,0.9136811751628158,33,3,443,992,549,29.026570486181846,1315
190a8b41-a562-4ead-8ec3-31c42c1f4bc6,Commercial,0.5942736509796129,46,24,339,951,612,62.890259080310784,9650
8c0d80d9-81ed-40cc-a025-2f11e364b40e,Commercial,0.4094193438659933,12,20,443,509,66,38.41414337776621,4172
9c84879e-7e17-4f68-949f-6d3f46c917dd,Educational,0.012033912409530112,18,43,602,1209,607,38.35322397653175,7439
25ccb5f3-3b74-4037-a95d-c40e9dcc00c8,Commercial,0.9293203434744767,31,45,715,1128,413,50.0661019785712,8100
5c3bb55d-d81a-4646-9325-cab65fa690b2,Educational,0.3764176645809537,6,26,9,1341,1332,50.51629513671115,5014
f8a53d0c-4247-446a-9d9f-be9cc83a7191,Commercial,0.921726826858234,44,17,173,436,263,17.793073832636956,8702
41098405-5cc2-4aa1-8bfc-347cdf881a01,Commercial,0.1599016147666824,21,18,142,296,154,26.452451583105265,7833
ae177f09-325d-4b09-abe9-bd82173d6cfc,Residental,0.580922880706306,15,47,482,821,339,54.84831255983957,1439
afc730b9-a437-46df-aa29-d8cde638188e,Commercial,0.5955038452908981,1,40,290,568,278,60.572279025916366,1448
1cf6eda9-e2e5-4094-a1b8-a087adfd2ff2,Commercial,0.9855163307605714,28,17,521,621,100,67.65086332606279,2838
9f107e03-6c43-41d8-a984-3682f0730b92,Commercial,0.12585122406340854,24,22,386,1118,732,31.18914042789103,4411
0629cbed-2556-4eb0-b24f-39396a40c6db,Commercial,0.6973012316272575,22,14,179,795,616,59.46184488958689,6927
1614aae5-ff0f-4767-baa9-88a247811add,Residental,0.9688518728350232,8,21,560,1090,530,38.56774229070514,4424
04646776-f4e9-443f-a3c8-c514097d68a6,Healthcare,0.36799445157255106,16,23,197,715,518,87.57849150038923,6004
d25c3016-f5b9-40aa-8e4e-6d0835f4ca00,Healthcare,0.005813880235921665,40,30,479,503,24,41.18013293371622,1860
de155a8f-e832-4f5f-bfec-aa281d337a1a,Residental,0.8880677948222606,12,41,96,1421,1325,26.204520233591047,8039
858ecc5c-c47a-4c4b-98f8-18087088d6ed,Commercial,0.2701555488557861,29,25,233,950,717,77.08672285213255,4192
b94c9acf-3239-4c30-a260-68ce66d8b4f1,Educational,0.007783931543525524,37,14,702,1270,568,31.084298836923182,8520
3ac2609a-f38d-4917-9d29-a4f406c25356,Educational,0.4595015649547074,39,17,167,734,567,69.97859097743441,3489
2c5b9d1a-fb48-45f9-9e22-51096538914b,Educational,0.7919724824143877,50,23,499,858,359,51.75515042908988,7776
8281ad01-dba5-4c91-961d-67cdcacf7922,Residental,0.3530935343747824,35,49,314,826,512,43.031229980944794,9067
b1260599-96a8-426b-b7d8-cb8a1389e422,Commercial,0.1733447136311751,17,38,547,873,326,30.233750835817705,6807
a6e82fbb-e50a-41c1-a33d-422dc20cc8b8,Commercial,0.7822984789487775,16,49,671,721,50,18.436335985336843,6876
ba4dff1f-3401-4176-91aa-1211f406a01f,Residental,0.5365199737686426,2,33,258,820,562,38.57703890798625,3632
7d70f3d2-3fcb-4179-9af2-c28b893d7aea,Commercial,0.2803069090124234,35,42,236,1424,1188,51.2211170417537,7091
31d9dbb6-ee60-43a1-965b-224c45f5b9cb,Healthcare,0.9504080086232909,16,26,142,1208,1066,38.355952635734305,7567
533f9a76-5292-4b08-ad38-a8e3729fa6a5,Residental,0.7125017262710186,50,3,565,885,320,52.025895133602916,3467
bf22b66e-0022-4a69-84ee-00c6d3be8474,Healthcare,0.18354801635897566,26,45,156,915,759,68.40544962882294,5937
a7248ef3-3d0c-48a8-84cf-8fe5a1f752c0,Educational,0.23494246401371788,18,25,537,1178,641,11.141812629504269,6254
e979f839-c32e-4e57-a5ae-75e408ef5332,Residental,0.744042134564338,36,8,704,730,26,46.258759079557215,7541
610d188f-4203-4f09-9245-9bce50f3ea96,Healthcare,0.2079802623954221,50,29,570,1348,778,66.63002356354949,2527
e8495bef-076a-43a6-84c8-575577d9a2b0,Healthcare,0.6374982576561972,17,11,32,1251,1219,70.29281327854932,3548
18b746c6-d41d-4418-aa18-8c287c125e4e,Residental,0.2660670688986153,3,5,178,808,630,51.55572192540127,9121
6db51c02-1583-48c9-b396-88ef7c7ebabc,Residental,0.5639987189092862,48,37,483,1072,589,48.89589034975801,8283
87121019-4571-437c-8a58-6b346f9365c0,Educational,0.8687406145810419,44,3,465,723,258,71.86566635548499,7259
95026e35-4dac-43a4-8ef2-6f6bb6a2d173,Residental,0.8378609323589994,43,1,365,851,486,17.248060916471466,8458
42760708-1986-4fe8-b339-522b222100a4,Commercial,0.5861253807195961,15,21,443,446,3,88.61487028687581,9623
29df2284-fee5-46d6-9da7-fb6ed66f867f,Commercial,0.8774479988252849,10,45,30,296,266,81.46259891013968,4903
8c3a72d7-a1f8-430d-8dac-0fcf163038e9,Educational,0.6660245595642456,27,5,253,955,702,95.80894938921519,5465
98d94cc3-3fcb-4ad1-92ff-920082645019,Educational,0.5949605182205147,9,11,661,1375,714,26.49032319847118,7334
3364a032-2356-471e-b390-25cb0c4b66d3,Educational,0.5358283622148925,48,38,462,859,397,35.62458872615383,3337
c8f36364-0061-4699-a0eb-d28870f8ddd9,Educational,0.6144517939084794,39,1,258,1003,745,30.080126567235574,4614
18056a11-bf00-4148-a22d-e24ea3de80b0,Commercial,0.8543535064375029,2,1,352,358,6,45.89411690999731,8122
4aa11da2-4ae8-47bc-9fc7-8d4bd5d332d8,Commercial,0.992448388551999,22,8,137,945,808,33.58869196771753,2218
890cc2ba-e8fe-48ed-b368-74d64bd6ee25,Educational,0.48265133211160105,45,38,627,1044,417,13.129466178491795,4506
97561a84-dc58-4488-b445-6dc8a65b0afa,Educational,0.30294706018139794,29,41,6,281,275,12.328781142526086,6904
21b427de-1bf5-46bd-b907-2dce87b3edb0,Commercial,0.6247104611050661,45,17,173,738,565,53.75497472558339,6271
770b3f34-6bd3-471a-8a4e-98b2df0b7b0c,Healthcare,0.6129370721394679,48,3,119,492,373,69.57927325959074,1159
74765da4-c2c0-4569-b016-0ab2b27efef3,Educational,0.7518293338609946,32,29,168,1272,1104,91.03909765528596,7976
87358631-83ed-49ff-8f11-3736959c7624,Educational,0.1561092691442657,44,37,695,1318,623,33.62644832997526,7456
f48d427c-92aa-4ea3-970d-d33261fc7723,Commercial,0.8939973651997238,18,35,478,875,397,64.3572020247137,3871
31466b05-2131-4de8-af77-b1d221c3b963,Commercial,0.4359384507830627,35,7,438,743,305,47.19723910753334,1740
2178b962-dc3d-499e-952c-07104fc39b46,Healthcare,0.9481011793114084,37,36,212,239,27,63.0167274710714,6075
b2a5e3ef-e286-43a8-9046-f29e38b4aa90,Commercial,0.500176744755595,8,14,43,1331,1288,56.41196121724657,6353
01b8195f-975c-437d-a734-7df893ecd513,Residental,0.12590932145500988,25,9,333,660,327,13.686617634396933,9238
2c3ad326-afae-4a6f-8760-1f3970e89ee8,Commercial,0.49450510594830266,13,33,544,558,14,60.95533358608979,4435
3b7e5b3d-65ea-4f3d-8d95-4bcb32bf7ff9,Educational,0.16497877525376303,46,22,191,1072,881,28.238695195017108,5299
6d6b7017-6543-4112-9b46-9533152780c2,Residental,0.8757995172093532,7,19,704,1432,728,39.04652569282316,9208
d07ef289-4c6d-415d-8905-d2c7fdc2a5ed,Commercial,0.3956368408177807,35,29,171,289,118,76.38219331064977,8741
c2ad2069-985a-4ad1-ae61-9543cd5ae9d2,Commercial,0.7555094511350702,10,18,13,296,283,11.79402659620674,7789
08b05b05-0dd1-490d-9ffc-87a5ca400584,Commercial,0.6507720473003371,13,31,632,1057,425,93.07621437546105,2789
df062f9c-52f6-41f9-a134-68cd0a2695cf,Commercial,0.9073435517222354,9,50,560,698,138,83.31801740655493,5616
1b5d0ab0-7832-4c86-9ddb-566be3445932,Commercial,0.04631149158709558,7,2,522,711,189,54.975708810593574,7061
ca765d4e-6c38-4dd8-825e-60160e9ce7ef,Healthcare,0.1505070517091679,26,32,94,133,39,64.77665483747839,1654
244d0a07-713e-4ccd-85e3-aa5ad9caab7a,Healthcare,0.6123791444063664,18,1,114,414,300,20.249247500032524,9644
48f296ea-bf20-45fa-8d40-b3e21957dd19,Residental,0.0018416037418989006,9,36,518,1345,827,15.54623675633158,2671
da68e3c5-84d7-42ce-877d-eeb3e4ea4c4f,Healthcare,0.2358930991900693,31,26,553,1365,812,38.8102842955315,4150
bcbb4560-a8df-4884-ae9f-2b43423abbf7,Residental,0.18095523257457946,50,49,249,587,338,79.12214102561056,9843
5cdd93b7-95bb-4c83-b321-b31134edc95a,Healthcare,0.0469229580906414,46,13,195,1253,1058,16.62669733090914,1221
3207dd21-4ab1-40f3-9e01-6482202eccf6,Commercial,0.3879871589103704,9,8,337,671,334,57.69663197769238,7176
0a2b05dc-2215-415d-9697-5c700a218c07,Residental,0.5071551720736844,26,14,190,1440,1250,43.68269518545719,9750
0c1e8e9e-9f25-4fde-be31-85b01165c736,Educational,0.5985352635759709,13,48,229,825,596,35.302394900484074,9223
922aa779-bed8-4131-8d0e-07de2604faae,Educational,0.08193807547527487,3,49,275,618,343,41.601773450983714,3669
e3bb586a-702f-4423-aa11-8038063bf3f8,Educational,0.7102748758564449,1,49,481,1156,675,13.140264124315825,8302
d50f872d-b9cb-461b-ba76-ffd24b4bb90b,Commercial,0.8986854725405856,11,31,374,672,298,30.07387287972177,1559
d17ee05d-d396-4f19-94c8-a81fae5bdd01,Residental,0.7387162463570294,3,24,8,191,183,36.67255230487148,5251
d12c34b7-3ed4-4968-a80c-604859d10513,Educational,0.3317562546404549,10,12,159,555,396,31.277902585142236,4165
d05b7cb8-43bd-423e-9fe6-09f793bd5aae,Healthcare,0.2583734284002459,16,8,330,766,436,72.14218829089836,5888
1df744fe-1616-4c95-98cb-76259d142bee,Educational,0.907274586988171,14,44,30,777,747,31.49436812025836,1382
e0088654-6d49-4056-ac3b-5f934f293692,Residental,0.8935174507991921,4,13,97,570,473,44.50223849087055,2281
71e03184-7dcf-493b-a84b-172cc2201daa,Healthcare,0.465894026777686,30,21,572,780,208,70.88019584645556,9145
e2b5a027-333e-43b3-8ac1-01c3cfb11f22,Residental,0.11340628931140317,43,43,238,591,353,99.67047447422809,5095
788d6841-4b91-47f8-ac24-6d9b1604271e,Healthcare,0.6019242900777264,20,23,110,562,452,87.64027635821414,1798
17ab45eb-6550-4b61-b76d-f6f711ab974b,Educational,0.45748454290835927,19,42,662,1269,607,72.24566384609011,2663
1c2aa423-5ab4-4e13-b90b-9e5a49b5e448,Healthcare,0.4201269286184064,14,15,359,785,426,97.2308756134348,6707
ecff1c93-0598-4939-90be-7edb5d9df67a,Educational,0.3126103534868787,28,46,533,825,292,72.49438813939355,7240
24173fe1-d83a-48b7-b8f2-42117ccc902e,Commercial,0.8664412112772748,2,18,110,1206,1096,30.549619291570924,8872
5a5b1e31-3b3c-46ef-9eaf-3604cb3a32de,Commercial,0.06997585552839225,4,41,458,633,175,64.44422543730445,6783
afc8038f-722e-4f08-807d-c2504bcba8c4,Residental,0.40777438285798107,33,17,674,1146,472,72.6737967298224,5119
a4ab02e7-b07c-44ee-99f7-7eeda1fad01d,Residental,0.1889526680036564,37,4,671,999,328,25.37364338281204,8631
788110d0-6ce5-45aa-ba34-452774672c0d,Residental,0.9386220182521807,45,48,640,1334,694,46.0592274260289,2589
073243e6-e6df-40a2-97a3-a962d844617f,Residental,0.36469511354493456,34,4,261,1369,1108,21.17510612599446,3539
8c4a59f1-bc61-4922-85b7-21f742ecdc67,Healthcare,0.24880589036649237,10,35,600,964,364,98.53453557656175,7464
3edd419c-cfa5-4350-817d-c6017d329a67,Educational,0.7882572270217928,3,49,148,882,734,16.933260369086607,9264
f3af40b1-564b-427c-99db-d689b0248a11,Healthcare,0.8224539880771518,16,10,581,1190,609,11.228561764941215,7850
921f1a65-c9c1-4e58-97bd-c70fb25949db,Healthcare,0.07018607176185687,50,7,633,1414,781,69.57346877488155,3344
01bb2de2-2d51-45fd-803b-64d00e847c7c,Educational,0.887360999222349,22,24,276,1106,830,45.57047166296228,3424
ca0e318d-c5f1-4412-af53-dff1fd8b1bf2,Educational,0.9160395822929835,38,44,453,597,144,51.650850468135175,8788
00350bab-c1ad-4b5a-aadd-5ac3979d2a13,Commercial,0.6652394037189941,11,38,139,1297,1158,35.960420764495865,7131
7a7edf18-87c7-4355-b363-ea46750b40bc,Educational,0.386020880633584,17,23,344,1332,988,89.06525068605193,8603
c63e5ca5-e3ed-463f-bf85-a35eff72ea41,Educational,0.22747691157839367,42,16,644,799,155,25.475231057414753,5524
163ec34b-3c07-4cfb-95c2-871432844d40,Commercial,0.04725817167588242,8,21,191,983,792,89.24165054348819,3207
1693736c-4a93-4cc3-99a2-8c9c2a46523b,Healthcare,0.45537406281552595,40,13,567,1105,538,30.18554341747576,5552
9c9536cf-6f74-49d3-b05c-3942b91721e2,Residental,0.35153501028887013,33,50,496,1105,609,70.76418421689411,3359
33e40c26-7993-4374-be37-ca8d4cf02eed,Educational,0.008298512162686178,20,8,9,86,77,12.160153211393183,6665
bf0dd424-dfd4-41e6-a641-0009ee98e949,Residental,0.27131081151499237,13,13,231,394,163,71.81298632164061,3580
f314763f-2a34-475d-aa4a-c4226c61a1ad,Commercial,0.7785778442572308,14,40,699,1283,584,46.31405592367286,9593
71eaabfb-b334-4e7e-8129-c645194426ce,Educational,0.26217715491548566,26,7,541,1204,663,80.23126782756432,3941
c97b32c4-5b3e-40ad-86b8-d8a7ce21a1a8,Commercial,0.8300576037462287,5,6,120,219,99,67.11862676622808,3893
ea558017-f9fc-413a-a073-07f7bed551bb,Commercial,0.4584705631025281,18,28,515,595,80,80.77418583379207,2974
a7d4abdd-10b8-4689-bc56-86a0a4b94d56,Healthcare,0.1861018718005324,9,4,145,1299,1154,22.36252319446972,4829
854b5c4c-38bd-41cd-9e0f-e71bf2828cc0,Healthcare,0.43571367956092566,40,33,427,535,108,43.25377501756825,4378
39e4a3a9-987f-40b5-b171-f8427fe11e80,Healthcare,0.3185618602280228,19,37,623,729,106,59.668903505881886,7573
597b930d-4d0d-45e3-90be-65cbf337a542,Healthcare,0.16383385478437695,49,50,409,926,517,21.668036048850645,4446
91f345aa-6892-46dc-989c-c5caee9d89c4,Commercial,0.703405851760069,46,19,425,752,327,83.56644859999777,9338
4d0e2e2a-3b07-4c09-951b-0d38404a20d0,Commercial,0.7894937475455842,4,36,672,1278,606,98.06575568055939,1494
54555e58-8a83-4d32-8adf-3e12dd8176f6,Educational,0.9138982603371547,24,39,621,1077,456,12.60718934142772,6554
dcf216e0-e306-40d0-8cb0-0e4e82622b69,Educational,0.5395601319329131,7,34,611,1067,456,52.68394307123876,4316
0f53b70b-0077-4c16-a7b0-e0162d0c50fc,Residental,0.3550119861371095,40,45,683,1377,694,52.2079714050267,2788
1e213959-71ea-4ba2-9f95-fccecaa81ee1,Healthcare,0.23704835581806893,17,38,627,974,347,88.55902232584938,6913
21ac6c38-8072-4b58-80a5-8891cdf6951a,Educational,0.2728661971361376,10,49,24,1171,1147,67.67568214274712,2284
bce40646-2e14-49f3-a1f4-e724ad43ef11,Commercial,0.5037821682659165,31,11,196,662,466,14.935435500296451,2788
93f8049c-b58d-4be6-a56f-99af86bb028b,Residental,0.9373249870705991,37,34,232,412,180,15.106231204078519,6628
e342a7ef-1ddf-4e7f-b7de-255b2f9b9539,Healthcare,0.8753816593096955,9,41,313,616,303,70.45893029851723,7356
96d5f59b-bb39-462e-b2fb-cdc1b40b444e,Residental,0.847235048696817,21,45,181,953,772,91.66634013206081,9312
5c1727bd-7cb9-48ca-b5b3-0371e74e004c,Educational,0.5946509644158366,49,29,43,267,224,34.52403464619263,3241
eb7db910-3f64-4ce6-be97-4e486c11fba4,Educational,0.39152937226640494,15,45,647,1108,461,24.512429215517095,6637
4bda172e-699a-4265-b603-dc6a0123195e,Educational,0.887966690923276,38,22,704,951,247,33.94938240445783,5523
6d4fe749-8166-45ca-a5a8-945aa5b9cd3a,Commercial,0.4564290953992295,28,39,41,751,710,75.26721038201286,3205
fa722462-69ba-4c7a-8f7d-ceccc644d93c,Educational,0.0122930188700906,19,25,340,513,173,52.43955674709694,6609
be417a88-bdb7-4c3b-a058-e06634a95afb,Residental,0.15672023001400004,29,6,581,699,118,15.440885820300998,2034
9311bca2-a4c0-4a98-af5d-63e20c34880e,Educational,0.2968549691902065,6,27,83,450,367,45.47713528326747,2356
ac1f6871-d7be-4e7f-9eb7-60aca10405f8,Educational,0.7338131465491659,32,16,611,1194,583,17.952955955739753,2646
d60959b7-8582-4f36-bdb7-1f8f179f8563,Educational,0.8671899923279511,44,35,208,672,464,66.60360553111784,2875
4c8ef9d7-5026-4195-a81e-05788a1261f4,Educational,0.7174435292567429,42,8,689,881,192,51.80129443848356,8287
0d566028-1d19-4466-9095-306414eeaa80,Commercial,0.7729939834541448,4,32,358,888,530,29.70576438129813,1555
cef44b7d-9dbe-4539-976e-60d4c148dbb3,Educational,0.42401528723678306,1,31,266,1207,941,56.279699329446686,7463
8c95f890-fc6c-48ee-bf9f-3a13d1e7fdfe,Residental,0.6616416755122525,26,27,544,704,160,91.78446772439607,9943
fcfe549e-bdd4-4b20-84c5-4b609e350769,Residental,0.16478182407355813,46,16,716,984,268,79.41107844440506,8962
425b641d-615d-4e61-a148-9c0347d8d440,Educational,0.20967197858358622,13,44,703,1298,595,21.423977727060898,1326
7a1de590-b58b-41a3-b13e-55ad1ba0ba14,Healthcare,0.0476953366668843,13,44,512,1258,746,66.60433804707424,6947
755b0956-db12-48b5-85ed-46a54fedf677,Educational,0.9238767875369636,34,38,345,705,360,37.106526779938974,8171
e0e53e34-08f6-461a-907c-e1b20888a6d2,Residental,0.8665354176809997,6,44,444,537,93,68.53264554155822,6407
da4b333a-9a78-464c-be1d-e0720ea9c2e9,Educational,0.24900160473646082,29,16,37,94,57,48.300751219015694,5604
95b32061-c8d8-4e7e-a013-5c3df8de671f,Commercial,0.4677459140362853,44,12,448,1106,658,91.75873720997265,5582
42c42124-d86b-4a2f-827a-7beed6514bdf,Commercial,0.24884422923344995,8,15,103,1330,1227,59.18654953008272,5094
cce19948-04a0-4040-a8f0-0e1a0a2eda72,Residental,0.16076270719854624,20,9,245,838,593,27.4351742711662,3388
4067d74a-9a61-4cc6-b105-37b12e480f30,Residental,0.2501968780978413,1,25,147,466,319,53.9641057966468,6145
a686456c-7d87-4908-a458-a7250a3a7f5b,Residental,0.6159729012125571,36,37,657,1049,392,79.22152220067022,3668
0f57880e-230d-47fa-87e3-eaf1cf2df2d1,Residental,0.4045510873387662,19,32,397,811,414,69.09314096854561,1465
825dccfd-eceb-441c-a517-2c2056ac6831,Residental,0.08940505295526369,9,39,59,475,416,19.004633261912762,7246
d267b43d-05e1-4141-b548-b481a85a8265,Educational,0.12177778062254208,9,5,468,732,264,79.79893764034455,4097
7aea71ab-70c3-437a-8c3c-8156756d03e4,Educational,0.4793098956138161,30,37,214,644,430,85.9845205299265,8491
cd33f8be-971e-447b-bbfa-c8e05ecd510a,Educational,0.3443656470565506,33,30,513,628,115,88.092568495621,1675
fab32113-7cc0-4cda-8a83-8da26ff18a9a,Educational,0.436663460181704,14,5,457,511,54,81.36314605547012,1973
656a41e3-470f-47fe-be8b-119d83cc2253,Residental,0.3917714587760349,16,50,449,1273,824,37.55349610357575,5100
6aa9b726-2331-4af1-9c5a-0fa21a455d62,Healthcare,0.3933835615814051,35,20,679,1226,547,80.12740633069109,3348
ad9ce056-ec58-4723-a99f-2326e169567f,Educational,0.02194232154954634,10,39,712,787,75,13.802564246883604,3584
300270f5-ead3-4068-bfaf-8316eab3ccce,Residental,0.2645009496743972,43,13,668,1004,336,21.312407462754486,8139
0cf46a53-d505-4965-8a4d-b33eb160ef30,Residental,0.06512655841574344,28,10,373,764,391,86.20226819126009,7446
2f212947-ae95-4078-bfd8-6b906b3a370f,Educational,0.44075991364310574,1,38,579,1225,646,78.37750733569517,5057
cbff337f-56a8-4044-8849-da3336895b79,Healthcare,0.5816110529633385,27,39,634,1058,424,67.65016299047927,4410
3a17b136-6d5e-42de-8c02-f47dd819a94e,Educational,0.6312701369793039,33,37,186,339,153,99.70938114114146,1072
1aa24516-bda2-406d-8d12-475573946837,Healthcare,0.43193185198641826,30,40,623,761,138,51.04581014214368,1935
9d1a438e-bb23-4818-b09d-ae89fc91923c,Residental,0.9591301398526031,18,8,382,990,608,28.561545081219514,6900
5b7e293d-3d73-459e-bb10-5dcc2bc1444a,Residental,0.3600006017606484,37,14,250,748,498,37.12689843583088,9777
14513023-6885-472d-9608-92e6479e531f,Residental,0.3761955056109103,27,23,521,631,110,88.62275398533139,2441
f6517684-a5f3-439e-92ee-f737715d9b57,Educational,0.18680645176603572,48,41,296,969,673,45.792877615749724,4269
6d683255-4aee-4ecc-a694-00498e4abd3e,Healthcare,0.330534242710089,30,35,347,1056,709,19.64979491584579,6671
c2b221a2-8d39-47f9-8d62-8aad60da3554,Educational,0.8428986379018552,44,33,623,840,217,27.996163641622363,5791
6ab68ecc-52b2-41c4-ad65-7a72e340cf6e,Educational,0.5343091646907783,41,14,377,401,24,78.68200028572586,9390
acab8987-1ff9-44d1-b212-1ff271a85bef,Healthcare,0.332820270871802,3,2,569,1164,595,88.46231089200299,9441
45a2be0c-5fea-4aed-9169-5c12c4ecf674,Healthcare,0.3897191015192333,8,35,502,1086,584,32.19145007024252,3884
506ab4c6-1654-4eaf-b399-a5f6e203d3a6,Healthcare,0.2763851017809529,2,46,393,1385,992,95.2595881455096,9266
9b5dd605-4cda-4b55-bb32-10b2a6d535b8,Educational,0.8853733446670182,24,50,647,1351,704,40.678949563025625,7776
5ec61306-613d-4167-aee2-d5328519ed4a,Residental,0.14688601449006244,45,8,632,826,194,75.20245792747873,9257
7dc181da-ced0-4c79-bd93-f102e7c77341,Healthcare,0.3248331971025247,43,50,437,783,346,85.17009302961593,9787
1698df70-b9c3-4da7-b064-0d640c9a74a9,Healthcare,0.13239505261611406,11,26,715,727,12,96.37999401521743,5587
1f996cb7-41b4-4345-bb59-566b42e50794,Residental,0.5341663388192994,35,27,38,420,382,26.9517911028841,6825
b213d9f0-10c9-412a-801e-f0cc487a22e3,Healthcare,0.7493577869341712,35,43,84,858,774,95.13595749815815,9052
69c7d6b1-af1b-4e4d-a779-49539f50e44d,Residental,0.134577765596823,39,42,30,1430,1400,39.2690817927438,7301
ae73262b-c699-4cc7-a157-80e57c9687f7,Healthcare,0.2746488757586487,20,19,562,1050,488,28.1336093269449,4277
715be27a-6561-4ee7-bd08-efc8964f535f,Healthcare,0.6990704425558847,29,44,83,1102,1019,91.864882445747,1616
fe4d50a8-de6b-40a5-83ef-98ec6eacc648,Commercial,0.2828531738785862,13,30,64,486,422,30.704041104650067,8369
523eb838-a11e-41b3-a680-34281cdcc5ed,Educational,0.37823396677078347,7,31,270,1234,964,85.87979416462643,3550
913ae7b1-3447-4489-adaf-58a45368d30b,Commercial,0.13866798456250518,1,35,457,736,279,26.947239567694606,6940
1dc52366-8c68-4faf-aa6f-62e23756daa1,Residental,0.728403696040664,19,49,21,1020,999,64.45748124987514,2490
232b4e4e-3512-4d9c-a6cc-26d06aacd625,Healthcare,0.33402176584566545,8,16,232,1283,1051,94.6162145176128,9202
272485a2-e3d5-4f7b-bde5-c4f56a1a84ba,Residental,0.6195628157953382,8,10,267,854,587,49.56644944738305,6114
76bb649e-f877-4ee2-954b-92a0a12bbdd7,Educational,0.2127957731577227,23,44,531,979,448,55.56994915594937,5902
e39749f9-c5d8-456e-ae5c-646798294b38,Commercial,0.4162502267136895,23,16,61,877,816,25.186985256119897,3477
5fc67e01-1cd8-4336-bc03-e73cacf06b86,Healthcare,0.49526078922959516,11,11,568,686,118,74.73582846526764,7151
58880352-1048-4b09-96e0-953edce033aa,Residental,0.1597329077869959,11,35,464,1282,818,96.16336961404338,2909
355cbb56-7a20-4ff1-9960-3058f0b477e5,Residental,0.360206112335414,8,14,255,1298,1043,77.7551038847859,7615
d86f6c10-e5d5-42f4-8c00-f590be9710b4,Healthcare,0.07037461767330067,35,12,396,1277,881,17.726887202204267,8676
898e8e4d-d71c-4f56-89e1-a5dd3b1559d7,Healthcare,0.7181430783139661,36,25,428,768,340,72.93316836190743,3042
8174f95f-5924-4315-96b8-749a881e6c76,Healthcare,0.5349628208547501,40,1,370,768,398,20.576557936009095,9662
1ecc5db5-5daf-488a-b113-1485f551f7f5,Residental,0.4616365854457871,46,38,654,974,320,95.01691404414842,6140
22732467-4095-4cbe-a532-bacce85c5cb7,Commercial,0.6569452301305116,50,33,467,1231,764,52.98256515108843,3047
e7d03693-9300-4125-90f6-87c483b0eb19,Educational,0.9590983176334288,15,45,108,569,461,41.622905257641406,5438
c78d880f-68a9-478d-9815-0100837875ce,Educational,0.9557395518251863,30,33,678,1190,512,96.96362356494724,1433
58a5494c-669d-4228-b878-aa28db297913,Healthcare,0.9959386882450643,10,20,627,785,158,83.46670309622247,5857
905a0192-3074-428d-af57-8d668c9ef199,Commercial,0.9627549312966789,22,29,598,1374,776,12.43156780658482,5828
5068eace-57f2-4b4e-851e-3a1b6ff53c3b,Healthcare,0.3697604460369913,41,14,503,752,249,86.22754808955233,4154
c373089c-bcea-414d-b944-8d9fd559b263,Residental,0.1126661861836481,36,4,560,1144,584,67.19093603817,9385
5afd7ba2-9bcb-4f57-80a7-d1dab33948e3,Residental,0.9698907769441923,35,33,549,837,288,54.42402859979819,7872
d74e0a07-f420-4305-b5ac-1dee140b8dfd,Healthcare,0.3485649733656223,20,20,374,847,473,62.70860330650486,4989
bcaf1042-65d7-40d5-ad3f-4328b5215e86,Educational,0.11544684150592088,8,16,283,403,120,60.10853202221966,9658
6c7a15c6-329a-432d-8512-b77165034eb6,Educational,0.41921960603882147,28,31,304,1277,973,76.3592228403644,4130
8330e0a7-7b2c-4d85-9b01-881bf06be4c0,Commercial,0.9474575390259832,39,26,246,920,674,47.81865017753443,1246
c195e329-2a04-42ec-bb08-224746a1c7d9,Commercial,0.6646767846229025,14,38,609,655,46,19.129447822372818,2211
17215cab-3465-43eb-b03c-b67799bc2209,Commercial,0.5006388145238471,16,43,550,660,110,91.47786016774069,3597
fe9e71f1-95b6-4d15-9839-99c78c32fd91,Educational,0.48130960737812767,31,33,172,1137,965,31.134748293053246,8486
9f8f54a6-48ea-4bf4-a315-dd914cfa7e10,Commercial,0.6195756362611762,26,6,41,251,210,25.07228775440577,5700
d0bb3b31-c341-4499-94c2-97259cbbd9c0,Residental,0.1726627964964894,7,46,211,912,701,39.215041731170075,6316
6c496f99-86fd-43d1-9657-611c4fdb8e3e,Residental,0.09513460797863582,33,3,697,743,46,25.381081346991028,9177
01a69d87-7bd8-4c32-9e05-d860d495c2de,Educational,0.26069837943846863,48,6,346,1342,996,86.98757829734656,1920
90c35308-3cff-47b5-90be-b750142fc619,Commercial,0.6432725581139769,12,35,174,493,319,30.9499490871118,1582
9ee73d5d-d4b1-493b-9eff-9a409d22132f,Healthcare,0.12673244921712978,21,31,28,1112,1084,25.631334473261603,6716
cf1dfe1a-fb19-43df-98bf-c5634ae2af2e,Educational,0.8525863234269986,33,1,95,1278,1183,85.90045115438136,2850
c3943f9d-b1cd-4e01-b17f-d856b9d95872,Healthcare,0.15442635396968718,16,31,343,448,105,36.20690037530436,2556
0414b35d-da29-4725-bb4f-ac424df3e878,Residental,0.32960423773551795,9,13,121,585,464,55.875570351442825,7305
f552c29b-ead3-4f7e-bf1f-4abe15b49d79,Healthcare,0.7968324884570684,2,20,135,366,231,75.71825337314668,8182
3a258b36-2903-4fe9-88a7-6cb64e85987d,Healthcare,0.30811038471053254,8,36,612,1243,631,71.06523753248752,9766
c9c6efe6-2b36-4ad5-8dcc-a5461badf51d,Residental,0.3213666588164408,34,14,79,388,309,65.01356243527286,6348
ce80c8db-623b-48e6-96ee-83628601c54f,Healthcare,0.4601205699155807,27,49,269,405,136,56.03540580025718,3244
2e24b7ab-80ba-43ab-93d7-ee5cb44d5a1f,Commercial,0.006307123569772366,23,27,184,394,210,39.135053290336366,5835
29939573-8b7b-41d2-b52c-57489e808326,Commercial,0.13976186115844957,39,11,653,818,165,50.54662931254998,4334
767f5baf-5250-4be1-92cf-ec9cc326dd0e,Healthcare,0.31436582765033505,17,43,407,1288,881,76.7401463210366,5031
3e7ed387-40ea-4848-bec4-b17515565889,Healthcare,0.682674249728413,15,1,565,860,295,33.24236520620861,2996
0d999400-14d9-4f9d-9834-4ce8f875c769,Commercial,0.5692307542008984,16,22,235,390,155,18.069011218521084,4492
e0778cff-1391-4996-b085-52d287d6abb0,Commercial,0.18416030419656948,29,22,482,605,123,81.17023553194345,3835
0773c176-8ad0-4067-8cd6-8af912107ecb,Residental,0.48200693289874075,21,7,440,1185,745,77.86809913983289,2103
e4bac20f-eb69-424a-9f6b-a7ff44a78bcc,Commercial,0.19914009203293803,9,27,77,1233,1156,53.10676992245741,4797
d4aabda9-f40d-4327-ba61-c5f365726988,Healthcare,0.5736783753034139,16,2,116,988,872,56.222553103619006,8952
9386d5ea-82ab-4414-928b-db9d5a8dc00d,Healthcare,0.2507991373856795,43,29,146,1182,1036,65.10215566540097,7548
d1c88a64-e8b5-479f-8a8a-fab44d4d1d44,Residental,0.6579532017698491,20,41,80,1297,1217,56.137709768455935,2342
ed3f222a-3176-4086-bca6-d449cb64739e,Commercial,0.49463782106141685,9,8,651,720,69,22.357433025948577,2872
9c3f8824-3812-429a-8be3-ccec15a8ad8b,Healthcare,0.04946572399729565,13,16,601,1077,476,38.53154023639745,5750
8a7c350f-dbc4-425f-8dc6-6af59e7bf2db,Educational,0.15028346632656775,13,32,274,907,633,21.791885930017564,5554
6dde353b-859b-4251-9909-c655f364baea,Educational,0.24627338647975217,4,22,480,949,469,24.299429347747967,1593
d76afea2-09e5-432e-a1fc-031b3c24a0ed,Residental,0.8572144632573787,47,17,608,1378,770,12.779035099338985,8232
5dad04b9-d3de-48b9-a166-0b323afe23c0,Residental,0.8643012847352978,18,14,342,1335,993,91.720824924491,3200
59e24331-bdfe-4215-a515-14681689d9b8,Educational,0.05583899487311128,38,36,255,1363,1108,45.2658669137948,6594
432c73f3-913f-46d1-aa22-a0b781637402,Educational,0.7428474906511072,41,30,228,1050,822,67.88641541425767,1368
ff5faad6-af74-4ade-b730-1f02af66b8a8,Residental,0.207127260773999,42,49,202,892,690,93.80832904443568,1928
6c874f69-c231-4711-a5d1-90252978da16,Residental,0.8330102262164863,25,30,299,796,497,30.401281693957348,2959
82877c65-e685-4a90-b72d-9c6119fcc9d4,Residental,0.049284213161537194,31,11,241,939,698,44.59476304059652,2474
616268ea-1c99-4225-9556-816c8b52f470,Educational,0.8495461719665874,2,28,351,584,233,33.18268567449747,1938
97530238-c69a-41fc-bc40-28dc42bd3222,Educational,0.06947059779185272,33,43,274,991,717,33.922981577536504,6086
80a950e4-2e46-4ff7-8fbe-b23df9e9e11c,Healthcare,0.3646131733734319,18,22,536,794,258,64.22783596744709,1148
5c17dbd5-730f-4e89-88da-0f0ef18c5e09,Healthcare,0.35651003976963624,28,3,241,1407,1166,49.47764702713364,6608
c8b224b8-4c9b-42ff-bdcb-146932948654,Commercial,0.9292163476997474,32,28,623,1134,511,64.7340406780075,9248
ac07a07f-e40c-49e9-b140-a3d4d0440acf,Residental,0.4538013206463254,11,47,696,1416,720,22.490895611763882,9182
8a5cd72a-3697-486d-b3e8-bc5b140c23fa,Educational,0.674889158575392,24,4,7,37,30,42.75470303228045,5669
e779fb64-81dd-413a-a9b7-06d7ad7e132c,Residental,0.811101434200125,1,3,80,1194,1114,61.92454010057048,2198
628874dc-706a-47c3-a543-94bd43011b80,Residental,0.09600563829412401,7,36,228,271,43,43.210072539840965,3801
efc4c249-5c97-4c08-a459-d3698ea493ce,Residental,0.7016141101456036,29,5,190,1154,964,49.33051940172127,1684
0932f024-b193-4928-903c-020ff3f882b3,Healthcare,0.2602366190100184,48,7,126,461,335,62.12564841293246,6748
e97e92b5-fe26-4aca-8618-133c05191c71,Residental,0.2029084188273188,1,14,130,978,848,99.458774564443,6505
a4139bdf-4997-4b85-9b3b-0517e108553c,Healthcare,0.6842046220379027,24,30,543,1329,786,35.224484986032785,6480
ec769829-2b6a-4e53-8b46-6d30051414b1,Educational,0.7014357159101061,31,7,71,1072,1001,63.34313320825408,2508
f8bb0688-0012-43b6-8c5a-c3baaf8e9a15,Healthcare,0.8014112025841538,30,35,705,1202,497,22.53624609922859,4819
88e52b93-e93b-41cb-98d7-33fd085ca9ba,Commercial,0.7765769883167982,1,9,228,1327,1099,49.48887024758316,2651
26865578-78bf-4024-96fa-1d0d7905cae4,Residental,0.9096036861262988,32,23,266,1085,819,68.06175629925072,1968
b3aafcb8-8b21-45a8-9924-1a3610eb0486,Residental,0.4415155798375029,30,33,517,818,301,65.76132130677891,2484
0764ccdd-8686-4956-a01e-c19a27a2f5db,Commercial,0.3548586239632465,29,7,310,926,616,65.17910396289437,9239
506e03f2-0299-4ada-ad9e-7a8c3cfc7519,Educational,0.4927802398852129,5,5,304,627,323,85.27328204034968,1365
54f28ec2-f255-4631-a135-7f5c097a4117,Healthcare,0.8921680572759481,47,43,198,574,376,44.00933520404724,5108
c424b93c-0434-4a88-956d-c71b0d87c165,Commercial,0.793644715604566,47,44,204,1383,1179,97.87644150324525,7716
7fbec4b3-22d5-4b6a-a01c-f6655e736e5b,Residental,0.17189705765137442,49,46,523,927,404,79.27951775190435,6721
20bb48d7-43ea-4abe-bf25-425facf70866,Healthcare,0.4173899235344797,15,25,373,914,541,91.65038767862175,2421
2d1e7dd0-7a6a-4775-b13c-1da718d02ba6,Healthcare,0.5509911606536178,40,10,455,1276,821,39.090057468747986,9309
71a7dd69-2abc-4319-831d-5c9cfd1609dc,Healthcare,0.6847127676750022,44,39,106,1392,1286,22.91955883853243,4068
92af95aa-d291-4358-923e-3db2a6884a32,Educational,0.657971384579954,35,45,193,991,798,15.368743781911226,9027
a65a4c12-8333-42a4-abd3-e8790c5c1d78,Residental,0.7477923323621696,37,47,374,759,385,57.723759218770645,9016
44128120-1514-4a5e-808f-a94132eb7b6a,Commercial,0.00214101946342804,2,20,711,1311,600,39.95504817377155,8502
3e1293e6-6fcf-4178-8ee7-ce2a8157c8e7,Residental,0.38979957916768126,34,44,562,714,152,96.92769184827269,9602
5af1a0ad-73d4-498f-b4b8-80081cee31b0,Commercial,0.5508084969165922,18,47,541,1209,668,29.755010049953363,5261
fc450f46-dbc8-4efc-be5c-c1e7def90519,Residental,0.10084852536801803,22,34,181,947,766,45.38036115766608,3296
db278073-dc66-4def-92a6-b958b70b9f51,Educational,0.5197529619703228,37,33,601,1206,605,49.281990461704446,1885
f54dfc78-de69-4882-8142-b6f7197a1096,Healthcare,0.09558520029551831,30,13,521,1296,775,39.86267270105118,8286
0efe1b55-e853-456d-80cb-bc84f35dd3ef,Educational,0.0175693285449543,30,2,450,1166,716,44.62970414690419,4778
4c58032d-344f-43e1-a62b-8f71dd050fe1,Educational,0.6094675507373366,21,21,441,671,230,56.84099329867091,8622
972d6740-95a3-4b1c-9687-4009b4898a25,Commercial,0.22123663946300853,13,23,477,1188,711,78.5613056134693,4634
b67690a8-7d22-4a0d-898e-9fff5fdd41f2,Commercial,0.24280819527443454,13,25,313,526,213,85.36898598778501,5700
fc4463f9-b5b6-4989-b3a6-bd4443b085c3,Educational,0.0519058377535766,41,45,566,1262,696,56.461841846703436,8788
0fe1ea14-4db4-4616-b4cc-fd89b52c370a,Residental,0.9561381354684482,35,39,507,564,57,96.42305992994937,2579
bb8aa5d4-15c4-4d58-a19d-876f61246cb2,Educational,0.6428580881330136,10,11,667,1178,511,73.08201835855404,2079
76b0cc16-7adf-4b21-8ec4-74d943c23f37,Educational,0.7977748369330834,49,22,317,1360,1043,72.57383473865355,2660
851e7e1e-343e-4bbd-92fb-58f8f1bca096,Commercial,0.4977091673625661,3,44,610,799,189,73.46493994338331,5596
a2611a0c-e1fb-49a1-9ad0-a5549c9c6f6b,Residental,0.29399682754554113,33,47,688,1317,629,51.45017887027515,5963
db685f70-9b65-4e79-8c7c-ba0bfb186daa,Healthcare,0.32374040937565207,6,27,175,778,603,49.15429350124507,4819
99f037e9-a938-49f2-b0e5-f8ad8ba428d4,Residental,0.12211709191095188,40,39,217,1246,1029,23.686385507510206,6810
c5d11128-3d84-4b67-8fb7-16eeae8a3844,Educational,0.45188330085885964,8,30,371,845,474,14.040296165638951,7031
b5b2ab92-3c57-4378-b3e2-e5bd48f0786e,Residental,0.392036876919144,39,22,225,295,70,60.13608997950237,1656
3b875545-6920-4271-9092-3568e56206eb,Educational,0.14481424985408375,12,22,268,1248,980,57.406505292583546,5519
80b8c857-dc2f-465e-afc8-3616c6608620,Educational,0.1694090699046511,11,16,131,879,748,89.52743354535959,9157
cf3f3513-3080-44dd-9c99-ad7bce059988,Commercial,0.6095533478038963,49,31,393,538,145,89.70242625189832,7385
2d53a527-b8e9-44c0-bb09-be3b255b9561,Healthcare,0.007769776089555203,34,2,557,1099,542,78.61354329254063,5688
ad194985-9106-4652-a4a4-d8b327f997f9,Educational,0.46869023100001717,42,45,637,1240,603,89.4284136730684,5985
c06018d2-e311-4399-96bc-8e45383ab132,Commercial,0.48831078644121806,22,37,482,1237,755,90.74374094711912,5600
8a100e4b-da03-4a30-a166-a75f36f72886,Residental,0.995308638400624,46,28,639,1088,449,74.82631994412652,8346
06e3c863-c63a-4b94-acb7-eec01ab46a1d,Healthcare,0.1805961452963133,24,17,262,667,405,75.09052241161613,1213
6f0100a7-39b6-45cf-9b77-2339b5dc6d1e,Residental,0.1908309408799983,22,29,112,794,682,43.01485226822219,4474
e32a7877-eade-4962-b00d-21d06714b540,Educational,0.729958246968769,4,43,47,367,320,57.06560861256774,6358
e5e23dd9-bca9-4198-b49b-8c4dfb2294cc,Educational,0.49883995182104024,30,37,94,1090,996,88.19216650090682,7192
b4e21d32-203c-4ff8-84a7-da913d761fbe,Commercial,0.519717248468587,22,6,420,513,93,19.649918336618104,7390
03fecd27-7072-449f-853e-215f14fcaa7d,Commercial,0.18927434000362708,21,16,131,942,811,34.55415975354005,4742
52ee4275-f448-44db-8acd-04719af7b0d0,Educational,0.4089950439808977,39,47,495,1185,690,91.44298963387054,1111
0109f945-6229-408d-89d1-c6b5fc703ec4,Healthcare,0.235210628454945,49,35,74,1013,939,84.42137872835475,4289
54acb9f8-a8e5-46fa-8902-23d8225d513f,Residental,0.2822061779125382,13,41,246,756,510,14.672513399853441,4136
4e3d04a9-9bd7-4a9c-b66a-5e88abfa9133,Residental,0.348105442502588,29,32,21,225,204,32.92359085884308,1284
ab6fb355-4222-457b-8e52-a33d809cdbcb,Commercial,0.9932651341952816,49,34,356,722,366,12.492476681794816,1218
c5255c1a-8538-469e-b226-5841cb03209c,Healthcare,0.0556340274403172,19,39,633,954,321,18.838450345705883,9885
1f6d7661-9709-452b-9d33-10c49c6181ad,Healthcare,0.14955439999139009,26,4,619,1314,695,98.37263862330683,6912
4daecc72-53ef-41cd-8fc3-f07c31901ae0,Educational,0.955391350071053,37,6,625,667,42,26.275814893726444,3144
ab6bc7b4-a6af-4b51-8eff-ad7afc44a62b,Residental,0.3651006376517364,50,40,400,991,591,84.95328014914173,8171
8a16a70a-ab84-44d7-ae44-3ff65e7e6574,Commercial,0.3521235978067826,12,29,370,567,197,30.230366132986077,3803
65a59475-dc46-4ab8-a3ad-9b27d4ec8816,Healthcare,0.8615540956918583,25,9,275,425,150,23.432371745567995,3974
0f5ef562-90e9-4a76-b6f0-5f2ef0f45cec,Commercial,0.13878379433623744,34,2,685,788,103,15.912652112138161,7984
ac42a3e7-7a98-4fd2-9e91-e30c887236a9,Healthcare,0.9198181350599443,14,34,189,342,153,22.7167081653741,8387
86950522-9902-46e2-8c6d-ee75e96e0412,Commercial,0.44371394658393315,4,19,419,1362,943,42.06281105584349,7332
10abc988-fb20-4dd5-b3e0-e26f3e74a89f,Healthcare,0.005247846999671624,29,14,140,574,434,94.3617263132604,4811
7424ba69-1f37-4893-a91a-4ce3b3b5021f,Healthcare,0.6567011445062737,41,50,152,1066,914,82.41909525654845,7015
05671d25-a72e-4b59-9092-fd861117f3bf,Healthcare,0.7463466717033336,12,26,83,524,441,77.03866295804322,4501
7711731f-7470-44a0-9145-78db7d493674,Residental,0.5339598674868752,39,5,465,1074,609,87.93765536337374,6916
3d80afe9-6408-4a3f-9f36-3ab788e4c5fc,Educational,0.7404951943342908,5,7,441,894,453,58.81978798183592,9136
93c44823-f112-4299-95f6-96620266491b,Educational,0.682572151704397,26,45,491,853,362,61.10085936421056,2900
08457622-7f64-4009-b1a6-94ade4db0f44,Commercial,0.4800780031819476,21,19,81,840,759,79.90867398787715,7780
9239bed9-b7f9-458e-942e-e9d6dd22a0a0,Educational,0.42237980837380784,6,10,277,1303,1026,63.5793468336345,2866
ce0d4210-ee7c-4f0f-a45a-2cfb969926c0,Healthcare,0.869861171754537,4,50,255,521,266,17.962543608036327,5307
795bd0b6-1ec2-48b6-b57c-35e8c8370848,Commercial,0.09690353843768995,45,30,116,853,737,96.62741908109385,7266
db0e968e-8b58-4a08-9a18-4a7622440c37,Commercial,0.8938382113192432,20,21,703,956,253,24.834896720581757,9070
d38755d1-06f7-438d-9795-11dcf0363403,Residental,0.8580029638422383,11,25,583,1082,499,59.66079894662685,6065
918ceef2-b889-4eba-a3e7-7cb78fd95aec,Commercial,0.8119284224490674,21,10,321,1090,769,69.2502267662384,9608
b636a089-83fb-4145-a422-5c1adcfa0f4b,Commercial,0.009940342931909929,39,26,7,1218,1211,99.20605795593613,1163
106fdac5-01bd-4cde-a066-c3361ba1ad33,Educational,0.8033406866413974,35,43,143,339,196,78.7166434782,8538
2481866c-28c7-4285-a76e-77fb19f76363,Educational,0.007997711751830394,6,8,373,1087,714,44.71189034749932,4044
e5700b91-7509-4684-84fe-3b1697c2b2f9,Residental,0.03995485031397683,41,37,521,582,61,13.135967914747606,8892
ec7c5102-9c13-4998-a4e9-b6a03fab1a19,Educational,0.8607162054130418,18,31,48,662,614,79.23306303164615,5144
ed82ea48-97a7-4ec2-81fa-1c2760eb1f9a,Residental,0.4211916540866901,47,24,630,1319,689,66.4782611851987,7703
701fc16c-d724-4019-a82b-740aac4a217c,Healthcare,0.3039309896461869,20,42,207,284,77,82.028053931635,8134
0a6b9066-435c-45a2-8985-6863522339b1,Educational,0.03719663002863394,36,39,61,1212,1151,79.1829883796797,1773
d6f348e4-a690-430e-9bee-b2514f454ab0,Educational,0.45617769515455264,1,48,231,673,442,97.93502577895183,6389
2dd4b0de-b502-4dcc-aec9-b7b32eadcafb,Commercial,0.5545103268140996,17,20,410,1248,838,71.67209318875676,8043
1480606d-d734-4197-af75-5434149321ba,Commercial,0.9050263836378755,4,19,231,1104,873,86.63991018954317,1072
566b367c-ca21-4a13-a98d-9301dc205aff,Commercial,0.06605571379033703,9,38,457,603,146,20.10309593409061,7432
35c6189a-3ddb-4e4d-aaa3-013b7c902ef8,Commercial,0.8926842599407946,7,39,540,607,67,12.270682656513841,1683
1aeb883f-df60-4cfb-85d1-16e03d261734,Commercial,0.8027654279980295,44,20,84,1066,982,35.85832758870072,7326
0dc01683-29b7-4f08-abdc-f81d04cccd85,Commercial,0.06550452022467157,37,49,161,1110,949,55.9073505259547,4704
4d43669e-3a2b-477f-bf79-9f53a995d051,Commercial,0.02208499198418068,41,21,310,776,466,82.2200028095167,2777
a25482b9-2a71-4e22-b0c4-67fbf1aedd67,Residental,0.6180737790739856,25,1,709,1104,395,68.99702603968376,9198
d9e9e30e-3d5c-46ba-a3e9-4bad373bf1fa,Residental,0.4012450901819532,50,19,253,526,273,35.686727972544624,7642
94c85cd8-f332-425d-b57d-cb5f69170fcb,Residental,0.27638203187158694,48,14,547,598,51,51.95350996836477,8600
90d87c11-9200-4d90-81d7-19ba0d999b01,Commercial,0.08370174781295847,11,11,512,1013,501,60.59395008746029,8440
4b1931e6-41f1-43d7-997c-4d033d0701ff,Healthcare,0.9218781740777672,49,4,219,926,707,49.81960158688298,4110
b4b844d4-0efa-4a7d-a14b-1451f9d68300,Residental,0.8881282478776545,34,29,18,832,814,77.94387821091452,1335
50095190-bc04-40ad-a284-8fe1ed132b2c,Commercial,0.06954985743962172,23,2,348,945,597,27.51904562722746,8090
1a545632-b132-4fb2-a6b7-01509e0a78b3,Residental,0.020782954537936105,50,46,597,1256,659,14.221381873442343,4356
458ae577-2757-436d-982a-d93e26d0fbc0,Commercial,0.6480698211850007,8,12,196,1363,1167,72.58611127940597,1531
f42f06d3-9913-4824-baa0-ab1779384195,Healthcare,0.0667533043247357,36,13,287,562,275,36.332108234413624,7458
e39e0d92-0623-4b2c-9703-04de848d6d21,Educational,0.3323382183596034,25,50,399,640,241,40.771444746381064,4681
50283f85-d393-4fb6-8ab1-57b4425c0145,Healthcare,0.36315567857150377,24,32,2,78,76,41.678123410448926,6234
464e2865-86ec-4d18-8f26-780c73fda425,Educational,0.10897139784577892,41,15,120,1308,1188,93.2474077670496,3718
ab200b9c-4f83-4f32-8f79-f2d0af2c68e1,Educational,0.554634018799646,45,37,360,1208,848,62.44863277747614,9905
37db2aaf-db48-4564-8007-3b58fa504367,Healthcare,0.4037787578450287,50,8,254,1424,1170,46.827138309638265,5727
d419d375-1714-4b06-977a-e57e28d5fcf2,Educational,0.7750396709754741,47,17,61,803,742,88.72470530604954,7094
7b9788a1-bea4-4425-b913-6336c588fbff,Residental,0.24677461143419943,3,8,678,1325,647,60.024433816796474,1288
b5408c48-cd1f-4fc6-8174-9f17f010679b,Residental,0.34135907005417,7,36,485,1016,531,22.45386569190226,2220
8c011722-7af1-481a-b5e8-a92c95ecae3a,Healthcare,0.5075327365530519,31,4,627,1047,420,21.895184803082763,6640
6d7e9b7e-2bd1-4e69-b2ab-d82af53a79e4,Residental,0.14946792795267627,4,6,669,1277,608,12.149951094342342,5948
7008c427-edf5-4b6d-a832-6402c7807b0e,Residental,0.8875576137900621,41,45,672,1439,767,92.39283546504575,6442
0cfaf822-4826-4f51-bb5c-9491f8ed484f,Residental,0.7279710519535512,34,32,342,714,372,88.64264770539432,2493
a62b52a0-2b16-420d-b2b1-ac43b9383acc,Commercial,0.9074113316782151,33,47,302,1236,934,93.10929509376213,9309
70582cd2-8f82-41c1-9e4d-038faeb3b2a4,Healthcare,0.8862876455286237,14,8,95,360,265,70.77860758268648,4460
257bbc4d-b672-4c14-bc7c-c158b1e48c01,Residental,0.36172974590089435,15,39,714,1049,335,45.73925235190397,4780
4b2fb341-2498-4129-823f-6b1f188fae70,Commercial,0.5014807013661765,16,38,93,1057,964,46.631756024683405,1850
847db295-0494-4b65-b6c7-b8f9741972c4,Commercial,0.7822887971385439,8,20,356,1430,1074,34.831027559387294,9174
b7e97c3c-ab0c-47e4-8457-dc54bea1e96e,Commercial,0.06479290650873326,6,3,298,1044,746,66.02172629850958,1658
aac1afad-ce99-4502-a8c7-2296e67ed334,Healthcare,0.7975871876779833,32,18,450,869,419,95.70099818241907,4548
031a7646-05fd-4aad-a3eb-f80d62c8257f,Residental,0.5892543789047606,2,38,346,447,101,87.09740668499707,2014
13a6dc89-8c45-498f-8022-7c89994038e8,Commercial,0.7186088922650606,36,23,335,764,429,79.8424088981565,8144
4095dbb1-c18d-43e7-8366-ad9e5bc819df,Educational,0.3014556912882712,11,25,109,1110,1001,47.84665531582625,4796
4982d74b-fa4b-4759-9225-1511f21bfc77,Commercial,0.7348689781947771,42,17,389,1326,937,52.17512801959834,3917
328e5623-bfe9-411b-baba-81b96bad2934,Commercial,0.1742050799610485,27,38,435,498,63,74.48467631758763,3975
361d5aaa-8ee7-46be-add9-c9bf240dcf71,Commercial,0.02402106990653341,30,14,43,954,911,69.6866845442419,4222
8c91e37a-13d0-4763-b343-e58a2c8dad18,Healthcare,0.11133686787504393,22,26,532,693,161,20.66915975672761,2551
5e818f00-27db-4178-b2f7-7617000c53ec,Commercial,0.7794528144005356,34,34,650,1249,599,87.45012971927149,7520
27dc9903-bb8d-4790-b656-f65cd7085953,Educational,0.705267737463292,18,50,610,1288,678,93.08878397341508,8468
3b157647-28c4-4695-a38e-c472445c8f6c,Educational,0.5435237427305541,25,25,83,757,674,46.70564906753845,8279
45e39dfc-88dc-4f22-b22e-7bf3da01bc00,Healthcare,0.6494233471533735,42,35,175,1292,1117,89.30831806422363,8619
76926520-3814-4215-9061-3a7350996767,Educational,0.6939671779096277,31,37,339,1027,688,67.57615094848786,4675
aa20bdc1-b3ad-45b1-98d6-e9d8d6b3b19b,Healthcare,0.8313909493502082,35,1,122,261,139,39.54806841208766,2135
6f56c975-aa78-4b2c-a4d0-32a33dc37303,Commercial,0.18380308738630202,48,2,409,1364,955,74.22573125338238,1157
e6504a63-3bdd-4fdf-b553-e48916cf8791,Residental,0.9412240024341335,31,36,426,460,34,27.68812742680494,6897
17ed3699-dd31-468b-8291-68eea8ad9bbf,Healthcare,0.9641023510080465,45,49,636,813,177,66.02126519026135,7198
bc19ed15-ad0a-4724-9192-3b97fd989ffc,Residental,0.161879926268931,9,32,143,1174,1031,59.10301200692932,4363
a5cb750d-8f95-4cd8-8250-2a0a6c518b63,Commercial,0.1430950233339051,1,27,672,877,205,11.6342303714996,8799
24043645-fdb6-441f-bd07-ac6f01ab5237,Healthcare,0.1484465455031141,45,41,680,1373,693,94.70176204224991,1681
8db41c94-a567-4367-9033-aa53a35d9f34,Commercial,0.4891833149251029,50,47,362,1009,647,72.97799251235134,7309
ecaabf7c-0b05-47a0-9211-f21ea129c518,Residental,0.13611029610537762,11,49,720,945,225,91.92718679294833,4596
6c3951e5-5091-4b64-9773-351994a5ce76,Commercial,0.9096897679488902,43,4,52,157,105,99.24179480730972,9993
f7df3a20-fa74-494a-b234-75f46a738e7f,Educational,0.717352048688759,50,2,88,541,453,75.85213480354842,1725
2c386a1c-4f8e-4935-b139-c4ec1526645d,Residental,0.6649957340336988,33,38,441,936,495,81.72488689088563,5049
cb7c61af-401a-4f3c-9da9-40d77b2bad8b,Healthcare,0.02738686868091833,27,4,145,1050,905,34.948407157278254,1672
ce1c71b4-a687-45ba-b849-4e2cc0b51596,Commercial,0.6504207339778071,21,48,313,967,654,87.1516083825243,2249
84317e93-50bb-4d8a-b504-fcdda2011431,Educational,0.6864385534551153,7,44,618,1345,727,98.82632546158554,9161
03e78660-3c09-41fb-9d8a-6ce67bd5d327,Healthcare,0.6706458991687012,40,38,211,1069,858,43.35594996882003,4346
64942618-c7b8-4790-99a9-2e8f62521af4,Residental,0.06747019268541032,2,41,180,786,606,56.17656703769612,7192
232f5ac2-ae31-4c56-a221-747caf4e8921,Healthcare,0.8127379918164154,27,40,32,414,382,22.542141284734974,8954
72bd641f-a479-4e56-bc1d-7a5ce8f72092,Educational,0.7196504787993566,42,45,404,1066,662,70.87539413457836,9470
907706c6-0a3d-4948-a84c-d1157cbb1c48,Educational,0.9349356992663391,30,9,380,1013,633,63.824766294174,6521
5f9b48b8-a3f2-44b9-a840-b37d8c5f5b3c,Healthcare,0.7246671806200259,34,5,113,156,43,52.20081479586666,5380
8cfcd81c-2611-4985-8916-320a81021212,Residental,0.60728187813742,20,48,507,1439,932,50.457347256802876,9990
8fb64c05-ea6d-4c8f-bf9f-d13bd6af081d,Commercial,0.012785835077776753,45,46,258,894,636,88.15501103930076,3808
d250abd3-71f9-4f18-80ba-68db3df3f697,Residental,0.7260867712487802,30,46,473,1034,561,22.608083061620846,2662
2cf5c9cb-f74f-42b7-9505-233feb19f289,Residental,0.15537951076951106,2,33,266,814,548,69.60929881605885,6982
e6a365f2-35de-49c9-ac11-79de2112f7e2,Residental,0.3010600158537322,32,1,117,1097,980,81.6835289800629,6962
bf46449d-ff4f-4e8f-962c-a95e821b5176,Residental,0.759601685513437,21,10,366,818,452,84.02206239865734,9659
d57e4d68-a0ac-42ae-9bb2-5238f7ddc412,Educational,0.9793947625812152,43,30,533,806,273,51.677482593827385,2110
120d79e0-e550-4fb9-b003-c3e9d846ab48,Healthcare,0.31776079919958977,8,42,493,815,322,45.79111059476346,3037
4cf6f63d-e752-4441-a862-8cd980def0fc,Educational,0.2629250871913388,28,21,371,773,402,68.47974568199484,1805
2ddcfee8-414b-4f32-9e33-3cd7ff02dc65,Residental,0.9979844216943455,26,24,619,662,43,25.33570041623861,5572
5e66f3f5-1b78-48e1-a863-03b325b22261,Healthcare,0.4734875818653299,41,19,703,1043,340,86.60721666598538,3812
83d9f682-31a3-49e8-8e35-373a2f587bac,Educational,0.7308504380533023,9,48,188,1288,1100,34.35683935027947,9982
f2c800c0-20f9-4077-8eeb-303e261f90a9,Commercial,0.3365280317096465,1,23,325,750,425,39.782717209829784,4882
2f71e43b-d32d-42fb-810d-8193c38abc27,Educational,0.06754805459648794,29,34,715,866,151,59.19416415175793,9401
f699c10b-a526-492b-b11b-4d84cc0de43d,Healthcare,0.7633412807486379,16,9,585,658,73,73.30994068929527,9303
b4b97d33-f0ac-4bfe-a4cb-c4a751ce5d69,Commercial,0.0030383484395418714,20,31,419,728,309,37.578436238708,8380
b4d0ca46-1161-4009-a18f-d5821a184eeb,Residental,0.34762875784441005,15,32,227,367,140,22.13848381073295,9205
d0f050b6-f3c2-4d66-a490-f556cbdae128,Residental,0.05650425734779163,14,6,396,1434,1038,39.06749107424412,8957
ed8fb443-59ce-44f6-9d40-3c80a4b67fb8,Healthcare,0.748832841554002,46,45,223,1320,1097,96.24629648124056,4449
c917e6e6-00a0-4dd9-812f-e67d45156f14,Educational,0.007236854291675199,32,27,133,197,64,16.298874635741026,2617
fedd0563-e52d-4f1a-a7bb-88d4c80cb12a,Educational,0.966738907763013,20,44,97,972,875,73.10124353332071,4367
7adfd62d-a20a-4e10-81ab-737c009f9c75,Residental,0.798422853617614,11,30,586,1113,527,70.57258488567876,2169
2f981364-765c-49b7-a5d2-faec6310c019,Commercial,0.20888802857983113,30,43,720,935,215,65.59651402839495,5687
07202949-9f37-4798-92e0-7532ecd02269,Educational,0.8738805768622012,41,7,203,973,770,49.77727078064733,7763
a5d670bc-d51d-474f-8ef0-a050c2c597e5,Healthcare,0.37616045706531265,1,6,43,438,395,75.32380037111834,1111
61263e66-f8e1-4aa0-aa89-303f33c32f8e,Residental,0.8734502453290228,31,7,343,1305,962,77.66349857642008,4021
a012dafe-1089-4f16-ade9-c13387ac34c1,Healthcare,0.5128198305747595,14,8,457,1082,625,39.487457122777016,5997
c1d9ab14-4073-435d-be66-4d4814ee5afe,Healthcare,0.21482932616107242,50,22,624,1397,773,47.89461092931708,9141
8850d8bc-3ac1-4073-8020-af0e7eaad840,Commercial,0.5882586350678201,22,19,79,761,682,16.243197382099865,4557
e4acca1b-2f50-4b7c-be4c-0061db5e5cb6,Educational,0.5218682725496107,41,24,230,293,63,72.97857719836463,8098
4479e17e-5a01-4208-8c6c-f928aa302134,Educational,0.3446093124451278,5,42,276,404,128,57.090683252491075,1775
ea387d27-3f57-414e-b92f-851197e7d75a,Healthcare,0.28611831101347174,33,29,426,736,310,70.34579877562571,9663
cbf27413-6e04-4a46-8974-8ad98993be7a,Residental,0.3703917762877722,44,22,705,784,79,31.449716322239365,6872
665ddca0-9a7c-4e16-8ac7-fa6ae567f295,Commercial,0.09947858313143709,10,11,718,746,28,64.67943876409994,1725
5393eb07-8556-4b2c-b75c-c50bd9c57147,Commercial,0.9038816306919426,17,48,143,356,213,63.103686093631275,2367
05c1141c-4211-4a91-9a50-11add5f78941,Educational,0.16998020876586972,48,5,127,385,258,61.12081500311264,9647
a51e6fc6-fd29-49df-8bf1-c36fd8ec6a10,Commercial,0.3010643839269873,30,47,254,504,250,25.000201341353318,1589
6ec8b12a-2113-4deb-b591-6e4fcabe14c7,Residental,0.009846277463080866,25,1,253,1152,899,31.55163382609193,8542
12b3c5a0-9865-43bf-995b-5c19dec7cde0,Residental,0.8139752675240794,32,35,37,385,348,88.24478577157186,9735
6ef5a9bc-b03c-4894-a9f6-32c524d8e5ed,Residental,0.6282366201297217,6,17,17,226,209,45.30588042911978,8206
7143dd49-cd59-4c0b-92fb-f755ba4d53de,Commercial,0.19751628454575454,34,6,530,1232,702,24.455408752221693,3629
4972ca72-138e-4eb0-8a8c-44fa8f9b5314,Healthcare,0.694551215134263,1,48,185,1130,945,46.40022187359926,2662
7912b11b-a47f-46d5-8033-01a7f1e06bd2,Commercial,0.014098722445166745,4,24,12,897,885,50.81745433685791,8121
f501ac1f-1a4d-43b0-9b82-6d554f7556bb,Commercial,0.9066043123244883,11,29,88,325,237,23.175379513150737,2186
8e1639b8-1a3f-44b6-9e14-fdcabe44672c,Educational,0.7352777677278685,30,13,395,1025,630,56.174990564063904,7459
db52db39-824e-4ee6-aa32-8376dd749a92,Residental,0.5633494927063704,30,32,79,765,686,57.48553029821547,6475
fd686190-ff57-4a83-83d7-bfbe0b414764,Educational,0.7906935442669669,44,30,436,1345,909,98.06679768184432,5442
f496f9d5-32a6-40d4-8748-f2378a679aaa,Commercial,0.241267520389285,43,3,74,623,549,37.46641797836139,7638
3cbaff8f-cd04-4023-9330-2937a0555fcf,Educational,0.04834078927984853,48,40,417,1119,702,55.54589844365289,7987
34cc95e8-e9ef-45e7-836e-2360b98402d8,Healthcare,0.30044629475771334,14,27,38,1427,1389,61.32027755949178,9598
53362dcc-1718-4e58-a626-4274ef8d0eb5,Residental,0.8818583875045005,34,42,673,859,186,57.919464940216855,3723
c7ba66be-4540-4872-8561-d6c83e7edcb7,Residental,0.2318330302650411,34,19,683,1032,349,59.75147592633847,7472
da10d6fa-905a-49a1-b547-3171ec89c949,Healthcare,0.6516088341450594,33,33,409,1278,869,84.067414090697,7063
91899d44-a5ce-4fca-acd9-21ad3a967a59,Commercial,0.8625636428187903,13,36,64,524,460,10.49553778633488,1490
c8dc90e2-2ef1-471c-b4d6-9062c3fbd881,Educational,0.062326706899241247,34,50,611,1046,435,14.542988006521336,6861
4188ce05-7593-440b-9d0e-6221994a4089,Residental,0.6624566867614033,30,22,428,815,387,31.750067437339485,2830
c85ea107-1046-41b1-980e-2741d8dde0b3,Residental,0.7992178512266719,49,9,597,1362,765,52.73218489896484,2027
40dc4945-9113-4d71-bc05-1a1986b25871,Healthcare,0.8567494425621975,16,34,289,1269,980,12.396703210938789,2484
06f6d62e-748c-4e87-9f92-459117cb7afd,Educational,0.846520906112536,4,14,268,1145,877,63.990181376324045,6951
5f17254e-6178-4096-a4e7-66dbf3680331,Residental,0.8013410294144524,36,1,566,680,114,39.22008406800123,6397
1d627cb1-78a5-49f0-8838-c063faccd69f,Healthcare,0.5618993193690066,24,21,302,891,589,71.3052467332183,9822
293d5de6-9559-428d-9e8a-e31104c6b7b3,Residental,0.04529348689253643,17,46,310,1102,792,94.6080376057645,1328
a1f0441f-b1aa-4c0d-b4d2-9cbf39851ccf,Educational,0.653799414539822,8,9,152,1034,882,55.52374184388679,5349
e82fdb60-2e32-4712-9af7-d08ea4897406,Healthcare,0.49427991080185907,34,31,294,1138,844,66.69289917243424,5622
c6470a40-e7d7-44a7-bdfd-45fe21fa6eb1,Residental,0.7387010593903248,10,34,242,1169,927,10.02261571739963,5813
67000909-e6cc-42ab-85bd-3e00caf6a62b,Healthcare,0.4057310853360673,29,26,366,410,44,17.800311528814426,3725
19a3963d-471c-425e-a742-f283c154a3ec,Educational,0.7563528549507257,23,43,4,855,851,40.367061107588825,4999
585f19f2-711e-42da-b3da-70027cdb1522,Healthcare,0.703311136638728,49,46,205,852,647,66.48730111227925,4621
8e62d3a9-e99d-4f84-959f-bc577caa766e,Educational,0.5604758021929691,14,4,183,871,688,75.44689990182053,1242
ac8f7bcf-d524-49ff-9e46-c135a30c9ac0,Healthcare,0.8380478347095353,42,42,315,1125,810,28.892572288459448,9809
f20d5a6c-db07-4e55-834f-21b0b456a3d5,Residental,0.7620477002729794,29,5,151,1103,952,63.035665356569794,9915
4c529602-9925-4d90-86f8-6f4c2fdc6563,Residental,0.2556128516494257,43,7,547,886,339,66.30249780152623,7408
70f8b835-eb44-441c-a4b3-352683904853,Commercial,0.07119557284845324,30,27,75,580,505,28.23400075807881,8384
919ed950-91ce-4757-b161-7d11718f098f,Educational,0.5209029078073806,11,24,620,1179,559,63.38747465330298,4160
ae566b5b-4262-44c3-bd8a-5a85d3e8dcf1,Healthcare,0.2465105749138401,16,50,472,783,311,60.07904815548607,3089
31e2cb6d-0bcf-4fd2-9a83-b6057873d1aa,Commercial,0.5319755730495174,24,5,104,200,96,59.84881677136063,4003
3218fdb9-a62a-4ab2-8a37-305a64c24ff2,Healthcare,0.9385795604201023,26,45,616,1172,556,42.37163802674968,1913
ad6421af-b7c4-4c0c-aabf-305c7b1f7474,Healthcare,0.03241933137296504,22,21,118,262,144,74.64784788213791,7982
21ea0272-1474-4856-aa86-d8cf471bdc7b,Commercial,0.6816028075483693,31,17,218,912,694,68.9019404562973,4124
d07d0c93-b4c7-4c92-8f5d-516fdb9c0dc3,Healthcare,0.5172312745294658,41,21,697,782,85,30.059969516003676,2739
c954a153-42f5-4073-9ce5-48138fea8e17,Healthcare,0.9503565712559738,39,25,412,745,333,68.12423137634993,3672
2ded29b5-5e18-47e2-951d-71de985e4ea2,Healthcare,0.9825726288604779,15,45,453,580,127,26.681421662044198,4865
d4ae5298-0d0d-4b51-8024-7031bc917c11,Healthcare,0.9906251074371523,50,20,432,1055,623,91.17887958629407,4248
c780344f-d9e8-4cb9-8fc2-05c6998fde12,Educational,0.5145153739582426,19,49,381,1379,998,80.64185342661895,1913
d4312233-01c7-43c7-a2a5-009b840420e6,Commercial,0.1562064889732846,42,19,444,1337,893,55.624505997066386,2987
d93ddb60-f121-4c1f-89c6-4455a54d37c6,Residental,0.9669373795100717,37,20,75,1212,1137,51.92704085089332,1566
19bf666c-9b63-4bec-bd4a-fd2e53241c03,Residental,0.8606870929192978,19,36,30,479,449,61.36033848729055,8289
3682ae22-b64e-4191-9cff-170750389359,Residental,0.7014717068299816,33,25,688,1041,353,16.516953275728287,4211
b0b92d01-47e9-44f3-bf30-006ba3cf252d,Educational,0.6330170503104571,23,17,677,1366,689,72.43868676675524,3583
c679cf9b-a47d-4e4b-86a3-f12df80644ce,Educational,0.6085826064439684,4,27,3,340,337,31.476566011733688,8885
3878d880-d9cd-4a45-985c-eb3e3c00c9a3,Commercial,0.6074987524158005,8,18,24,1120,1096,30.009879560206425,4710
eae4379c-353b-45aa-8fbb-065811e07ba9,Commercial,0.49027463233240776,14,8,416,852,436,67.92452274005862,3679
ff24467d-59e4-48da-a648-9b0a7fd8cd9a,Residental,0.08578547387167523,14,46,651,1372,721,95.50837781000209,7153
51c785b6-4ffc-4383-9f72-4e23fb7c994d,Residental,0.2086376012210045,31,33,167,944,777,14.380836735020239,8208
75453f30-f29f-470f-8e33-f6bd0ec5a151,Residental,0.04756381819615907,2,44,643,725,82,56.37221134143423,7642
f2fa764c-7a41-4d2d-bfd2-05d93c4eeb2e,Educational,0.871493599212833,39,11,155,347,192,86.7847351096829,3998
d4f51245-dec3-483a-853e-06274905b464,Residental,0.7201872331091148,23,45,531,562,31,68.6384017476511,2053
f4b9e1f6-9df9-48bd-96c0-b4078f57d4d1,Educational,0.11823717175878545,6,21,162,230,68,54.33063324464875,3383
6beaf0e5-34f3-4534-9d98-91f7d059f37e,Commercial,0.6536255142076234,11,42,71,847,776,26.655141698844186,9315
f61c74c3-6c71-490e-bb8b-ee7abe1647fe,Commercial,0.8667630622786692,36,46,538,769,231,72.4909704870748,4932
54cada68-f951-440b-9e4e-35f3df65c9c0,Commercial,0.593009347523395,13,5,565,1400,835,10.515785976104906,6786
a5443dd0-a5c0-4cf3-bc85-5a4e822cd51d,Healthcare,0.6834609314780685,35,25,695,895,200,73.01688649466126,2310
ddf967b7-b5ac-4ca9-99b4-ed5c9664fb00,Residental,0.8708659196797823,37,7,344,536,192,16.042917371428395,4912
2ba5e53a-a1aa-45ea-a4bc-47a59572fc09,Educational,0.18887678296848498,35,7,420,1164,744,68.88012625153368,8396
eb3d658a-bc09-42af-bc69-1e5d19c9eab1,Educational,0.4685308899326157,6,26,186,419,233,95.84111485504795,7154
2b49ec3d-d997-4f9c-8487-00a85a29135f,Residental,0.5674771094566629,30,3,532,727,195,71.44939058853357,2336
ee1b963b-ec23-4ec1-b56c-d4c925968910,Educational,0.2980917611064172,10,45,429,1396,967,56.67944713969966,8690
a81eb5b8-5de6-4ce0-8cf7-4d18c0111e4d,Healthcare,0.2131171969847908,45,4,219,1145,926,94.32969949762038,6284
3ef79791-1a5c-423f-9ade-cf8de180d30d,Educational,0.3964073265114657,5,3,629,1123,494,18.304699405670952,9650
9ce47ec2-8796-4333-b832-ccecd2e237dc,Commercial,0.03620238678967602,18,22,626,1030,404,71.05031300222157,6561
a0c13cd2-7b1e-4be7-bc6f-c8ec482ebe7d,Healthcare,0.7781406428366006,11,37,502,639,137,98.99501219879565,9710
b3254692-89b0-4211-92b8-d61cd817a40b,Educational,0.031345251542721386,50,10,558,1270,712,72.28003384194827,4993
de00a10b-0db4-4c25-b83c-4ab53cb7537f,Educational,0.45102503042050546,16,30,676,1144,468,27.33292686519497,3713
4c940763-e3d2-4181-be20-ebf11a8cdc97,Healthcare,0.267152010955231,45,23,393,798,405,76.4370809942869,5807
cf335dd9-9c6f-47c7-900d-fb55453c77bb,Educational,0.6976183125965711,10,21,595,596,1,62.00304850490843,3941
ec230509-ddd0-4459-a9b0-0f64d2844e28,Educational,0.2330678313098692,12,43,74,407,333,79.82098354971262,4034
488f20b0-6853-4c98-9a24-7a53374a8048,Educational,0.2612243028936909,48,48,109,903,794,42.073903378789495,6657
807eda30-9a11-45a5-83d5-87b4de48e70f,Educational,0.7399844034286219,47,1,650,1176,526,77.0125538215897,4891
3e26e8ff-34e1-48d6-abfa-538cb49f75e9,Residental,0.7632821001430984,12,42,622,1289,667,10.603091439059838,5369
26764ace-4df5-4345-befc-3a74ff294e8d,Commercial,0.5479155616761551,7,44,4,1198,1194,77.88900986867796,8730
70f49a5e-5b48-44a2-b19d-5c025d631145,Healthcare,0.5283034229800361,43,13,165,968,803,26.436864553710596,5951
b225ef1b-0122-4ff6-910b-ff290988743c,Healthcare,0.26005297788835324,36,42,367,926,559,57.45267358208697,1966
8cc33f37-ba24-4bc4-a041-fc899fe0d88b,Commercial,0.9686787339595017,41,23,6,926,920,41.7142505479448,8788
654783c7-f62f-4f45-8b14-ba508e2211ba,Residental,0.4742749563832295,36,5,65,225,160,73.73960938878159,3588
b1fb53b1-f568-41b9-9542-96b0bc607010,Healthcare,0.7180760348044464,15,49,428,1244,816,23.045067932734216,1259
cf390dd5-7057-47ee-ab9b-0c980865045f,Healthcare,0.7331211034200977,2,32,6,393,387,22.660316636485994,2641
ab03a4cd-8a33-4e17-b9b3-83850b983854,Commercial,0.0433276664262322,5,3,600,1148,548,31.0886048800865,9669
3d54f350-4cd7-49fb-8a28-6b60f96bf832,Healthcare,0.46268762979111566,13,34,591,1430,839,98.15258241473467,9429
ca3c75dc-860a-4d39-94b2-cbb90c0c50d2,Educational,0.570040045404685,10,13,167,762,595,65.90556811003582,7236
e346a31d-0910-4df9-b130-0863db59862a,Healthcare,0.7856391679096391,15,40,25,881,856,22.20672534912976,5505
fd10dbac-8409-4336-ab14-0a2bdfc228f2,Commercial,0.3578213700066182,24,16,161,325,164,63.16907385303044,1813
2aa66fa4-9aae-4bda-b665-a65043a29ca8,Healthcare,0.755774265458371,39,39,122,136,14,72.95007684237217,3479
22bf7386-16a2-49b9-83e0-a9629a47c964,Residental,0.7403646542140374,11,9,411,1311,900,41.90748538206259,3419
ca44bb3c-3567-4ccb-8333-0b1829100ef9,Commercial,0.5462677733409764,41,22,26,185,159,63.16312092293026,1952
c121daac-a9f6-4ecb-81fe-b78970a9a48f,Educational,0.16807540982103708,36,9,332,518,186,98.26516394670536,7684
e56b4476-e738-4dd3-823f-cc397309e1c9,Residental,0.30835531293235274,47,22,334,440,106,73.666771076853,4621
e486ba57-7b23-47a0-90a2-c843cbdee120,Commercial,0.7135857527238286,9,10,47,352,305,13.933040175555568,2593
1ba7c1cd-e6eb-4c5b-8aa8-734762031721,Educational,0.19399093954045155,47,1,707,1275,568,15.247512775983246,2083
0a6141eb-0baf-4596-99c1-bf43f1eca620,Educational,0.8962206794835343,30,18,238,287,49,94.48764905410954,2758
f21e24a7-a72f-43f4-b761-2cdebb287ec3,Educational,0.1324036748265056,8,26,334,1298,964,37.42370012107035,3965
8c720d9f-06d9-4598-887c-5c6649accbee,Healthcare,0.20860136488629977,5,41,125,1438,1313,76.60958632270939,5248
39801374-3bcf-40a2-8451-99344dad580d,Healthcare,0.3083629200634157,13,24,362,609,247,77.93858845297142,2714
49eb2c26-c84f-41c3-9a86-9905e8204406,Commercial,0.9205849658073605,33,10,34,685,651,52.40809751261239,4558
c76fb41b-3c8a-4d80-a58e-0f1e2cd67c94,Healthcare,0.2943175756095685,7,8,649,977,328,88.24017224079859,2459
8149b25b-3b64-472f-b393-07ebcd12601c,Healthcare,0.830859487765524,15,17,226,1323,1097,95.33449227450295,7140
c88048d0-2c6e-4547-afc9-b10a97892e25,Commercial,0.055001881270750896,23,9,584,798,214,18.39396921994609,7156
3f5fe2ce-57ef-499b-a8a3-69a7a8f804ac,Healthcare,0.2125403269526306,17,43,10,236,226,34.582930544654154,3789
58dde71b-c494-4bb7-8e24-a7fa2ab1fb9d,Healthcare,0.6628156098116935,31,13,586,1103,517,83.79817583230403,1339
354e5304-065d-439c-b772-a6b1bd981ad0,Healthcare,0.2040704860131085,15,23,154,573,419,88.95749068921542,3205
f92e75b0-c193-40d0-a024-843a2b3fbdd8,Educational,0.3463708945425533,41,46,666,691,25,75.1058885047318,9597
55b7db6f-780b-4f73-b791-3460968a2fe1,Residental,0.6033347271357165,3,44,391,1093,702,15.210932728408029,1541
ce6aee4e-5dc6-40ca-b530-77f095ffe756,Healthcare,0.654704094148222,3,49,81,626,545,65.01747881835027,9991
acc7be82-67cb-4109-a62f-9298b165a8d6,Educational,0.9799685876941893,23,39,15,601,586,53.73496121930381,1492
6b9ff1dd-5edd-46c4-87bf-bb2ed2926b26,Healthcare,0.8918079159491926,7,25,573,851,278,71.7517160825277,4732
8a8d3f83-f0f3-485f-a81f-1f2e7cde5821,Healthcare,0.23080920760188717,3,30,606,927,321,92.23514045458408,1254
b17d171b-150a-4559-93c7-6683a3984f98,Commercial,0.8045128200063346,32,45,597,1202,605,75.06098762922726,3006
05862f35-9120-41fb-964e-0b57a68a30db,Residental,0.0667479111559971,42,48,90,1225,1135,49.5239283699129,2929
17d3a467-2e26-4f9d-9603-10a38b25da92,Educational,0.9827026425170904,35,5,687,865,178,49.87206499873487,8151
f56cdb3d-6a1c-4508-99fd-8ecd2e609a1f,Healthcare,0.6144911201968045,13,22,223,380,157,21.458745333211514,3445
1aecf84d-21d5-48cd-805f-e6a7abffe0a0,Residental,0.8752084063326246,47,47,229,468,239,34.82035261127439,8840
a1beed8b-be2d-4f2e-96df-ba2ddeeeb22c,Educational,0.12699715606277273,27,38,37,200,163,57.68014915566268,1434
b66c8f41-58ae-419f-bd9f-2a87a56e4600,Healthcare,0.18940229258437247,26,44,630,1272,642,95.66585281957957,8673
84c6fc7f-2336-455f-93c7-9706f427aaff,Commercial,0.10780538144409113,8,27,490,1378,888,51.416421062293026,7705
e03f6021-4302-49e6-bba4-6796f88fc588,Educational,0.046461156073862475,1,17,590,1334,744,49.52538980227281,9024
5b260f6a-be27-46fe-a9bf-568169e938dd,Residental,0.9734879037412112,35,18,91,622,531,37.1134233049529,8162
78be9d60-9d9c-43c9-b6c4-9b4be25e8fc3,Residental,0.1960992690862241,7,18,664,1026,362,83.48885940550781,7776
f8de070f-5080-42c2-94e2-fac33db7e534,Educational,0.45247848787211553,30,48,407,537,130,43.68692268687878,1983
23c7fba1-8ef9-4800-9e08-7153fcdbb93b,Educational,0.27351899978457817,43,40,403,1243,840,32.51366221891806,5634
c497a1d5-c674-4327-9474-09c2ad0c1f7f,Residental,0.6405762506961398,10,16,157,1274,1117,77.24996488663142,7776
9a8b47a2-b639-45da-b47d-1b9ec3cef277,Educational,0.8133945537360278,9,32,524,1303,779,35.81770850470043,1597
ad5b03ad-a47e-4fe2-84cd-25bc7df5f92c,Residental,0.7580626291768162,22,36,346,1348,1002,35.68602200161142,7408
53a398d6-e1ca-4281-bc9b-f8aba4a59d06,Educational,0.9763457095226161,6,25,593,673,80,25.684381618581874,3764
a7109983-2146-41e6-bd65-f34579656bf9,Educational,0.45238218332193125,39,44,464,1098,634,58.20179627220051,4411
93c8508e-c3b0-4043-9a77-24180cfbe035,Commercial,0.00123063725379835,28,43,433,1422,989,65.85295173966006,1381
05b90351-1c7d-448d-98c8-ce26673e1e50,Educational,0.7096016982369233,49,13,640,1364,724,79.87169938119376,9061
5ea337ac-6818-40b4-872b-7cc52a8f792d,Commercial,0.8679237362249705,33,18,572,1097,525,96.92207697229439,7083
1034af74-4a48-4104-885d-30798b8e66c4,Healthcare,0.29823209710401555,23,2,394,1027,633,58.41595577378196,9100
644eb033-2300-4897-851d-390fd1f0ee11,Commercial,0.6140424288983012,20,2,598,866,268,79.21569148602237,9596
f6c36664-f7df-451f-b887-9d1810fc4e26,Residental,0.9867478192622952,41,41,315,541,226,75.01956643910435,6109
b14ac8b7-b0ca-4221-8ecd-5f6f8bc09a52,Commercial,0.5215660669646159,37,37,662,1041,379,95.26694322017978,4892
ab73b577-3b24-400d-9d9e-32d938e1e8a8,Educational,0.4059489830973988,2,42,245,991,746,53.30389733028258,6225
f01428f8-8f46-45f7-bb74-a2d39ccf0f63,Commercial,0.22634554590739242,32,43,508,1402,894,86.14443540897447,5538
410b77e9-1de2-48aa-9552-47980aaa8a45,Educational,0.4906793697416886,42,9,715,1429,714,16.479608604474905,4204
4d7c8bf3-b69e-4040-a3a5-c853ecb4299f,Residental,0.43266299039842937,44,31,365,572,207,37.93682162566601,8386
1cf33756-f870-4784-91f3-61081ae119ee,Healthcare,0.8348680094599629,37,40,296,1355,1059,68.03825160600587,1291
c10daa4a-d8b3-4e90-9527-6a9d6e29afd2,Residental,0.3563409878386987,21,33,409,1188,779,77.17316498583047,9012
0a2b69ae-993e-4093-9af3-42543e1b7371,Educational,0.009080173352995491,21,8,18,1156,1138,48.443907306955154,9795
ad6d86f8-a648-4cd4-aa44-b6b6d865f295,Commercial,0.7276338615891782,22,8,560,673,113,22.89532556819215,9123
ced0215c-d583-45c9-b8c6-87fe957b2484,Commercial,0.6418519936975036,42,7,138,299,161,21.49852057929418,4158
c6a7673c-ea99-46b0-a197-81bb2779b65f,Educational,0.14185384671719026,28,8,384,810,426,57.65522940328065,1416
80ba0343-8293-48ba-9453-cb144e94a7e1,Healthcare,0.8198784329585391,28,1,320,500,180,38.451932907426425,2315
0188753c-c2f6-4ea9-bc4d-40706278356f,Educational,0.505079381644401,48,50,198,1015,817,56.881066150933414,4102
467d55fb-7077-4a69-9c0e-4a94b1973246,Healthcare,0.21661179791352714,32,37,594,1134,540,86.35317450128507,7540
18d05bc9-b546-4c5d-9a82-6e5a3cf88898,Commercial,0.793824168640443,13,33,213,1190,977,21.155163244265154,6117
d304d34d-adda-4d0d-9fc4-46617584ce2d,Residental,0.36820181137966757,50,47,144,501,357,41.14666195154628,3538
960f313c-bf5a-4c7d-bc2a-f7b990d6ec9d,Educational,0.03001066745365022,30,14,650,1270,620,45.25470300775148,1648
7e06c742-3b2d-4252-b032-bf0b30772528,Educational,0.1965967117988897,6,39,635,914,279,91.32424484197959,1673
a3cb3361-8cb9-4fce-b68c-d628312273ab,Residental,0.41082637334680205,48,16,691,950,259,97.9109023870758,7871
09b0709f-1e9f-409c-bac1-87b4c83d4be2,Healthcare,0.6381057573485368,45,17,650,743,93,17.038538099310244,6429
e5f1ae1d-6b1a-4b8f-835a-9d9860dd69ba,Commercial,0.5490851124155198,8,19,643,1332,689,98.57162959060963,7453
c7c18d55-d427-48f4-82b7-627fc5e5fc93,Educational,0.6984087864145406,17,3,198,1331,1133,77.54506501822766,5441
188690fd-d127-4b71-9d63-728830c00d28,Educational,0.38230972782251915,3,2,544,787,243,84.56736964970911,3770
1913e1e1-1a14-40fb-b195-6ac921dc97cc,Healthcare,0.6886053734252073,39,34,202,1279,1077,31.801412134432148,4329
23c62e75-727d-4490-84a1-e4aa80e19348,Educational,0.3891349079703449,37,36,74,1042,968,84.31325165839154,9916
a9fcbadc-3f96-4fa0-8474-e62fbf685ead,Educational,0.2452672719695853,45,21,239,875,636,71.7030194737186,5010
801d5149-ae80-4434-a7eb-9cbef8d96b67,Educational,0.1638993977231279,31,2,61,1191,1130,34.11844546146958,3965
0def6652-2c9d-422f-94da-75c6eb5428c4,Commercial,0.5304672921708178,39,43,72,617,545,15.431919709824626,6065
f306636e-afec-444a-868d-c2c11e9e0191,Residental,0.15213849870669516,1,27,413,491,78,77.74161840292722,6421
76de38b0-f856-414f-aa7d-4836df0efaeb,Educational,0.4103510599038803,8,22,66,290,224,57.593501810409215,3628
6e2dcdc0-148f-4f05-8946-3f00b9e8a691,Healthcare,0.9756803752317774,35,18,258,985,727,35.03872734604488,3310
a936790f-3a4c-45ca-9302-4c0df68f06fc,Healthcare,0.28733036366344056,16,12,611,832,221,55.13383888962964,9010
e4f29d56-7565-4ab9-9872-bcd64e21201a,Healthcare,0.2938777854394172,34,18,259,516,257,49.715286257452235,2142
9fcf7246-b2d2-470a-8a40-4f81d48e19c0,Residental,0.8388430121075549,3,39,676,800,124,32.065103916536714,3363
8e158bc0-dfcd-4a38-819e-53d442994551,Residental,0.5463871440256084,47,11,117,907,790,33.546271188960986,5346
f2130282-30a7-422a-8639-6ac625c7fc1c,Healthcare,0.3774760053482211,30,44,125,799,674,12.575628289707314,6984
78baad7d-ad16-41f5-9cf0-e657cb2d57e1,Healthcare,0.8588810699924072,50,24,281,1386,1105,54.89558697383384,8726
ebff19ff-00c3-4ac6-848d-115f5ef06a4d,Educational,0.853379944939085,8,26,8,70,62,21.949086516123387,9927
921bc211-9280-44fb-b91d-5e522bad8484,Commercial,0.5969729871650039,20,4,76,309,233,42.17510919237761,7950
d470c149-0335-4f94-8cfa-812d99719ae3,Residental,0.7002110088361134,41,28,400,1302,902,57.571413746888666,6521
078a2f5c-353d-4d1b-a3cd-9ea3d6bfbc9d,Commercial,0.9541237215481255,1,4,372,753,381,58.75365035648013,2027
67bcb0e9-189f-4a95-ba13-32fe9ff5b5c1,Commercial,0.41076816545700123,41,45,425,444,19,39.40478943539311,2453
598d9f84-8117-4ec8-bd18-9e96af01ae39,Healthcare,0.017091244372421488,10,22,176,346,170,91.19901912888675,3362
f5319e2d-72b5-416c-b6c6-e936ba064353,Educational,0.6291549677002867,23,49,8,444,436,10.125047677876417,6816
5dfb35f9-c8d3-4371-acbe-2645da3b8397,Educational,0.9844987739513993,19,32,71,670,599,86.11271780511166,1653
759f9bfe-be42-4c78-9f9e-79a68b45b57b,Commercial,0.7591847668746304,47,41,511,801,290,43.38193965905452,4149
86ff0eaf-47b8-458a-b8b6-528b2e10eceb,Educational,0.4905340900294479,14,18,711,1030,319,21.520733461751814,7349
168c9b77-441d-4c34-84ca-50b49bdc9de7,Residental,0.5199108773610331,7,38,304,725,421,27.330088785986657,5819
7941e0b2-a289-415d-8af2-3b8dd77fcd1c,Educational,0.010129972497896822,38,29,484,1330,846,64.60330157318315,2208
23d2f097-9521-4157-821f-9c1505a7139c,Healthcare,0.7513486656923606,26,37,216,451,235,33.91192734827068,3173
365c03f7-d14f-4e65-8ebb-6d654fa96cf3,Healthcare,0.8043537029278052,5,18,50,185,135,17.766078911207188,7407
89555da5-a106-420e-8a0b-08e9959dd0fe,Healthcare,0.7311944741194412,22,17,687,1355,668,41.89190503982694,5506
aef8271b-a7fd-45ed-88c1-afa6f3604554,Educational,0.15669010362302438,40,42,204,923,719,89.1410944217241,5360
8dcb9fee-a2b1-422e-98f9-abcd3f39b96d,Educational,0.2545991262509295,6,44,572,1099,527,65.93288769267244,5865
86a4c7da-de2a-49db-8ad7-22727ddd444d,Commercial,0.6594206778130512,19,48,190,1060,870,99.40367098010772,4058
b26031d3-5431-4fd2-aa68-c3584df32db7,Commercial,0.02312560553427545,31,8,260,561,301,59.955932820367956,5461
c076eaf3-942d-46b4-8320-c589fc3d91a9,Educational,0.07421039895218406,42,30,650,1213,563,42.107552243324,7201
222ae870-facb-4f2f-b780-d95b26743654,Healthcare,0.40088806441008107,11,10,685,1390,705,54.8015078561748,8310
d1f87bad-e062-4b48-859e-9215d416a9d6,Healthcare,0.4164125098043575,24,3,6,1104,1098,74.71109627992753,5218
ec889a1b-d2b3-490f-8775-e80bae5d48bf,Healthcare,0.0017815195959052232,14,38,374,493,119,66.18337155895252,3851
f1308b74-aa93-4fff-a4e0-28a8814ed04f,Educational,0.012150536619869645,2,12,57,964,907,48.71990964738559,6755
faee5cf6-9bf6-4c30-9be2-e41a225be310,Healthcare,0.38066021167399433,20,31,159,1135,976,46.60519212853995,2100
30006164-eabf-4a72-9791-cba8ee5e4686,Educational,0.2249423189597498,45,6,136,980,844,23.70582057860863,8086
6ffd5de5-2a2c-4922-aabe-0f5cb75ddb40,Commercial,0.5566804134568326,5,28,631,856,225,18.91582187950939,8575
54ba482b-637c-4b0f-aaa5-e0f4bb77086f,Healthcare,0.1991068941433285,47,42,239,1326,1087,95.00396356940155,2886
8238208e-6a22-4802-8171-058d9928a9ac,Residental,0.18991332592321486,47,36,354,1187,833,33.063133795585614,2734
3747b609-b98d-42ee-b9f7-67c3317dc6db,Commercial,0.7431892540465439,41,38,488,676,188,64.07976623860881,9470
31c4daf0-ee17-44a6-bd0a-f10ad24a48f0,Residental,0.16758273207775642,14,18,110,365,255,43.590502115815795,2311
d0427395-2a34-4e27-9901-8f95f188380e,Residental,0.04735862512537392,43,6,544,1358,814,25.085627303294483,6483
45ac1181-d2f0-419a-83d9-73a6a23a410b,Educational,0.6278707094709156,1,38,235,484,249,57.70203595274879,9884
c90f832e-3850-427e-af9e-cbc0c17be8d6,Educational,0.2895062768760932,50,8,503,746,243,20.082639805445087,7212
a24c18bc-3eca-4ab5-984c-e81208ee739d,Educational,0.0544597435365376,43,26,182,913,731,77.08074133897169,1899
51b850f7-03b5-4aeb-aa7c-baf3eee954e8,Commercial,0.8209915892008187,12,26,395,449,54,96.64908232916312,2947
c0d99548-436d-4432-9593-2861b8c530ad,Commercial,0.03346430262674094,43,2,265,581,316,34.06281892480679,3933
b6892c14-0afa-445c-95c5-049712931760,Healthcare,0.7468352253654753,30,7,636,1135,499,14.240144172906973,4542
944db598-ce57-4a4b-96c5-a5a34c2eba7f,Residental,0.15297157314293208,6,13,57,578,521,51.591302499353674,8366
a6a377f5-2562-448b-8954-7f9fbe12d15a,Educational,0.9103917191672427,24,23,358,941,583,32.315310795927076,7857
eec52e53-ce29-477c-a82a-16c3eb67cc77,Residental,0.31243307851846125,12,45,448,972,524,19.49710789732582,7479
c94a66b8-0941-414a-a76a-cd98462f7738,Educational,0.06117376158443666,39,44,83,364,281,39.48068740137905,4545
a3e240e2-bd73-4a4e-ad13-7daecfd7b894,Residental,0.9703184209819148,31,36,364,1024,660,20.618769499489254,8839
8a234f77-5c71-4986-b042-c08d27db0106,Residental,0.802628612171646,35,22,72,1201,1129,72.83632930606817,5609
e3c0562e-4c37-4d49-9450-701700c2294b,Educational,0.41464567536927865,13,23,610,810,200,87.19216470563197,3592
554af5fd-185b-42a0-8881-d993d51448b4,Residental,0.4598928133520507,31,43,466,852,386,54.8294642236929,1094
409181cc-9d32-4e94-8748-bab23fbd37fc,Educational,0.641791581495397,42,28,543,1353,810,24.586113322475498,7274
eb64becf-1541-4992-89a5-37cc4741fead,Commercial,0.05986647096701292,45,23,610,1331,721,32.02564663838679,6250
6de1885c-f72f-4e71-9f01-c1533df04354,Residental,0.02276738106208598,3,26,666,673,7,49.28272762073284,2156
c7c4e1c4-9bc3-4d68-bb40-ad39f37f250e,Commercial,0.7522936704588964,26,34,183,487,304,48.15659777729194,7674
53cae579-75b1-4ac4-a980-00bf447b8360,Healthcare,0.3132948401018232,40,18,360,791,431,34.263885825196034,1666
70d7af4b-56d7-40fc-a2e5-cfd2ee68e592,Residental,0.6089662972876823,15,50,83,197,114,83.92839954536885,6637
59166f1c-616e-4086-8b8e-01f68a0d5ab0,Commercial,0.4341437247839862,5,9,494,547,53,70.64105019027089,4599
0f93c0d7-de28-4e78-af0f-65596981e527,Residental,0.2474939937064905,37,30,424,1307,883,90.38180201528554,5656
ffd4f832-f8c1-44fc-8739-93656fc0ae5c,Healthcare,0.12965470886498653,17,33,658,1063,405,56.58195681775886,6493
cd9ebb43-c4c0-45f2-8f4b-5151636b9867,Commercial,0.15504189510166333,12,46,211,1039,828,35.648693320895525,4835
54b36c6b-e6e6-4882-884a-f4330197b169,Healthcare,0.577357687560283,17,41,474,671,197,72.893282912872,2416
31c67217-f00d-4e45-af66-aec6667be9fc,Residental,0.3889401053771536,41,10,661,1049,388,40.29115503711332,2800
bd76360a-1c2e-45b0-b7f2-ba75e095724a,Educational,0.10796934621695153,45,43,694,722,28,27.954472912150074,9470
a2b31c85-0dcb-44d2-b4d6-782321f74a14,Residental,0.897040873872264,44,50,96,489,393,66.86204627181584,9673
e5bb6283-b852-49f7-98b9-6fb865d4064b,Commercial,0.9954626371225248,30,11,263,818,555,94.29799014989469,4034
d4aa6291-777f-4883-9553-7b0eaee88c9a,Educational,0.557620037118226,15,33,213,1006,793,60.60917092820081,2781
4318af4a-3a84-4279-a69d-151315413d1f,Educational,0.12686545135757132,28,14,151,988,837,11.289575480461226,2573
5d249a64-bc91-4944-b7bf-657f763f5740,Commercial,0.1780921138457381,15,40,89,590,501,67.39497798260035,3518
04d2c422-b5cc-4b7a-a128-4d196d07db44,Educational,0.4374921665053142,19,2,76,594,518,92.94629822333359,1132
f55bf269-3589-40e1-b83b-3ff5964577b2,Commercial,0.4761727636202444,14,9,592,1396,804,36.922587549877186,2493
8b159668-6eec-4468-a987-268a692486a3,Educational,0.006231886228289518,29,16,644,662,18,35.720150419891674,5543
01d464c8-16d8-43f6-a4d5-a57692a23aed,Educational,0.9431765639148654,28,34,199,1249,1050,97.64445647538625,6251
d350b781-f57e-427f-8c0f-88ae8e70878f,Educational,0.9788432982402585,50,1,562,759,197,99.36256544647222,7614
f7a3e4d4-c582-46b3-8afb-cc5e5aacddd6,Educational,0.3099503993518893,44,39,37,895,858,84.80609625129708,8172
54938849-05e8-426e-a04e-3bf2b0db44b2,Residental,0.19698907068866323,4,12,377,503,126,64.48240667043638,9653
d1438ab7-92ba-418c-b4f4-24f2f64af7bd,Educational,0.3728880895526877,39,49,519,724,205,85.87178606071261,7705
e991eb4e-a40f-4518-adb7-71e67640bfe5,Educational,0.5800776274495727,32,32,121,768,647,51.15682831727046,5222
b86342c2-7c81-47e6-b597-160550e4bc0d,Residental,0.17592775121644044,5,38,74,328,254,19.938174213123386,5649
7c4edd1c-e057-4949-b3d4-36347070e46a,Commercial,0.9850354054555033,46,13,216,1151,935,70.50837802305367,3379
22d0a052-e804-4026-9d4a-4ab673694bd5,Healthcare,0.8840330843843633,40,50,243,421,178,57.8179715597162,2399
bb7e4ddb-802b-426d-88a9-c88b95d7175f,Commercial,0.04649769826168326,9,16,361,1293,932,47.998675544971775,5548
6bee9476-2691-4151-88e2-07d6dc8156bc,Residental,0.5585292386557451,46,30,362,1115,753,80.89420675156788,9390
8e2b2b8b-633b-4173-b5b4-8119bb5a57f3,Commercial,0.15041063689766276,24,25,264,1103,839,96.9460524692008,2115
03a8331d-4ef4-4608-ae22-dd85268b6b16,Healthcare,0.837031101373204,32,28,392,734,342,51.41914675788792,4531
ac572be9-82f4-4a48-8ce3-381b0a4dc444,Educational,0.6386330568679591,14,24,135,238,103,69.38881756133404,6501
691b7df4-a61b-4eca-b547-d37983a0d7de,Commercial,0.059158180311500774,31,35,697,1165,468,39.47793367960017,9139
49c370a5-b29d-4ade-b8b8-260d346f2633,Residental,0.7743368646061726,50,28,6,198,192,75.66747638331015,5843
0f2acfa3-f75f-434f-b899-9db542ab8e53,Commercial,0.6724127385856722,30,5,561,593,32,74.45991098939855,2961
37930d73-7c5d-4340-824d-dedbe27e2d1f,Residental,0.25283389405632717,44,13,69,1032,963,81.03352869609608,9655
cf54b5fa-e419-454c-a567-0e9bbdb7383a,Educational,0.16312705350740386,5,28,421,1438,1017,73.86322453187671,6675
4b2f2a1c-da91-4010-aaec-7a30d87cd1a7,Residental,0.1989725031262014,6,18,621,1395,774,58.18148979257502,8440
24efc6d8-f977-443c-af07-4ebded18c140,Commercial,0.503113296424016,13,13,123,711,588,90.43754876130458,6388
991c7f70-dcaf-4cf6-b07f-8d1fe582affd,Educational,0.4511242913642869,6,16,109,121,12,83.61054061848868,5258
365dd47a-e7c8-4ec2-bb3b-4340c7a75312,Residental,0.8556299679400367,32,49,141,1356,1215,23.972813052547274,3685
8ea7d514-ffc2-48f0-b740-18034cfc1a72,Residental,0.43042230790883806,40,17,717,1062,345,69.86185108824165,2673
db716d10-aeb0-4b12-8b8c-c899d3e18fbf,Commercial,0.4450834575927003,13,24,422,576,154,91.92131054360574,4455
810ebb92-2342-4467-8bdc-8531a9e6f8e3,Educational,0.6494078253806542,6,22,243,782,539,65.47688116328756,8800
3710b6ab-4c0e-4ce7-bb1d-c89e3316462e,Healthcare,0.37018241858761636,14,18,419,970,551,90.13786637116822,1252
0b6426d1-bb4f-4ea8-91c5-63faade73a22,Commercial,0.8391668462642404,3,41,713,1371,658,89.82701220324566,5840
af0acf86-74e2-4829-9d68-5275688211a1,Educational,0.8297092531630285,22,35,198,732,534,39.994638151505704,7545
0aec025a-4e25-4080-9593-f8026dae1af3,Educational,0.6170164184859818,33,3,246,1297,1051,18.539838224879663,9318
f0e23ea3-6073-40e9-86fb-b9edf9357a52,Commercial,0.5343298919755282,45,8,700,788,88,65.12782610876984,5186
872d7bd9-1720-481d-8e00-c2178000de43,Residental,0.4495759399934066,27,49,430,486,56,76.4782446218095,7092
1b67bb62-e669-47e8-be47-c239384949d4,Healthcare,0.3725390550043858,41,33,132,360,228,78.91311468971224,8717
b46f5cf5-2a85-4ae7-899a-b50f45b1fabe,Commercial,0.17073022727687492,21,7,419,781,362,83.72936915241989,3946
ae3eb4b1-d030-49e7-895f-9d748e2cd08f,Commercial,0.6899826621777496,5,44,331,665,334,64.98711182868087,3095
8f7bb427-6591-445e-8c58-fcb6ab0e911d,Residental,0.14986128883234262,27,9,353,404,51,59.421460454372024,2873
28e92e9a-158a-4ab5-8b25-df7e3dc3a234,Residental,0.918231447426455,36,45,186,409,223,94.41362120198573,4070
b1f59e09-d49b-484c-a277-41d67ff7b0d2,Residental,0.09845602453047886,37,44,692,1047,355,62.57358433001688,8232
9d4c8cbe-6a97-4820-ba4b-3e6b817e0130,Healthcare,0.22198889583908543,29,49,227,287,60,96.18772057825467,2176
67483a45-9677-4155-9d82-fcaf9982ae25,Residental,0.4119245068829873,11,29,198,524,326,62.30567688503601,6564
282afb3c-246a-4cbc-987f-dfc7e305096f,Educational,0.8345736885077185,43,45,146,1186,1040,64.01577842277041,1248
9b2c852b-9427-4af2-9039-cfc2438ada4c,Commercial,0.5658777875567116,7,2,720,800,80,45.2301997387197,3311
d7f07295-d091-4cad-ac8a-3e22f4bdf677,Educational,0.4691562527653811,43,30,702,998,296,75.40239002932438,6715
4cc24475-57b1-4b31-a45e-fbf7034890f9,Healthcare,0.687501270668701,42,28,669,1323,654,95.98877288424367,4001
3b99e74c-ddc9-46be-a246-814d19f5bd0b,Educational,0.49253442450456475,30,37,204,465,261,20.508305078392613,2018
6199f909-dc49-49c3-8a14-e79fdf63fc23,Commercial,0.2275925098411271,15,45,660,1338,678,10.791704229392687,4267
d77a2d71-bcd0-4094-a43c-20e2b7436b70,Healthcare,0.6041212603941438,11,45,679,1413,734,29.85561891311257,9940
0ea08a01-dd41-48f0-acbf-7728d2d7f9e1,Educational,0.6178996090605036,28,46,145,353,208,13.599231629873849,9944
10a2e54e-b6c2-4414-8986-dec901d447ff,Residental,0.24197686557785125,48,4,17,112,95,83.03986958280404,8473
d9c58ec1-057c-482c-973e-b4f2825b5020,Educational,0.38892079296148496,32,50,672,1216,544,53.961201144749296,6332
d9470827-f851-4b54-8592-3afc34c1781a,Commercial,0.565854891556522,22,5,376,476,100,27.230048497784495,5085
a1f5254f-22d4-44ae-890f-5e75583746f4,Healthcare,0.07842322874171748,25,13,44,147,103,81.60780293692993,8818
25a90fa9-9f97-4158-b293-aa4a43a2e879,Commercial,0.34160751277777934,38,30,368,515,147,95.31254815018431,9773
9d8ba9ae-ce17-4bf3-b4ec-254c352ecd99,Healthcare,0.36655631825325063,4,49,208,1370,1162,92.9386797557781,2847
bcc3f234-c60f-4329-a249-a6c9a37c9259,Commercial,0.7044504620323033,45,41,292,1091,799,65.83457947775648,6393
9d8948d2-78ad-4f59-8660-d487fd33610c,Healthcare,0.2395450229237447,37,39,57,959,902,63.25415782560556,5134
90b126ff-9379-45f5-92ba-7cadb9cf507f,Commercial,0.1851597288906205,12,47,174,543,369,36.23975405138833,1417
3f73ee77-e7fe-495d-ac63-c5883474b0b4,Educational,0.8396748111821919,35,6,322,881,559,39.809523659758376,3132
bdc74f06-86af-41a8-99e5-73295131d034,Healthcare,0.7631556041826214,37,49,296,498,202,24.92794125599687,1889
5641e385-73e8-4743-b927-8e4961a76fa0,Commercial,0.5096062538754511,9,4,524,618,94,60.722266713602856,3175
1dab2c00-82e9-49b5-9723-ffaaa454b453,Educational,0.6583717792051683,38,45,270,1009,739,14.282412249423583,7670
204ed75f-4229-42a0-aa1f-2b00f23128e5,Residental,0.12043386840089587,40,33,384,1178,794,16.31814865352845,4290
29749647-93dd-430f-b244-107af24ccb0a,Educational,0.7199306805968088,35,32,546,958,412,56.152377492046305,1753
688d599b-ad8e-4a4e-a42a-dd5f0328a1e2,Commercial,0.8930139054056287,37,29,50,349,299,17.379919613973332,1119
48979520-a53b-4b88-8098-399e49e894f3,Healthcare,0.39550921022573393,11,45,376,646,270,65.39379821355168,8510
2c678065-5eb2-46f7-979a-4c1d156c7d8e,Residental,0.27053835072817245,41,26,51,82,31,63.750293824414975,7782
ed0e055d-8e12-48d7-bd8f-c2f050ab0e03,Commercial,0.19444127521576815,12,24,718,1248,530,29.29363344186764,2558
818f83bd-5c57-4ae2-ae5f-7ca1ca285999,Healthcare,0.30626131631295284,38,37,653,1096,443,26.790928918217688,3290
da649421-3416-4233-a6ff-193c90bc377b,Educational,0.2268621586893187,44,8,92,414,322,55.49326021226175,9739
bc2b7b06-f588-4c6f-b16a-d2c38e6d5d07,Commercial,0.8385373939486054,21,45,115,1360,1245,96.28264971932461,5722
7538100c-1a2e-437e-8044-8e15278956d2,Healthcare,0.4906830589341572,26,34,611,1006,395,52.34074024065072,8414
2bb73537-ad65-4554-8e45-feab98a707f9,Healthcare,0.8565995925078836,17,2,373,744,371,52.43869172164651,4457
ff7564fd-339d-4b4f-b09d-5950e8978a9c,Residental,0.5711926247566684,21,21,431,690,259,13.409804744113918,3872
15a72a94-2fac-476d-81b9-b7aa514b3894,Commercial,0.270039248679653,48,31,264,1010,746,21.35218901721381,6832
4bb2a166-8f6b-4ce9-ac1d-74b2f178e11c,Commercial,0.30749464552432204,1,39,304,1327,1023,47.473269872074574,3290
36b4824e-64a7-4173-9afc-e2871fdbcec5,Healthcare,0.3126695113470236,26,21,241,348,107,85.07484870308565,8213
ca981605-8bf9-4dc9-a7ab-d335627c4f62,Educational,0.24357064195338007,12,6,684,866,182,36.271509602829966,7361
db6e0ec4-b549-49a2-87c4-e6bc43c4ba7e,Commercial,0.06686832605256221,23,39,318,573,255,56.14590445110453,7670
212a7bfa-3a78-45b1-94b8-3a8b3c2dc7cf,Healthcare,0.7389801350106495,29,25,633,991,358,70.07325786114393,6228
d539f190-8677-4134-a038-8402eb892856,Healthcare,0.30057095168493975,20,27,316,913,597,81.85307137847656,6145
e46ce514-51b4-414c-851a-af5f90af7311,Educational,0.6040591815147974,3,29,638,1023,385,36.23869020133731,1843
afc53f4f-cdf3-4dad-8f83-0352c00958ff,Healthcare,0.3072895533677522,8,7,150,844,694,62.62324947105859,5411
41f4a20f-2121-49ed-a24d-409a44a0a188,Healthcare,0.8130913828999603,3,3,134,1196,1062,85.95348087165343,1089
08b9fb92-ae6b-4782-92c3-55a99b68b8a2,Healthcare,0.11102980243956695,17,44,159,751,592,50.325565622177834,6806
1d0644ba-f6c0-4033-8f13-15b62e7e151e,Commercial,0.713224726711199,28,46,452,886,434,24.781237175805728,8931
092941ed-1aa7-42fe-8051-97b79886a22b,Educational,0.346292125853762,42,46,605,862,257,96.05458223937542,8052
e16b31a4-c0f1-4aa0-8d5a-d1a347bcbf8a,Commercial,0.5756218743074312,35,24,209,1028,819,44.29107965315176,7990
2b516594-dbad-46c6-95d3-afda012bda9a,Commercial,0.1308198010059778,34,42,137,516,379,83.14410219742685,6578
4131355b-4d07-4260-a571-cff0e72079cc,Commercial,0.3008697081692818,4,21,255,1187,932,16.295451982109512,5723
1cb02eb3-d33a-4381-a554-68ac59b669f2,Residental,0.5264222128016536,17,16,137,720,583,95.73285052620597,7100
6c7c096f-d277-4b20-b697-e092b1f20b86,Residental,0.7083427708813167,8,6,58,1326,1268,56.99522329158978,8606
9bfd979f-e8c6-4697-9a8c-8d2ee612cf87,Commercial,0.07663936798831916,40,39,101,149,48,92.0641837644983,8885
e7e866bc-dae4-451b-9a8b-2a538618a224,Commercial,0.19399652648841947,3,26,563,710,147,86.60889049719341,6652
f8e4061d-8d59-4863-ac41-2ad4c882a33d,Residental,0.08648254332003313,8,21,51,593,542,88.83106125339523,7111
b2169b59-706c-4d18-a9f4-701c878f474b,Residental,0.41940040105975207,14,19,374,1319,945,52.17014787928932,3138
6ab719a2-07bc-4dbb-b863-f207b1d60871,Residental,0.9402384152729869,8,24,67,625,558,21.232825535555335,6601
668e937e-aa46-4fe3-9ad8-a22d6c0bb94b,Healthcare,0.6241301723902661,46,34,264,981,717,97.61324036862862,6170
ba7505cc-8e49-4d43-9103-473fe819b585,Residental,0.23494733062504702,48,30,586,1398,812,55.90256518945804,4491
d9441b84-3171-4e8a-9caf-bb4a09694d65,Commercial,0.8421636210017,21,12,180,1103,923,46.523378320020065,7499
5e3d7faa-ce77-4bba-aee2-213f8f687bee,Healthcare,0.21400832324118968,28,46,103,640,537,23.84128794876775,7596
5136d470-3f43-4bd4-8b68-23df98e122c7,Healthcare,0.3961736471338203,22,16,375,887,512,22.815141238276404,2213
c0705b67-3c71-431e-ab8a-7c2f7ec0ac32,Educational,0.21304329165813596,26,18,576,913,337,65.65072272905451,4472
784b743d-0a1a-4405-a247-4a01376b8ca9,Educational,0.40854832514701056,9,40,90,1358,1268,27.8637982401825,5297
55191ae7-6a45-49a4-b1a9-94d19845e690,Healthcare,0.9740674626482108,47,11,502,803,301,78.74114923069195,5967
9abbbbce-8e32-4c59-8b43-7585c7e09e6e,Commercial,0.6806729256428218,28,39,689,979,290,97.17420395371332,3202
f55e60de-753a-405f-bcef-d162ecc5fd03,Commercial,0.4281288577135719,2,13,8,486,478,86.60323470826607,6512
12dc0260-7d95-4ba7-a039-6d3bef25cc6b,Educational,0.9732250023902255,34,1,560,1247,687,93.78923693847366,5705
67d789ac-1742-4f82-862d-e7d254ec3963,Residental,0.5220779228309687,28,4,450,615,165,50.78361203266551,8119
52ecc785-051e-441a-8ff0-f0027f07391f,Residental,0.46350110643078757,50,10,360,751,391,78.85767386554149,2981
ccc2ac35-7e83-4e82-8460-af92387bb0a8,Commercial,0.719869512790258,16,19,632,862,230,75.9088420771298,1600
39b3e006-4245-469f-a90c-c06032594e7f,Healthcare,0.0028486751925423937,17,25,610,817,207,97.89363276438937,5351
3155292b-38b8-4e0e-9b43-54246b944f3b,Educational,0.4010979976526713,3,1,357,1240,883,19.889781227476867,9570
4a1752b2-2513-4d9b-9a4c-fdaeba9fe788,Residental,0.7666038318100508,26,2,239,1310,1071,68.22604073040716,4796
4ba190b9-839d-4a51-9b62-53778e242a0b,Healthcare,0.8470327126378782,34,47,463,1031,568,89.89899679424826,5404
a871e1cc-48c2-490d-ab80-3510a7ad0dc4,Commercial,0.6041843850144643,41,42,69,1301,1232,15.403051415992119,8095
c6588a54-213c-4318-9579-903b61056105,Educational,0.2302247138430955,31,14,453,1211,758,90.63589923765085,1241
6abcdad4-b61b-4ef9-9de4-d3c665868a80,Commercial,0.714573481456452,8,32,89,209,120,79.33291730252455,1025
9ad469af-cb15-4ec0-a486-36b7c2fc058a,Educational,0.5739982576745714,34,37,100,1264,1164,45.710427310247596,2085
c705804d-8b18-47c4-a92b-59a0dd38051d,Residental,0.7061732568968996,18,47,510,935,425,83.21951418167859,2859
cccc92a8-28d2-4a59-b845-246170abe43c,Residental,0.3532832693696497,16,14,521,1122,601,78.9423175036853,2912
e683307f-bac7-4d26-b84d-e7d3fc31f160,Educational,0.8726448625625849,39,26,334,1172,838,13.7199421611002,8587
9e8dc7af-e892-4b2b-9e7e-6f6eccfcd176,Commercial,0.7345233232651225,21,34,566,1023,457,13.666847717152,4179
192ef3d6-c6b5-4831-920d-a8b5f8143889,Commercial,0.2468594023847862,17,30,652,973,321,45.99279831283106,1372
7f289e5c-b4f8-4922-b5a5-487a0ec58777,Residental,0.014559067004752402,1,35,31,961,930,46.525739221102285,2244
4e002552-09fa-47b9-b0e0-92f6ecf3d786,Educational,0.2942364951108336,33,8,128,962,834,97.25837669308744,3950
7f4a004d-9714-4ecb-bd47-0a93d2fc992a,Educational,0.35957756385325756,14,25,62,568,506,90.97680906012762,2661
1635ee92-bd9a-442a-9f34-45dfa293faf0,Educational,0.567427982521797,36,22,123,1081,958,44.26160222444629,5776
04353c31-c3bd-4eab-af4f-07793303bc8a,Residental,0.12279803366566677,37,36,306,1428,1122,55.39500742590749,1501
30c6a0d0-1bf9-4bda-81ef-4835074b8d58,Commercial,0.4660526759919973,18,50,41,1193,1152,61.237396787552065,8062
b9a47dda-905b-4dcf-97a5-31f567278995,Commercial,0.4957522991991937,30,35,300,704,404,97.41375845889537,1159
ee6e88d1-e0aa-4a1d-9213-5552527b1b4b,Educational,0.44451068589029685,16,12,595,996,401,45.32726653365198,1391
93ed12e4-c18f-453d-966d-5fa7a4f6d668,Healthcare,0.410759293406038,28,27,106,252,146,83.38208939523494,9744
e0aaf8cc-8e77-4053-a9e7-20375915aa70,Commercial,0.2249135873123519,24,12,9,798,789,62.25361300581909,6631
215b8a15-ec8d-4201-aabd-36891f60d9e3,Educational,0.0775894834036912,38,26,416,945,529,77.22898880430733,9427
5c791537-5441-49d3-a62e-0fe530494a0d,Educational,0.8167572093157455,13,30,714,1049,335,35.3423156402987,7024
b44c9332-48aa-4b05-b25d-fdf13aebf171,Residental,0.39165709359942635,29,42,175,1127,952,30.991029749334473,7319
56c71206-59c1-47d5-830e-fe933639ce6c,Residental,0.40503933903114797,12,37,629,805,176,21.282183167692853,7665
ec9639eb-b645-45c2-9486-fee3731974c0,Healthcare,0.4963126593329621,9,40,70,323,253,28.56675026359281,6016
70ab6977-a726-4bbc-8ad4-afdb954c51c4,Educational,0.5090104329941408,14,24,542,1327,785,13.808283073606521,2933
137cddcd-0d3c-4960-bcb7-f3fea5aaba02,Commercial,0.170403280527051,30,21,678,812,134,60.92328044641954,1706
d0fa22bc-559e-4b2e-aedd-c9ea679112ff,Residental,0.05831077382204597,2,19,437,1016,579,85.37288412106196,5133
4f2e4b66-8d67-486d-b375-bded749ad5f9,Residental,0.26827103930536733,9,48,645,982,337,61.957793304369126,3960
59fce62d-0d26-4ef8-8181-092414eb2452,Healthcare,0.21440880031015008,42,34,229,1037,808,22.233670082847944,6944
59459995-b52c-4bb1-b627-89a3cbffd164,Educational,0.7867992716416903,6,5,623,888,265,50.702558979285186,5678
b9227937-932b-48f2-ab35-86d16b30da2e,Commercial,0.7022151435310898,49,46,181,318,137,32.06217983674554,8096
d754777a-512c-48ee-ae50-6264b569e77c,Commercial,0.3841669621988386,13,7,118,443,325,14.082628062726918,4779
8e31c4a8-44f6-41bc-aaba-0b02d59d8883,Commercial,0.0935873810007527,31,44,350,1016,666,23.05716998920435,7971
e5e1d42b-f13e-48c5-9320-e0b9c89adc5d,Commercial,0.33002846093933214,10,23,610,1205,595,46.51256586695311,4055
93a768a9-b145-452d-bc71-d1662aa2fc89,Commercial,0.08444039967678629,42,20,68,102,34,77.19735478929542,2262
8b5e02db-e255-4c32-be0d-3b12948508a0,Commercial,0.042560409826517875,24,17,459,1180,721,30.022230567097196,4095
9cc818ad-252c-4994-916c-c5409ca8c23b,Educational,0.9647459039168313,43,38,330,1229,899,80.56089684627652,6032
5b3348b7-34fb-4364-b6d2-1d07652faffc,Residental,0.5748168305568044,35,33,87,841,754,15.601685463112123,6686
6ab1d7b5-2e46-45a3-96a9-7ce04d67120e,Educational,0.26180361649524264,44,10,70,1030,960,68.60067190931146,8981
86b6c289-15d1-4381-a94f-b26978682391,Healthcare,0.8296673435774033,14,43,660,1417,757,18.20116796862363,1558
d20960c5-225c-4ea0-91a3-be1c808cccd1,Healthcare,0.6579463935977174,48,33,522,1384,862,94.18206484361835,3914
f2763b5f-51c9-44ce-9083-6bc3b5510e6f,Commercial,0.7612642113736223,1,26,213,915,702,67.68772586422838,7918
ec9cbe74-1b2a-4012-964d-2a7d6ccaf125,Residental,0.23368588166704873,18,37,407,1440,1033,29.046519509925464,4242
23403911-9713-4d1f-a642-bbe2cb40546d,Educational,0.022729237368565247,48,18,618,1037,419,42.29962219365289,9836
3ed533a0-81fa-4986-a57f-717f3fb8b126,Commercial,0.5885153223346167,41,2,36,804,768,70.88765811519923,4745
ba2c3ca5-3c7b-49cd-8de5-0931c16a4b25,Commercial,0.7633307654999513,33,13,671,719,48,58.98253091644103,9128
50c64468-f53f-445b-af77-480057c4b480,Healthcare,0.461942170623893,17,15,649,1147,498,73.30367792104728,9881
0f74085e-7170-41cd-b5d0-867c00df289a,Educational,0.45706613786846884,1,41,136,1206,1070,57.774629140709905,1960
ae51e1a6-0b4e-40e7-93eb-98314124f167,Healthcare,0.4445779928158955,37,6,425,1434,1009,16.727933609501203,6841
d644e593-a8ff-43c1-a6f5-783b9371d51b,Commercial,0.2874367630633573,46,42,257,1196,939,70.45045471637141,4947
8f0fbf29-9ba1-4a7b-9a2b-7e11eabbea27,Educational,0.18132808194115035,6,37,428,557,129,36.97591683700019,7566
7eddce96-4c1d-4f1f-9bb7-13437eb460a2,Educational,0.2043039435743118,25,25,143,1330,1187,42.16166392137058,2742
558468f9-ef11-438e-a9e7-92f6bfb9bd8c,Commercial,0.8217793981596566,48,4,423,457,34,60.06676797876258,4226
96b6150e-4456-4b6d-80b7-b8401c93c9e1,Commercial,0.4939710842442715,19,9,165,218,53,70.71477802539809,8523
f1dee351-e497-4ca1-9bb0-5201d7b45399,Residental,0.21688849533026244,21,41,361,918,557,32.72787758140676,7659
72a27f0b-5e65-4c6b-b544-1ccabbc4af97,Educational,0.7363818774240912,11,5,581,639,58,56.32152950016987,8646
18db7b9c-7c5d-4dd4-be4a-542ddf2f6d8d,Residental,0.9675160771467952,26,44,276,675,399,11.425256628885325,2963
ef9277d1-130c-4ab5-bf47-fb73b573d7df,Educational,0.10998439054701181,2,4,231,1045,814,40.051133888244834,1205
2f991131-2ff7-4712-95a7-6abc96ab13e9,Healthcare,0.08563395526612172,33,37,416,1047,631,61.01985039213689,6144
295fa671-bddf-4d87-aefe-2fe66082c95c,Educational,0.4120828663267453,31,23,482,532,50,12.664972766529274,4997
da95eebc-7674-48c1-9155-e75558eca253,Educational,0.9499998203471159,11,35,440,1087,647,80.98003690663033,1542
33886704-6cc4-4cf0-a047-598f8fd5845d,Residental,0.8834628784331754,9,5,538,704,166,45.15651551150079,7212
4efe81e7-b5d1-41a8-9fa6-6c4871c7ec2f,Healthcare,0.6694844616819372,34,21,31,214,183,63.917289971650845,9145
039dabbe-1434-4496-8d5f-c14ef4f0a349,Commercial,0.7520146192427142,37,39,503,617,114,12.913274707430283,4321
e70f0ddd-3a3d-4591-8244-a1ccc5a14002,Residental,0.5237399519447772,48,49,92,384,292,92.15708155735538,6897
0d7fc51c-c5c9-4cf6-bebc-89c0b50161d8,Educational,0.8447790291786245,18,10,159,202,43,66.63180887511702,6051
8d60627c-57cf-4a4d-bee0-9fd2da59bf2d,Commercial,0.529986077435724,43,7,247,507,260,61.216993651729574,7339
6dfae6d2-7844-4014-8180-e9bfefb98cf1,Educational,0.8077847463244926,3,36,305,918,613,94.12788763564258,9914
f3d0fca4-78ad-44dd-b574-32f842700a35,Educational,0.7437272980137851,27,4,464,1325,861,70.84647736465489,8178
37c8b76d-f85e-4409-b4a6-201e93985c84,Commercial,0.05104827009917401,45,5,228,1370,1142,53.62426386822001,7244
113e1fa2-86d2-4270-b8d5-40c8df1a3148,Educational,0.5010835271941316,39,18,149,1090,941,82.82988140705118,2656
8d73c35c-ddfe-4012-b2e9-7477e7a677c0,Educational,0.763953797328049,15,19,194,1424,1230,29.316062620967756,7905
6b4f64ca-2693-4891-908c-6e342b7d15b9,Healthcare,0.5380963691431946,36,17,174,644,470,92.86517769427704,5286
7c004e8d-9cdd-461d-a1f0-32b9138314df,Educational,0.8359542108216255,44,23,237,397,160,47.2761375077184,5466
3a0b4950-2c16-4737-b2e3-67f9b3800b67,Healthcare,0.626360271676186,48,31,49,1214,1165,70.48747737179119,7475
68cedaaa-7fc6-48e5-abfe-deb40c91e2b0,Commercial,0.8019990186478021,10,20,657,777,120,94.89215775656267,1462
c1c5b1a9-8bea-4280-9db2-8c7344058735,Commercial,0.6664461236109254,29,5,375,1023,648,39.08333827592445,4264
cd733c76-b31a-4800-9862-5bf575c889ac,Commercial,0.8264205531056091,26,26,348,1416,1068,11.548122360448064,1081
06cb468a-64b4-4484-bedb-56189a298c28,Commercial,0.2764097904847541,29,3,352,1097,745,95.63039077619834,4470
174908e5-3668-437a-a4b2-d79a5506bf94,Educational,0.6114538548707628,42,35,172,1392,1220,34.286366100492316,2561
b6fe8923-6a69-4c3f-a9f6-6d67e5805268,Healthcare,0.7907203967442425,47,23,690,1061,371,30.385386069230098,9292
8fd73fd9-e29a-4101-9bac-c6ef8f41a10c,Healthcare,0.3179252876213938,34,43,362,551,189,68.14701259886542,8509
80707b71-1fd6-443a-8fc0-deab5c0c8c44,Residental,0.1663620557147213,36,7,323,1378,1055,53.88945297312166,4610
4822b8f3-4cf1-4e54-bb37-c9abdd9769d3,Residental,0.14074539853085621,33,37,102,251,149,11.337183558609128,9056
5c69997d-2f31-4f85-b443-f4628a4e4f88,Healthcare,0.8282858753762978,34,45,195,434,239,75.22242570539201,2213
573923a8-9def-4ac1-9718-d6e4639d8bcf,Educational,0.5288459670902239,30,10,179,479,300,45.145332409079145,4784
82b0a152-8528-41b0-803b-25c998f83af7,Residental,0.29333618746806345,36,31,44,568,524,86.60537879720238,4677
26a16cf5-c126-422e-9404-442c1e4b9117,Commercial,0.9425257125629867,48,41,173,535,362,92.38864270265363,1697
524ff038-87a1-4b0a-b320-c9673c049e06,Residental,0.8095659459573807,6,43,33,1225,1192,95.01681004899126,5154
c44ae12a-58b8-415f-a4d5-acde31009ba1,Healthcare,0.08054763454072633,4,31,583,661,78,61.99035022514933,7124
238e1486-0511-4699-890b-2243002b9e28,Commercial,0.6104023474391823,21,26,502,1035,533,33.877079252392726,1490
80715492-12f6-4c5e-851c-c35bfd5fdedb,Commercial,0.7903449569792373,19,2,503,1074,571,71.87980666101065,6686
80677c5d-738a-42ad-a68c-e25d4df5407e,Residental,0.2485878469943268,24,39,99,773,674,89.97619511538343,7400
123756e1-3557-4ba6-9da0-1f11c4d1a8da,Educational,0.2902823233708759,34,15,562,1377,815,90.10662528676939,3241
a221d3ab-b975-461a-9a0b-17606db9254b,Educational,0.8700902511145683,26,28,694,758,64,41.456582076642306,5752
806fba86-7903-4df3-be73-cfe5f563c6b7,Residental,0.6621550669406765,26,27,304,866,562,98.95715435021692,4129
d77d763d-744f-4094-8b25-dd8bb0ca1e9f,Commercial,0.13826788326623485,31,20,438,690,252,51.35300904926313,4538
af001546-3806-4904-b5d6-7e038d9bc483,Commercial,0.1501767004071245,20,11,375,1238,863,72.01952270834576,1099
9ed70e88-ae39-420a-b2c6-2d5a78bedc5b,Commercial,0.28902607093876087,46,30,658,1123,465,82.53457751282635,2058
2ba3c1ef-a932-4ce8-a584-14c0fcd1b1c1,Healthcare,0.8295459824170514,35,45,615,1429,814,78.94928650859244,1315
7b371198-46ac-4e51-8249-3ee2e2026678,Healthcare,0.23779341679355281,33,30,566,1209,643,11.2125486280831,1459
49fba5f7-bb22-4811-b06a-99f0d706f58e,Educational,0.22218992812994165,11,42,475,1303,828,88.54492038805125,5611
9b936cbe-540c-46eb-9d11-092b26205452,Commercial,0.012762275793329558,18,31,538,1320,782,67.84665045482953,2825
a80ea607-6756-4c24-a64b-9706ffd90049,Educational,0.42900257986228396,8,31,380,1225,845,37.97572504522886,2843
53a7fd70-de8f-4468-9fd7-cacbc28f1cf9,Educational,0.1552259501657136,43,37,454,1400,946,18.67415197018373,8108
b89d7477-e2ca-454c-9ed6-f5f9f797f155,Commercial,0.45581787994276246,42,48,284,328,44,98.20608718501774,5467
d483a2de-c46a-4ff7-b108-dc7cf28a01df,Educational,0.5314370071325021,39,20,231,1225,994,75.76199502281784,7169
9e28ba74-1c3e-4058-a676-e735371571b8,Educational,0.10562852803105138,6,23,590,1344,754,11.656140474680335,8352
8542738d-fcea-4a5b-85ed-cb248a82481a,Healthcare,0.4381743776489111,1,25,601,1054,453,95.32973752798681,9387
f790f351-d994-46f2-89ab-3d240add1ecc,Residental,0.5374275938609674,30,1,401,757,356,79.86400149886191,8210
52b4d84c-61ff-4249-ac69-9ff33a77c6d0,Commercial,0.30022007713110777,11,26,630,851,221,94.07694181282017,9285
c8f6cbd6-f985-43f7-adff-4cb79aacd3b3,Residental,0.8344990654204676,19,18,640,754,114,81.97091246456982,6987
aad216cc-777c-47a2-94c3-4cc146e03398,Educational,0.06071959465157084,4,8,88,148,60,11.009424072643236,4438
4c5d5c98-47c6-46fd-8e7e-cae66ceab487,Commercial,0.09783556369263124,25,45,33,776,743,11.455050647758247,4285
fb6b2c0f-f539-456c-9dcc-dabe90bb5822,Healthcare,0.36278879096537964,10,33,485,826,341,51.30778899568959,4297
b2e8ba04-0d9f-4718-959a-3644a80d1a94,Educational,0.9233374642359066,50,20,422,773,351,16.580579895380495,3668
2f412654-7592-484c-abc5-fd7b1c4f8a93,Healthcare,0.30303508469997964,30,42,20,109,89,29.011022777868746,8096
36ef5333-456d-4af3-b899-fdbeca79c7fa,Residental,0.19886372809367336,20,31,669,1330,661,62.79753075859082,9812
761d4f06-12c1-41f3-844d-cd473ebe6d56,Residental,0.7652347512506222,39,49,432,896,464,24.935549077160907,3349
26ca2f47-9ce7-4b40-a98a-d48785689226,Educational,0.9395806797443684,44,39,172,762,590,13.959608409250587,5070
753f2ea0-4b81-4151-af47-8db296e48b0f,Residental,0.9552367921918111,20,20,208,1323,1115,40.612194381835025,5306
d98cfadd-f097-44e0-9d19-c9c70fca49f2,Educational,0.6467897126893859,21,2,330,412,82,79.47038242942683,5909
7d96fdd1-aed2-432b-b9e4-fa3a504f3606,Commercial,0.027449935250367208,46,1,425,759,334,16.797762568691248,1228
147efbdb-d6c2-4ca1-9b0e-0919c53427c5,Healthcare,0.40748936255431145,45,24,382,526,144,25.362532352120795,9716
3de1d8ed-69e0-4670-b5bd-9f3ecec294de,Residental,0.6800324433812794,45,21,302,1438,1136,68.84817087368464,9686
a81bcd0b-87ae-48f8-ae90-2f2032eb30ed,Educational,0.06809112138588347,23,44,452,1180,728,14.629518506762636,2390
0c21dd62-75af-42e3-85c0-353db19ab3d8,Healthcare,0.49333403643670115,4,48,44,307,263,95.0911728699378,9287
575bf64a-b803-4795-8e08-011b6077bedd,Healthcare,0.710589784255848,27,16,540,650,110,92.02504762771542,3471
58994e80-1bce-4413-829b-9e3e14ee2b10,Healthcare,0.038591479935995654,18,35,455,1199,744,70.38532610697625,6332
b58ed25c-1240-46ad-b207-0f2f2f78f524,Commercial,0.012125509626569553,15,10,693,698,5,72.25243440928259,7291
1944665e-150a-4dce-9ef3-3c611833684b,Educational,0.05771521087352238,35,35,494,845,351,75.67937603804124,8644
64faf6ea-c9ef-4943-a9da-d5835731ccf2,Residental,0.23836125352784443,7,27,632,851,219,38.14303655853175,3280
b9eddbb9-8e35-4b7d-ac5e-e2eb82bb82e3,Residental,0.283381598457331,16,26,151,472,321,61.907587705172716,1990
ce06b766-a33b-41a1-b247-167c4b3475cb,Commercial,0.8739130696101853,1,12,260,316,56,65.58966906091857,4224
b40d3724-0835-429b-b545-f8b9ab6cd32e,Healthcare,0.4678364000151287,26,13,584,869,285,90.32500148009316,6290
6abfa150-90cb-4d6e-86ec-c492b521d36a,Residental,0.4425354834976226,19,2,475,729,254,50.85120438367943,9650
42982090-bc70-424b-a2f9-84cd0659de33,Healthcare,0.36470009119697944,2,3,112,158,46,94.25905299908656,6621
5eba75ff-9d20-4878-b867-e3041a0a93d2,Commercial,0.08717833668302866,3,6,113,565,452,11.528812798869998,7682
87391366-89f1-4ca8-a6ba-164bb29b6fff,Educational,0.0018603022007455117,22,46,181,792,611,18.591586728608696,4480
f427e5dd-851c-4aa5-a9e7-cb300c61f762,Healthcare,0.6514037494290805,30,21,329,595,266,58.35456576420131,5056
24d01416-7d5b-461f-80f1-07b29c7321b0,Residental,0.47164506909644355,29,43,350,483,133,34.69183016511347,9271
7ac21364-1c37-4766-9c80-ca42cab06410,Commercial,0.8093925976336573,24,26,708,1386,678,90.00879079559569,8215
8061838f-1308-49c3-8160-c4d62a58c744,Residental,0.23492893873439613,16,48,312,840,528,94.12626925931258,7834
9eb9b0ae-2182-4681-8636-49f6bc6758d3,Healthcare,0.18601297200224065,5,8,697,1115,418,83.65112885338057,6661
fcbb7bd3-2df4-4c7d-b8c4-a6dadff5ddaa,Commercial,0.6213190180933614,36,49,202,1113,911,98.18980343604602,8998
0e6dca86-ae44-4ebf-8c01-1c32bf19cc21,Healthcare,0.4872973246751643,41,11,530,825,295,33.51988336579086,5348
54554538-cd51-4884-b18d-d5f7b4b60343,Commercial,0.48961048537058893,29,39,491,801,310,56.41201599181642,4136
8d9c62bd-7894-4ab5-af13-62dd0ba6ca08,Healthcare,0.352533514148606,27,22,145,1162,1017,62.18213414377927,3438
3f3bea9b-46b5-43b7-945d-03b824219eda,Healthcare,0.2871854805904209,14,49,470,473,3,36.339977895432554,1558
d4d9237f-3495-4aa3-80ad-59f5decbc0f2,Residental,0.29335871497267685,21,15,571,885,314,64.32368279495279,8492
0bb2e18b-7ffe-4553-ba5c-456afebfa27d,Residental,0.6616579324553501,9,31,422,1302,880,32.916101421576045,2524
bf816be9-6717-4a91-8296-3ec9fa5656ef,Residental,0.5772305934236096,26,20,291,677,386,71.42559971520576,1064
2babd14d-8424-46ef-9739-9797b41d8924,Healthcare,0.7341879936980534,45,40,428,753,325,12.493411086924846,1427
f5f4e77f-7b2c-4895-b44e-3daa97b8c40e,Healthcare,0.8671484089585514,32,32,401,710,309,94.26315524344551,4019
5c1f38b3-2dbe-4aee-998a-168ffe22ce30,Healthcare,0.5260752476845393,38,47,293,1027,734,37.424600035383534,1583
0c2fcbbf-9a87-4f8c-b93e-3a0156db73bb,Healthcare,0.27517335442970314,43,42,159,781,622,38.30848565708227,6178
87a6a5dc-1b59-416a-8048-63845df59fff,Educational,0.4048234634503389,6,29,261,1232,971,13.597153826981096,3104
1392f148-1f39-4df6-813e-c21c4e2a201b,Healthcare,0.6587188276767568,21,37,631,993,362,73.55685269073766,8366
cb1d5a41-8614-47ac-92b8-a06a028a7b88,Commercial,0.8304408050732471,20,39,714,1305,591,54.3002847423883,6617
79b34ddc-64f2-40f9-81d3-5d834312ab59,Residental,0.16134558353519524,2,23,106,284,178,42.88790729852915,8421
8c61ba8c-c433-439a-b39b-56c7968d3d85,Residental,0.5360833937562172,30,47,412,1059,647,58.33323923017296,8154
9fab221a-09ed-4a97-a255-8cb926b91976,Commercial,0.8147807887669336,13,24,634,677,43,66.46040924495307,1138
ad5d7cf4-0ed1-4d3d-a699-1043cd2a5b7a,Healthcare,0.8952750273866914,34,5,306,960,654,62.34501408375828,6352
32b37b72-aeaf-455f-94f0-10b50a3a7664,Educational,0.10821123075957051,22,33,602,1371,769,60.104060958624345,1731
d7af9d2e-883c-40fb-ba70-9a8460f4446e,Educational,0.9040561625102173,33,22,276,1145,869,33.07982951381835,4192
8637ea28-e51f-44da-b4f3-1c009e672b72,Commercial,0.5965866007458925,41,15,23,164,141,86.2443305653573,6290
97b5a4d4-ea2c-46a6-8985-7718f233e441,Commercial,0.718994614345516,30,12,402,1038,636,50.42714051587802,2809
b0c7bb2d-2fb1-471d-b86b-35c54c1b52d7,Educational,0.8247686494519424,4,9,376,867,491,87.29807317175414,9462
c42e1df2-c072-4fde-a8ba-a6df83c8d745,Healthcare,0.6758941372594824,21,28,655,989,334,19.84610962010155,8052
60811f0d-8990-45f1-a583-181505614df8,Residental,0.8462288018810312,12,20,13,1132,1119,16.530542449036872,4952
26ddc574-f49c-4132-b2e5-ec12b588d0fd,Educational,0.4156363405126262,39,16,501,1395,894,60.370129437674514,7296
35ed1b82-7b33-4ec7-a0a9-70ae09cf297f,Healthcare,0.8326915325395268,48,48,204,938,734,39.433332075170846,9242
665be061-0450-4205-bfa5-94aabc490882,Healthcare,0.6474115655404531,49,15,250,1357,1107,49.364199700724726,5418
b5527ecd-29b1-436a-8990-f5f941f13d3b,Commercial,0.24837268905206333,22,19,397,1295,898,25.33161728688132,3896
c26029a2-87a2-4149-9569-9304587dab92,Commercial,0.543034800387295,45,44,715,1098,383,26.134056175084066,5317
91239a2a-6412-4a49-84bd-ef8214c2aebc,Commercial,0.37692154249151844,44,35,681,1428,747,92.63480220987601,1649
e8699e5d-930d-41c5-9c38-5e0bd4178b1d,Healthcare,0.6346545743695058,37,20,451,860,409,67.46488806517388,6543
d1ab9cfc-451a-44d5-bb0f-b8f7bc5bc2e8,Commercial,0.8600334814332473,17,45,269,1110,841,92.96604896368147,1625
1fbdf1a4-1ef8-4a38-b45b-cf7d4c398a20,Educational,0.6024043649057308,37,9,436,966,530,35.87548014292085,9559
85c1cc91-1098-4379-8703-5d73551ca62e,Healthcare,0.7953870050527786,14,32,496,696,200,41.25064257637676,6162
9b59e873-ec7d-4b33-bbd7-e96ea333c25a,Educational,0.34142280106101774,47,50,252,1028,776,92.82964963806229,4023
6cf9c968-6231-4ed9-a910-ad7fc271e511,Residental,0.08491851074221513,10,21,676,1372,696,52.31591532469887,4846
a907aaa8-d699-492b-8cdd-0cd74221d010,Commercial,0.4440368708520329,14,18,282,653,371,68.88573299897047,6225
b1f3ff3b-750b-4ae5-8f05-f16de7b15c74,Educational,0.1442395446715128,11,22,15,1023,1008,50.1665651035771,6245
28a2178c-fce6-43a1-bd5f-0d057973d081,Residental,0.46616450077060545,40,33,73,379,306,32.257331027223756,7906
c73706a2-0a02-41fb-b739-55e09d141436,Healthcare,0.5861193127010498,7,17,317,415,98,14.144814002059038,7998
b78508c9-a23b-4f8e-b3de-47e72cff545c,Residental,0.2609264878895273,28,22,11,1355,1344,29.183580420759057,2299
0a98e196-b4d2-4176-a147-8d7802d0b5a5,Commercial,0.3127873895149679,12,5,135,380,245,69.67307585075898,9674
44e51837-9743-40a9-90d7-fd060735db63,Residental,0.142004388745689,31,45,659,1172,513,12.395143998404953,7806
6e6efd2b-9669-42f1-8250-302b28905782,Residental,0.04646000993791388,38,6,436,504,68,35.54484359939205,9111
239be8a7-bd98-446e-8ca9-764853c941e9,Residental,0.7507537588484332,22,5,519,1296,777,80.43211851360199,7757
20abc5f1-60dd-4d97-a71b-2231ad0449af,Residental,0.6507223774989732,12,24,290,1308,1018,82.36903214774625,2808
0fc9db8f-2e5f-49bf-a51e-c94cf83fba03,Educational,0.4827802952104814,21,33,690,1152,462,15.521937242207123,1157
f1e2a3f5-d2a1-4fcb-b2b7-1a802e9d1a6d,Residental,0.4246536745220105,49,3,587,862,275,52.075646301153284,5548
83dbb3ae-4d55-4128-b404-7c5e9cab2424,Residental,0.26984651438045404,41,22,460,682,222,51.286098654427704,9286
0eb696df-a546-4a57-978a-960ef0010dc2,Healthcare,0.3629460454513743,25,49,605,1112,507,37.145443320923384,7450
4f171f32-dbe7-4cc3-bca3-717e5bbb0b16,Commercial,0.49390393971644064,36,33,50,105,55,48.77180294760539,5899
ddfa7e19-ae06-4d33-92dd-a1569b1a7141,Healthcare,0.16888865998644476,14,47,502,522,20,11.204966654770653,5638
0efc42f3-4bb8-4777-b28f-b6bb2ffcd77f,Educational,0.3645318045578334,4,27,54,656,602,80.39864628494612,4117
175fd572-dd2a-4e1d-ad34-e257cc49fd41,Healthcare,0.4820373170735964,36,2,539,791,252,85.22685397949249,4185
5b0e61f8-cfff-4b93-99ad-881510a06e18,Commercial,0.9256544528069357,43,17,278,383,105,36.16103982360091,1315
fa64c9a6-781f-4c8a-a40b-f8f58419a9e9,Healthcare,0.5747933410534485,16,39,604,1422,818,27.086330324709728,2888
02b78b59-ab65-4fda-9331-052eb093aa08,Healthcare,0.09698410151880388,22,22,94,390,296,60.99972640785282,3738
aef248ef-00cd-437b-8964-f838907edfa4,Residental,0.18652364142382338,39,43,375,448,73,50.07345436761628,8564
317e1a06-3367-41fe-a4e7-dca314d0f1e6,Commercial,0.22269866761593027,11,49,700,914,214,33.993347234670566,6724
5e487544-1953-42a4-95b7-457a4b003754,Residental,0.2581154204057715,18,27,547,984,437,44.76336407380203,6772
b660ddff-5933-42c5-afc3-8109cc822906,Educational,0.7106945887765371,1,14,357,438,81,97.33701279896216,4936
e3f0b26b-5a15-4c3d-bc3f-44aa44b12e22,Residental,0.5450262664600778,20,4,647,1051,404,88.32183288862329,3981
ca5b1d91-f73b-4601-bff4-66f87741de61,Residental,0.6411163341166165,47,49,409,1069,660,70.50230774686611,6012
cf30574c-7fd5-4a75-b769-660bb3af0bf0,Commercial,0.6534643587665585,11,49,467,521,54,97.36338257905086,9546
ea7b199f-016f-48e0-97c6-547ce52cd414,Commercial,0.255731497923138,26,15,276,965,689,95.00593320193614,5448
446d87a1-0e0a-4f20-9049-6541c5335ea4,Commercial,0.38757367022667255,37,27,124,372,248,50.89147695062331,4737
60e73519-5640-4485-8ef5-5b5f61a67363,Commercial,0.560243812469463,40,10,445,936,491,34.90506137030294,1750
fc4b95a1-8c8e-4d2d-afd4-47d17c8c5062,Residental,0.27236823512289343,47,21,512,1376,864,17.401698852071135,4626
9e82e26d-c0e1-4178-a9fa-49f93ba1f5c4,Educational,0.24334787789083223,22,14,354,413,59,36.69382032306881,4856
7230caa2-0694-4a84-a783-3c594a3b4427,Residental,0.893416498292841,24,32,340,1142,802,81.20066938866762,9157
145dbab0-196e-4dd3-bb72-39eb11614076,Healthcare,0.6142551646379587,23,12,502,734,232,94.44765432790786,3191
80c89e15-2dc5-4380-af94-e3f7a19bd919,Commercial,0.5672315317750085,42,11,404,1005,601,10.720098851069,2473
7702753d-98d4-457a-9a5b-93359ae9a442,Educational,0.6831534912250927,37,45,242,1128,886,74.19354892223828,1791
d8875d97-7d19-46aa-ad80-5899c0ba55c9,Healthcare,0.3405137981246861,31,17,686,1274,588,39.20362609547502,7927
61818a66-8583-4038-9025-646a0cffb99b,Commercial,0.24998525974499497,39,25,35,995,960,88.03829576926279,7246
f6f9fb17-15a9-4d8d-bcc1-74a1489dec07,Residental,0.4990926888951347,11,47,590,1389,799,93.43691940066708,8276
a74aa5dd-c05d-40d4-8197-243933e1b4de,Educational,0.6076766605412817,17,50,555,1372,817,82.03339545932937,8595
51c6fe17-da66-4436-bfc9-da5b4da726d4,Commercial,0.40073481709102476,28,28,387,658,271,95.90370055347539,2487
1dc2f3a5-b342-4cbf-b92b-890368c82525,Residental,0.9009557939358778,31,1,413,975,562,82.34128790093438,9726
28bb288e-2290-49da-b76c-8712fab6eb8a,Residental,0.8691657733359434,23,11,497,816,319,92.72349627133127,9152
7ba99632-4915-47ee-af52-7be13c978b11,Residental,0.24337890170571064,20,16,390,859,469,61.65021201478479,3361
670e4713-ba0b-4da9-85f9-0599a2da1b3e,Residental,0.7458254261456702,42,27,387,1256,869,74.12039876980674,8499
7340ff98-3380-445b-96c9-b1ae4b01debe,Healthcare,0.5383226602913609,30,5,708,1434,726,70.34359590575504,8433
a1a8d704-f919-42fb-b594-9acff0c7b7bd,Educational,0.9571698645057023,31,7,323,1440,1117,79.2758447132075,5165
46bcc253-9041-4dd1-96b1-8b43841cf320,Commercial,0.5049736931649057,42,37,142,719,577,93.21667283236407,1793
1bd3202d-aa55-4816-ac1a-1a01d7ce661a,Healthcare,0.08734865986018814,20,43,591,731,140,95.46384045936692,4165
76b1e719-93ca-4c81-830f-a006d1623f4f,Educational,0.7706869364087373,5,21,634,1078,444,87.70982416485325,6130
a24e599d-ef7d-4b08-a093-7347bf84d003,Educational,0.4006324667811315,3,30,504,1003,499,93.80705464916512,5558
308e4c4b-6f87-4252-8300-9ae6c1fafe0e,Commercial,0.47537761248515564,10,19,226,483,257,17.145445822071675,4294
0e09f300-b574-4b75-a004-ecffe39ed56b,Healthcare,0.9409299385409138,32,3,364,507,143,73.42419700701265,5411
f6293a35-3375-4444-b4a0-456d54bf70ac,Healthcare,0.8098939789533143,3,26,536,639,103,49.87712436148147,6290
d4c4d398-bc5e-4470-83c9-d06757bdc1a9,Educational,0.23413029385030248,30,30,550,1362,812,53.507285729196354,6146
d94c5140-bb3d-4ce8-8e2e-21e4778bbbec,Commercial,0.19551800446023482,38,50,145,388,243,35.60986737422628,1170
89465f3a-be01-4e53-8595-7e6fba88f68d,Healthcare,0.6160075466068806,23,34,596,974,378,54.57183423314059,7147
5b3823df-d45c-4d59-9a03-c5dacfd5b86b,Educational,0.7250973371025556,39,6,118,613,495,80.79684819020584,2197
7e075d32-e9d7-4ab9-869e-50a85e1e175e,Educational,0.658059827862551,10,29,229,949,720,53.285969877218804,2547
e2a0cf29-f016-42eb-9f20-322e66e5e48b,Educational,0.7850937262769364,2,31,719,1143,424,33.718224689620605,9031
c7a89f9f-a212-4ec0-87f7-a7c2ed54ade6,Healthcare,0.23483655307057238,20,27,580,597,17,71.47459981038547,6454
292fb69e-a1bf-412c-a13c-3b03441d8a7d,Educational,0.2049866607560027,31,13,680,966,286,83.8702549608095,9208
d4f7d93d-ce80-4aec-87fd-64fb85861c10,Residental,0.13984240514115653,28,48,710,1015,305,82.06856943347157,3441
d3417083-632c-45a3-a9db-25db6d7897b3,Residental,0.8795925117095271,42,13,2,699,697,31.98097461121572,9699
accc4274-09d2-497d-973b-3f20793cc1c7,Healthcare,0.6204971696638687,13,34,373,741,368,20.59062606136689,2804
86fba4cd-3ef8-4c08-8ead-eda4d0bd9626,Commercial,0.4046478667561232,37,43,399,644,245,23.649556943361247,7868
ab5bc15d-2fb8-41c6-83d8-0776eabaa23a,Healthcare,0.4445090034602516,1,8,306,542,236,50.363145352613714,7564
6ff0ec19-45de-4b7b-b1fc-8ddc6681711e,Residental,0.35722636270457064,45,44,365,487,122,33.75440985221708,1869
e697d709-bd7f-4278-9f79-9cc5e4b1377d,Residental,0.333928360187178,37,37,642,778,136,66.86039869500465,8310
b561da0b-9eef-40ed-bedf-fd0d5820a8ff,Commercial,0.8666308570789271,48,38,276,930,654,86.25044352848002,7824
d90c7f98-0b87-4fa9-b447-c103f212c0e4,Residental,0.053330243966538404,37,28,707,1333,626,75.01210108406917,6789
2b871849-c176-4f2e-a8d2-a9c03214e2ca,Residental,0.5723387295854627,45,49,108,285,177,16.53913349794859,8070
b3895386-3696-4142-a0b0-763ac4f75894,Educational,0.11154884224299533,14,13,495,1148,653,51.58863522408805,1942
923390ae-bfd2-486e-87bc-9faa82d11cfd,Educational,0.6352574332834365,12,32,324,380,56,31.424026782184335,1149
ddb95aab-edd3-4795-aa02-a807462eef5f,Healthcare,0.4667945444444227,4,28,475,673,198,34.463242786195295,4826
60b663dd-48af-424b-965d-4628207fc33a,Healthcare,0.6934736003828835,24,4,267,377,110,99.81897365390758,2200
ee175bf5-8f09-48a5-b4e2-461f329767f0,Healthcare,0.9261212044880623,3,38,513,1152,639,79.49045963342591,8640
96ae9b1d-7a06-4dbf-877e-2bccd163a3ae,Residental,0.14566063771900728,10,44,584,1053,469,20.76944033359963,3409
e9034e1c-d25a-4a97-813d-e483e1fd4954,Healthcare,0.1259950286976611,23,11,631,1388,757,97.76757105595259,2428
f335a807-e584-43c6-b3ec-e717915d960c,Residental,0.2209427186975884,46,13,585,732,147,10.876964809477155,6974
5d2edb38-94e7-4915-b015-16ba37eab629,Healthcare,0.32236216028397346,15,45,269,775,506,49.620331763556194,6205
8bef9b31-3141-4787-b9f7-46909ab30f70,Educational,0.7406401357676149,40,16,44,575,531,24.403166633494344,7128
ebaaef11-9866-4cdf-be8f-83277b17bfa0,Healthcare,0.4140657948827068,44,16,369,1066,697,52.355996281054274,3711
8ce616db-6a6e-47f6-8c0a-36823200bff2,Healthcare,0.33046117520040064,23,14,75,307,232,34.63930784722035,8626
105e249b-3186-4da5-af85-ad3a8e25a510,Educational,0.5529544495825809,8,42,20,504,484,24.453743255850355,2626
1909512d-d074-4936-9c76-c068a39309fa,Educational,0.5686869449769705,36,29,44,1031,987,28.367715813078153,8039
91c5a643-bce8-4bb3-8885-1baa02004beb,Healthcare,0.06573404669738714,14,43,402,521,119,49.08452547700931,3123
7ad4a18d-c292-4e77-989f-ebc599542eb1,Healthcare,0.3962847956858223,36,1,483,612,129,30.15756686938418,1357
3b68d07e-6055-4e95-a29b-c8beda446472,Educational,0.958712909171635,36,8,587,1386,799,93.78532677098491,1146
4efec570-6da1-47cf-851c-a30a495da650,Residental,0.40885494329335137,37,7,316,1330,1014,93.37495430493199,7883
328e084c-ba8f-466d-8364-25ebb4e6caae,Commercial,0.2993118090933624,38,20,483,588,105,99.8294781612704,4686
7911aa01-b5e2-4f53-83d7-f6baabc481e7,Residental,0.35177641421057815,6,6,148,1099,951,48.255164433472416,8332
1a75d212-6867-4a60-9ca8-2ba2111a200f,Residental,0.2202424748927817,24,34,674,1440,766,74.89370637967563,2840
37384320-766c-44e2-a4dc-e0130e9a7036,Residental,0.19667925917270102,49,26,328,652,324,62.78897859015056,4810
ab2bf73f-7dd0-493c-82fb-d5c43dd354e1,Commercial,0.14755635288341173,45,47,51,866,815,96.25983971242229,4107
783cd7ad-0e19-4ebf-8782-cd1cca100239,Commercial,0.19808877540441538,15,45,479,1219,740,60.46559099436326,1235
3fb88533-6a62-435a-b8e1-84018b1afa2b,Commercial,0.2862103281654743,33,40,398,1149,751,52.356730128373485,2056
67461b9a-f2d6-4f6f-953a-13f13ad54970,Commercial,0.09566544697592394,38,11,551,609,58,74.22488162213821,6186
94cd0e78-2ca0-445a-9ae7-bf5025ecd5b1,Residental,0.15342375076145243,12,10,271,572,301,82.69901348573599,8966
80404a54-269a-429d-8eb8-ebcac446eb74,Residental,0.8423690741391903,49,21,692,1390,698,46.417339089398716,5945
7cca2f2d-6b0a-441d-80fa-9101ef64c0e6,Commercial,0.8546998384552796,14,32,419,1132,713,70.11984303725171,9613
02877cfc-9b50-4d83-a475-e6d32dfb398c,Healthcare,0.3621003105734726,4,41,257,568,311,87.49051800607198,2628
5e69edb1-9ff9-4023-8fe8-85fa2375fb95,Commercial,0.043868025422064916,19,44,290,795,505,54.665728858602726,4462
0dc2212b-182a-42a7-83fd-e815b7a13187,Commercial,0.16186314737986995,27,2,345,643,298,43.36296616882772,4543
1dbe0ae0-635f-42b4-ae04-1b8158d4f77a,Commercial,0.8499527575652179,15,49,336,858,522,99.01133169401525,8063
b5353d98-28f8-4115-aaac-048a4d5f5507,Residental,0.681859046053323,21,40,97,112,15,62.62244645867822,8394
80b10c5e-14bc-4be5-8909-605fa1c7620e,Residental,0.5249487147007332,49,22,645,923,278,10.759627625612298,9470
36e52295-a120-4944-b0cf-adc7c0c8aa2f,Educational,0.5038180486395528,27,48,692,921,229,66.91308301423442,1359
0311f636-3a72-4402-abaa-bfb66ce52c0f,Healthcare,0.32382545022928155,49,48,614,1015,401,52.60134082655478,2001
36a36269-7091-419a-b29f-1388a18eec36,Residental,0.29007262006176693,33,29,459,764,305,32.96036962626289,9006
3e2a1266-364a-4343-8869-def01d54c2bc,Healthcare,0.3472932188373684,19,48,391,933,542,25.420773809403475,8225
5e60b641-7e46-48a5-997b-c546c7456ab9,Healthcare,0.16162045979415995,27,14,16,452,436,49.552094136435436,8839
98f95d9c-c800-4e81-a9a4-5dbccb3eea5b,Healthcare,0.0029191770245329263,45,33,436,988,552,83.51814436852129,2015
4a6bf186-94da-4721-90e3-36fca1374c77,Commercial,0.8793669104568427,31,40,424,1227,803,86.91308854381734,9218
c729fad3-1fb7-403f-83ba-bcc2c62713d7,Residental,0.9639220832476485,22,3,99,1329,1230,20.968009663844096,2668
8f01d81d-44f1-462b-849e-d3096195e94f,Healthcare,0.06481980255587805,36,6,189,380,191,45.17619833794696,9441
3533f88b-b29c-4ea8-9a6e-6b85027153a2,Commercial,0.8658040922851185,29,13,173,577,404,49.58398837166474,7811
964922ba-0336-4bef-ae37-cd85a5ffa577,Residental,0.4709980274871084,22,40,629,630,1,16.614920057847474,6526
065282e0-6893-48df-bd6e-df0bb7bfc46a,Commercial,0.34963602667704896,32,47,451,743,292,56.3824371278814,9454
5632bbd3-e6c9-4d37-87aa-d3b3d27f9a3b,Healthcare,0.8725862485258046,48,49,661,1102,441,24.878627499905214,4382
5eebe4b2-db04-40b0-9a70-27b83c5d6a6a,Educational,0.19229173129091592,2,19,517,1161,644,93.53266907311941,7340
ce65f565-14fa-497a-a20d-95541d6de021,Healthcare,0.35437964146891066,13,18,640,721,81,28.699466658158755,8668
ff8bfc3b-6b22-4699-bb32-2935f527e2ca,Healthcare,0.7711000474447992,24,27,84,145,61,38.01088407258635,4199
8a835bc4-b707-4431-8600-c83bc0684a66,Healthcare,0.37269378882571746,19,11,174,959,785,97.11580760700627,7482
b94eb0b2-6bc7-459f-b42a-bc74ef6fe2f9,Healthcare,0.3051086655277706,20,40,519,1240,721,44.837051452431254,6353
6c7fb4ea-09ae-4312-96a6-ac2364252b62,Commercial,0.7712708463945588,12,38,192,1353,1161,76.61989505099932,3411
13d23c90-4b14-496f-b409-ee3c59a08ec3,Residental,0.410585583647624,44,40,135,928,793,74.24521785075805,8412
d276806b-645a-4034-bbde-ac3f966565b5,Healthcare,0.2075560600622227,33,16,617,917,300,16.827949477507637,6382
a2681974-ae91-4cc3-ab7a-c777edb6cabc,Commercial,0.2151924516299697,34,43,651,1354,703,57.47819872152225,1187
47374bea-bece-427d-be77-4a23175c87f0,Commercial,0.19214495627299544,41,15,675,1152,477,32.965588931474784,3072
ed88100c-0087-4a8b-8413-3771d46ec037,Residental,0.6854999623228721,9,32,371,708,337,10.075726407297136,1049
01685119-c9c3-4315-ba61-615df72852de,Commercial,0.9803327432828618,37,30,656,866,210,96.08350087817486,6445
79506f18-8b7e-4ae6-b634-807b2b5308d9,Commercial,0.91328500366526,32,6,1,1212,1211,40.857618612796614,9439
f7b7b6de-957b-47f3-afa7-dcc02f20464c,Healthcare,0.7612069778974067,50,18,336,775,439,55.60927580648114,1501
5794e19e-6cb3-4cc3-8589-e0db6a20553b,Commercial,0.18325242086213778,4,15,345,902,557,54.930960285769146,7104
da8ba99d-224d-41a9-84a5-9ca1411afe2f,Healthcare,0.6725238510769944,13,1,369,628,259,64.05850279917863,1928
054427e0-746d-4722-8989-1c44c562f899,Healthcare,0.11213400516166316,30,14,467,1070,603,89.17284676800845,9164
e1adaa90-7b3c-41eb-b375-d2fa2dbb6e17,Educational,0.44132817030376026,5,12,520,695,175,69.44525677482977,4935
b20c1330-7710-4ca7-a72b-4d54c22805bb,Educational,0.09379788364481834,23,15,454,630,176,73.64116537800939,1371
098869f9-5ed0-4cb2-91c6-396532fc32ac,Educational,0.22894651793743648,29,6,432,708,276,36.915579330415426,4979
76cefb90-4bcb-4028-91af-8d2ac3a60e06,Educational,0.22151812250061376,28,1,367,1163,796,36.598730846937045,4832
b01aaae3-abca-498c-9a96-7f90bda3b5c1,Residental,0.9679339808022707,4,37,506,1275,769,37.45853442740837,5774
0dd60072-17dd-4131-95c1-25d6d21d30e0,Educational,0.8436673487237668,46,15,505,1210,705,13.556109106470913,3779
c0ef5c99-9dee-427d-ab83-6ae1e0ec29b2,Commercial,0.877929538199505,18,21,136,666,530,59.55437157014319,7728
93b8760f-fb69-4bc9-b20e-b5bcf62b9cc2,Educational,0.606125368847103,10,28,594,1250,656,65.5484044986685,4284
d6c38ade-fc24-4f32-b7d4-c0493fee6b3d,Healthcare,0.7614819073041762,23,13,121,765,644,95.90105940161394,4617
70b86a94-5ab0-4119-9789-fd9aaee0988e,Residental,0.7501721013293214,2,13,268,839,571,65.78042489147681,8929
63407833-c692-4d95-9a8e-1e7e2524264a,Commercial,0.007784650268328974,49,44,475,1115,640,92.71772986609514,7120
733abbad-feee-4207-a281-9804d0f80a0a,Educational,0.857585714365013,44,35,399,998,599,80.37673586649433,3843
71f1326d-91b8-41fa-b6e0-71ae3f5cdbde,Residental,0.006752585836654834,6,18,155,265,110,26.185833245312356,7073
27ed083b-5ea6-426a-b45a-96ebe8f452cc,Commercial,0.8769582364514262,42,16,446,837,391,22.59328592991922,9846
cd328da3-773b-4c96-a0cb-e9bb92ab65e1,Educational,0.5752418916926648,36,44,695,990,295,52.85277822196522,2158
bb660f58-932e-4a82-b9fa-de7293805ee6,Commercial,0.08791710926665086,3,7,113,831,718,66.74897733415268,8416
e3715ef1-2d24-42d2-b6a4-5f09a32b8ef7,Educational,0.9790053235511776,47,29,241,749,508,97.40344770917673,8421
92302915-2e0d-41f0-9c8e-8b585f26bc40,Educational,0.3899299336595553,21,46,229,1368,1139,92.0082475666182,3747
1b8156c5-7570-444b-8487-2133c39f0e2c,Residental,0.8869593343420908,37,10,105,817,712,88.45078522748302,6784
2970b7bf-2337-47d7-83d7-7eb89994077d,Educational,0.8454927177261459,1,18,385,428,43,89.85019001620745,2398
033ec7c8-699a-47d8-b300-5682d952b714,Commercial,0.1531469295583162,14,27,242,471,229,20.754161008388,9710
9769fcbf-5c2b-4933-b761-bb4b686ca3a1,Educational,0.2957603752651782,32,17,208,1276,1068,53.88407819132819,9607
9722100d-fbf5-4ec4-94e0-1418a7f897de,Commercial,0.9215436011671707,16,8,505,1103,598,54.51798823722727,4690
75acabb3-36bf-47a5-b23e-7eb46fee34ed,Healthcare,0.1088450783347431,38,30,265,507,242,51.251015867627295,2011
1560fbd8-9ea7-489d-8ffe-8f9c1d65ad02,Educational,0.683052721590509,37,42,575,981,406,53.780096013019566,4565
f6b9ac14-2dc4-4a6c-8f6c-bc778934f92e,Educational,0.7559640276800325,43,13,157,381,224,86.22551906350344,4881
a5b205d2-08f5-4642-a367-f9c5b70c4c59,Residental,0.927988944092987,23,2,299,1413,1114,88.32644555542407,3241
a47d7727-c6fc-414f-ad44-f3c31c589cf6,Educational,0.906170602422248,27,35,434,480,46,35.91431598236318,1935
d920b667-4229-4eea-b7f9-f228b720205d,Healthcare,0.9335770489599375,19,40,26,1352,1326,79.00683789583101,7178
ceb5eedf-8545-4f10-a143-366479712e4c,Educational,0.42652410282075526,7,47,113,731,618,47.40701086272875,3884
ffd64e98-5212-4246-a274-b3a7dab8061b,Residental,0.5636992719733541,17,1,95,1333,1238,28.484173839344777,1071
2b8ab9bf-e671-4176-b527-36dd18b0ce20,Healthcare,0.9060416574194772,13,24,666,1094,428,17.840431844562204,9848
9c42094c-40fe-4700-a747-75ec156287a1,Commercial,0.3150792727956585,34,43,367,1337,970,84.96913559016865,5773
204f7ded-bac9-443c-9783-716abcfb9c22,Residental,0.704914411756991,17,24,108,818,710,51.14545124516151,6554
2e660f65-6447-4e01-9790-99f1499b9e55,Residental,0.8544273238260035,11,41,282,548,266,25.270240894990742,3282
36b0418e-0199-418d-a74b-a4e64565ce68,Educational,0.4771439813298163,17,39,216,1278,1062,76.00451118078043,3408
bd429f26-9ff5-4664-b7a6-84d920739274,Commercial,0.4296230389171819,5,17,35,449,414,37.3968190006246,9566
bc08c77a-9444-4ed3-9796-843483caf5b0,Commercial,0.1938920517516104,16,23,503,731,228,33.54106597733632,1532
119efef8-a35c-478c-9260-46f9784bcf17,Educational,0.39913437155428666,50,46,106,1218,1112,21.40959423484937,8271
92538a12-0648-45b7-b21b-25e3d299aa5f,Healthcare,0.18443928674600052,2,13,680,1162,482,30.803415776849203,1058
21799c07-e1fe-4022-80ad-755a2dcb88b8,Educational,0.7619869037052105,30,15,285,1224,939,65.46171560038445,8807
019dadc9-4bdb-487a-8d8b-3a383dc4672c,Commercial,0.5311167758152948,40,13,357,480,123,59.472347107133125,7139
8aff0cda-d876-4019-b179-b1803426cc4b,Healthcare,0.15392681722525337,47,4,307,516,209,91.18109665399012,7617
54c8ea38-a075-4852-b127-9e2f92e3e639,Residental,0.9968324219162715,49,50,642,1393,751,24.37023566886549,4895
64dcb827-5a50-463d-9a1f-618c07e9f0e3,Educational,0.32186786232010345,43,7,588,1381,793,88.87732105948183,9392
f93c784b-cf40-4d93-96ac-8f92c7778c95,Commercial,0.42143407285707235,22,21,605,1010,405,20.109387126279714,8500
be4e156b-4b2d-4b0e-aaf0-0b7c6ad935aa,Commercial,0.04064470892609473,8,49,179,426,247,69.31989321702173,7529
84a9f59d-9a4c-4ab9-9205-df6f1df017d6,Residental,0.8797699029174272,3,48,377,627,250,32.43575651992508,3236
c1876fb1-e2ac-434f-acb0-0026971a17d4,Commercial,0.3021838963451887,16,16,43,1351,1308,64.14965621426352,1204
6d319161-8625-4811-b7ce-6098da983473,Healthcare,0.8467350339765777,14,4,543,1211,668,64.99383203989308,3685
06a085c2-7491-40da-8b9a-f26392c24ffd,Commercial,0.5484485009510185,40,5,708,1382,674,43.62177680044378,6579
29e47ebd-56d8-45b5-8853-535914998b9b,Educational,0.8311553032138453,24,28,143,1060,917,74.46808443521515,3923
1028c80b-c4c2-4985-b34b-a46487b66d87,Commercial,0.053568125307826286,12,37,326,498,172,20.613436680662513,2190
f120e333-0d2e-43a8-9aa0-e3608380a111,Residental,0.3489871738961199,39,1,53,1033,980,34.367706340746544,4753
ef3d013b-ba9a-4ae0-a2eb-e5df7d98da9d,Commercial,0.9572163307461583,18,27,550,727,177,90.91152075529719,2725
952ea077-3c66-4eb9-9a94-aefe9dd3eec9,Educational,0.3254840707197496,35,21,502,1132,630,22.64208502753283,9288
e06f6033-27e1-4679-947c-ec8c535ef94d,Healthcare,0.6967585138320044,46,10,550,691,141,61.23051267138662,2226
4a9b2dc5-53f1-448b-8942-fdfe5e7bce63,Educational,0.8008101102339439,21,34,346,1204,858,87.08478974285664,7103
cc6cd41a-a727-4cc7-8a98-928931202a64,Educational,0.10069713045580664,16,22,548,696,148,51.71408774501347,2838
d5723cc3-0d1b-47e8-83cc-46bd358e39d2,Commercial,0.7166261605357529,36,29,23,204,181,74.05032501620232,5410
d14cbf92-ff4f-4d16-a26f-8073805ce404,Commercial,0.4593416920172576,26,18,561,835,274,25.69559928116048,6804
af532b4c-ed8c-4a8c-8379-6a58aa831cca,Residental,0.19573834066880746,1,18,537,745,208,36.3216614551355,2968
eba7b95d-8b32-412e-8f35-9b20f17b4daf,Commercial,0.6046832273962506,40,38,144,568,424,26.253507777485332,3826
40edd823-217c-47a8-a126-66cddbfb4781,Healthcare,0.13530767304941582,26,7,98,1390,1292,72.69569911731084,3913
d87aaae2-26bc-4da6-83f4-c7f55364ddb8,Commercial,0.8588243929182765,25,19,287,446,159,85.5526533523672,3990
50263540-58d5-4ee9-aef0-d8efe14b6531,Commercial,0.2778776658653185,13,32,354,1156,802,32.66572546484112,2484
aa0324b9-abe2-47d9-94aa-cab218e1c345,Educational,0.8773653924096801,6,8,494,1395,901,82.51213538895723,9562
c9623767-90ea-48d8-8ddb-fcc66191a378,Educational,0.2853866630512376,30,50,569,1265,696,16.88810051596875,1813
0a7f0eb0-d5c2-451d-8186-80cbe5d68fb0,Commercial,0.18945339189716637,30,13,708,1132,424,85.2379093478953,4377
3d4f6b39-9d60-4402-8080-6aa0e307c487,Commercial,0.4512395942873412,38,13,264,371,107,75.89617170558319,7055
126b4000-3756-45f6-8b56-ec0d15de3031,Educational,0.5030173180976266,9,28,493,1126,633,79.9334200487174,7056
fb8b0f50-f830-475d-8357-a306d86971ba,Healthcare,0.1271246095344225,19,14,336,677,341,64.39032386466015,5588
3649791d-c839-40de-80d7-83aa940b6c03,Commercial,0.0344039728323734,33,27,389,805,416,81.27878414424647,6920
63eaeea2-8297-4e48-8cd9-1a5d06a8a8ff,Residental,0.36336290590890696,2,16,380,649,269,71.45433096854447,8386
f79a930a-8cbe-459d-aff9-d174d706ebd7,Healthcare,0.4862126416630238,33,21,17,1305,1288,71.77078491265864,1664
010f9cd0-90a6-4074-a64d-5c68375721b4,Educational,0.4227692504542955,23,14,639,1284,645,46.783923421096524,5351
e981ed3b-2184-4cfe-a84c-05d829702762,Educational,0.5714185138675079,37,21,437,829,392,26.4815551250899,3210
bfe5c90c-a3b3-4dc8-9286-650a5f30f9c1,Educational,0.01545856401391299,32,8,320,1087,767,65.20112462711516,6881
716bacdd-54c7-4a2e-80b7-72f97e7db2c8,Residental,0.041854222480848025,38,28,464,1224,760,52.85042029165715,5370
b31cdc61-d426-4a90-964e-20ee899a1e8d,Educational,0.8177880207640801,12,50,651,1142,491,14.22710837609841,7211
f5940191-0cb9-4af7-966c-d4f831b7e1ee,Residental,0.03782182839654036,14,43,438,635,197,99.5972069945719,5828
e7873d86-b4f0-430a-997f-eac5c7428826,Residental,0.7004482235043393,39,20,88,1342,1254,75.15889834032201,3300
63bed4e1-1334-42e7-ae45-8d466adfe8fb,Residental,0.8924732311143709,47,24,559,589,30,48.83809839357634,6594
423e506d-76f6-4f0f-bd01-96ca1981a7e1,Commercial,0.8236767841105381,42,40,349,1401,1052,37.7992227506341,2697
dbbaff6c-ce97-4c4d-9aa5-f723dd0039bc,Residental,0.9255216058734576,45,42,346,603,257,80.70354362473495,9055
556ef6a7-3d48-4a63-887b-a20b02d8a513,Residental,0.1568601562280354,22,30,594,643,49,60.05977070777433,5781
dfdc12d4-cf96-48c3-ab2a-6b957194e628,Healthcare,0.7054936605688511,47,41,125,364,239,73.74705724855512,7622
8699c2c9-86e9-4313-981e-0ad51ebe0148,Commercial,0.4669881056742513,33,43,99,586,487,12.949215448187815,3580
30f615d6-21fe-4d91-b01c-365e48520618,Commercial,0.7714897440835071,48,31,519,1135,616,68.05497682836118,4658
a5439cd1-0ad5-4c72-8b69-df84a6b7d66a,Commercial,0.64300741263889,41,31,477,798,321,92.27509543549301,1648
c7d41f1b-ac32-41f2-a57f-785b7fbcf5c4,Educational,0.34282635442504517,17,39,328,1309,981,20.936304829599443,9731
021179ba-5b39-427b-a7fa-b99ef0c4c21b,Healthcare,0.754013464773409,40,34,689,810,121,17.20731647131487,6119
30ca0ec3-77d7-4bb3-bae1-65cdcde1f2cd,Commercial,0.0699239491633995,39,29,269,1421,1152,50.97061620245249,6967
34bec7a6-1666-4027-94a0-02dd572e093a,Residental,0.19757313870934956,30,43,152,1274,1122,93.98599282938834,3527
8e04c3fe-6c1e-4210-8821-e7d210b227e8,Educational,0.06292550027483257,27,21,209,684,475,93.60646751795478,8679
eee8714b-10d2-4837-bf8c-32b126a8a8ec,Commercial,0.34201610049844633,6,4,207,1117,910,53.77993076070754,4679
12f8295a-5030-4c0c-b63f-c913ba88d38b,Commercial,0.36736222223220616,22,3,527,987,460,82.72073469626497,4079
3b3c55bb-c3f3-480b-a6e6-167dabcdb8f6,Commercial,0.19193494832280156,50,12,93,371,278,88.32911667367942,7327
7919676b-4e1e-4cd4-9a61-550f27de8b1c,Residental,0.45930118472656556,16,26,237,1353,1116,13.605274970314063,7174
0fadba64-577b-46e7-894f-893223b4898a,Commercial,0.26872287313168775,39,15,347,1260,913,58.26345749575336,8164
33860c5b-31ba-420a-8534-391e5bca702c,Commercial,0.5410076336773987,10,6,491,955,464,97.41035129818275,2066
50aa04e2-ac9d-4307-8747-bed8906b7d36,Commercial,0.9025086289108264,15,9,520,756,236,24.327380516571004,9400
b76dafb3-37dd-4549-8d27-ce6bf77a1b08,Residental,0.42075897684713226,37,24,585,887,302,93.01213810069079,4084
a6524db7-4b49-49ee-9b90-1f360776de45,Educational,0.524020392793224,8,20,88,188,100,51.06452410095431,4966
327951a9-4f9a-477a-ab37-edac03a0955a,Educational,0.9841963930726356,15,48,464,1102,638,64.77261561386437,7350
268ec5e4-2a96-40ac-b383-176b2d9ef67e,Healthcare,0.41523767545584944,12,29,624,758,134,86.45373645817624,4618
794e1914-c116-4368-b056-259981608230,Educational,0.45493651830635795,35,21,402,661,259,59.4590572892965,7375
d3dc7876-1cdf-48b6-9a47-15f3d87dc321,Commercial,0.6472092456748493,47,23,335,374,39,56.2204392988761,3037
c296490e-a477-4ef3-99a9-7347719f513b,Healthcare,0.8033874490476065,14,50,275,1124,849,21.073049419855195,3967
6e407b2e-e4e3-4706-812d-8dc844789f5e,Residental,0.8849928878793738,35,21,109,1222,1113,67.3315740790436,8451
a8191323-1755-4ed3-89eb-04828fdc4843,Residental,0.09356584965094827,45,17,678,1247,569,28.973574175259245,5018
7657946c-e8c0-4180-83c7-c9465aa5c873,Residental,0.5501675143703156,27,46,714,1402,688,15.581615436014431,4493
691da48b-bc51-4045-bc31-c0e18422bf10,Educational,0.43754810024571433,3,9,603,1375,772,23.06062887721808,9321
56ad9e65-4200-47c1-b9a3-daa241ca2af3,Commercial,0.4649993811868134,35,30,329,376,47,85.2226751945138,8674
288967ef-8371-4aa2-9e45-2b4d6737bc1d,Educational,0.053085449471833246,44,7,153,535,382,19.52088688913452,9093
ccff81ad-41c1-4c9b-b8bf-ceca33f62b25,Healthcare,0.19994286884362522,47,12,377,432,55,39.48234795975251,4640
da98a669-2e35-496c-a43f-6f7c513e85f9,Educational,0.5663597902636459,31,32,513,1340,827,72.48288256917121,5839
eb207866-e868-4156-9bee-d60443597d8c,Educational,0.10128412798029163,9,11,335,712,377,80.15002958464744,8759
57db42e5-044b-4d78-8dc9-0381e42c2b2e,Educational,0.8103322769529151,30,22,90,123,33,72.172664154438,2138
147470a5-aaf8-489d-804e-f95261389580,Residental,0.9673467364599242,21,25,364,1008,644,81.64099103091885,1302
0b97f192-0dcf-4f58-8c71-dbca1435dc48,Educational,0.7540264424642146,46,19,211,508,297,16.347967218500216,8569
f0d910d0-54e3-4359-a308-1897e8f07439,Educational,0.22562148951307837,14,45,275,297,22,86.31239503243879,7149
04e97395-430f-4aa6-b5af-60d27c5a1016,Residental,0.9997547269883983,23,36,46,326,280,17.404762134613303,2598
fb19300a-ac39-4cf9-acf6-2675ba826d75,Educational,0.7626451599427043,21,47,585,1388,803,54.37943156571846,9227
b2641ef2-7879-4d27-9dda-465d01ba1e6e,Residental,0.5666542062757329,23,35,423,827,404,11.324111355066368,8981
bba5b288-adf4-4dcf-8076-60c67cad4689,Educational,0.9212051192283468,31,27,277,1246,969,60.63512321313113,9186
e48ac47e-94e5-4bc6-82bc-8b9c80daac30,Healthcare,0.6039677263448698,23,20,197,1429,1232,54.12189324987024,4851
025df924-e6b2-490f-b0f8-b2872585f674,Residental,0.1460617878723558,30,49,541,1251,710,58.89375106999164,7631
c9e43cb2-1696-4e7c-991e-6c8ef6b295f7,Commercial,0.3913158545973817,41,11,155,646,491,94.2318390511551,2263
2ad58240-1602-41d0-83f1-233b57f81313,Commercial,0.588340336529727,5,36,437,577,140,83.67548748257232,8570
21eea5f6-c6fe-43e7-85f8-3516a0135f6e,Healthcare,0.424386814600746,23,31,549,1398,849,26.631783683449793,1902
404861aa-07ef-46fb-829e-5a4716ea5691,Healthcare,0.06995261489050442,15,48,42,1319,1277,44.231266299191,3706
40330a29-520d-4fa3-bbc4-0a6aba502970,Educational,0.5345726950124594,34,39,622,946,324,25.839233616697946,3272
5a92ad39-d8f4-455a-8c11-5e98ebd0e4ef,Educational,0.6339565091288958,14,5,639,910,271,49.91907042967868,4266
b42d2444-f94d-4a2b-b33e-c92629a9fb60,Healthcare,0.9073510120547734,37,13,245,903,658,19.177842822853098,1390
67036a27-abdd-4a19-a42b-f8cd4e1e5947,Residental,0.18638981406886868,4,1,97,190,93,47.66406014545327,5528
d3a68195-25d7-402f-b7f9-aac67ac543ea,Educational,0.22962871224951542,43,37,472,705,233,67.27666797589984,3306
c797afb1-56f5-48c0-9461-82238872da54,Commercial,0.5920334552938554,8,7,454,994,540,22.236842354255202,1979
5ddef87f-cadf-4bd4-b9c6-70f2ac7ce428,Healthcare,0.8468316884910918,35,5,155,659,504,82.1924903348255,4505
cc1f997c-eba0-46b2-b1da-4827647fd682,Commercial,0.8992444494981279,23,35,362,958,596,71.49119620939064,8870
4c7b1e00-a24e-41ab-bafb-bdc6151dd176,Educational,0.4619084823296423,3,3,259,335,76,73.45635800152633,3564
c2b66eff-dded-49ed-a6e7-dd1edd9f1578,Commercial,0.6477504642460082,20,39,111,748,637,42.856934603494345,9557
35e1de03-3a17-4fbd-9e3a-768d256674ac,Commercial,0.19004327286741574,12,40,537,839,302,86.61649414091819,2701
0fc6de04-cc4d-4d22-9555-75aaae389421,Residental,0.571951800858192,26,32,306,595,289,72.02262066307966,8255
a672b316-4525-420d-b49b-9b261d2d6af7,Educational,0.3035538730851921,1,37,525,845,320,23.302950377123892,7835
1dd5777b-573d-4eaf-9cc4-d2d42ca623f2,Residental,0.5337258501281736,16,44,692,1411,719,91.18318951358671,8269
6a949deb-5741-49fe-ba2b-1b09087eea62,Commercial,0.23717713627101167,43,3,527,1273,746,59.35186886803315,6358
07c49164-5ac1-44c9-aa89-72fb80cb9e9e,Commercial,0.5899794068112192,29,17,23,1304,1281,26.5852813042897,5937
e2fe3832-b5f6-4e06-bdf8-053b8d97e323,Commercial,0.9189386909978252,39,14,167,697,530,66.24602835200707,6716
cfd8178c-2f5d-4d7e-b19c-bc47cae68a59,Healthcare,0.10723341140462017,29,21,64,117,53,25.37898276575458,5107
5c553afa-c2ba-42c0-b283-6e9c07fba84a,Healthcare,0.6848751649387472,23,28,552,1150,598,15.461736385112971,6415
e08dfc0a-0688-4e55-81d9-3b61dda10a88,Educational,0.20343584081018828,24,45,145,817,672,51.59911204579961,3212
518974c4-ce01-4ef0-9d91-de1d2ed78763,Commercial,0.9801999031334233,1,46,32,1405,1373,88.25790199343386,6743
7ec14d61-a10e-43a3-8991-964e6afb13fa,Educational,0.673077228101665,14,20,210,1289,1079,18.003323276166668,2589
e4696761-b65c-4068-a483-4199e2e94635,Healthcare,0.3891557196173594,10,38,252,362,110,69.07995576502202,3217
261cb3a1-90a1-4e18-aa30-c8d99c2ffee3,Educational,0.7764715501803849,1,17,32,220,188,63.901835290586504,8815
2b85cee7-a4b0-49a8-9b0c-eb5803231fd5,Residental,0.8556268247923706,10,30,201,1312,1111,74.17939330767408,9596
e7f61656-daf4-4250-9a77-9d515b750868,Commercial,0.5038876509684185,5,10,121,995,874,61.57487465192968,2395
18332a39-f6b4-43fd-88bb-1dcf9602790e,Residental,0.0920144326984933,24,36,644,728,84,72.69076384432532,9930
6a901758-137e-4972-a7fb-a4861877df13,Educational,0.38315891005600233,35,41,434,896,462,39.78451030034377,3575
88e54532-96aa-40f2-9e63-3f2aa9d27eb4,Residental,0.8245982037130921,17,31,500,1329,829,69.22072050745408,2198
68a16bb5-3ba2-4230-b1a3-cd558b9e305e,Healthcare,0.21146588317145998,3,8,151,820,669,55.99179955262726,4886
0353edff-0eab-408e-8a6a-6f966fa528fe,Healthcare,0.8899293454049647,26,34,100,1420,1320,30.476828804140798,9129
ef805bed-6659-4c2a-92f9-56188b1fac40,Commercial,0.8642385299240385,24,25,310,584,274,78.76722989498977,8707
22c8bb8e-7ecd-4db3-9f41-11c3ad9c8860,Healthcare,0.4821423824902259,13,35,636,860,224,53.99963635518513,5867
84434248-1d8c-4551-8f08-c62c00c02f53,Commercial,0.5815227107331066,23,6,177,223,46,48.06691970565988,9238
7c49a5a3-a3cc-4937-ad2a-c615989e63fb,Healthcare,0.8754530072298216,31,39,323,384,61,82.99897942124176,5113
effbad9b-1d0d-42cd-b147-23194468d926,Healthcare,0.37967892354844146,25,17,684,706,22,70.44174156364036,1641
3450412e-4707-4176-9df1-f8aa1fb6bfd2,Commercial,0.8778372473493951,23,13,256,362,106,90.64148594150205,2907
9aa2ed63-526e-4059-b70f-6c4b833b282e,Healthcare,0.6203757433149555,31,24,303,637,334,77.44910332384569,4617
a74a35a5-cf90-43a1-b80e-86bd39e7de13,Educational,0.4759379104278779,43,27,646,673,27,66.51464744058856,6115
a72982cf-1619-4212-bbb8-b62c27676e87,Healthcare,0.23261786310456944,40,41,456,507,51,72.91919468158812,7876
e1ec8241-e989-4bc1-a417-4a104b3f6735,Educational,0.7447147869563746,36,30,130,273,143,17.405210352505875,6346
5442a4c9-1e49-4309-8437-d31ffd1dbe77,Residental,0.9753828755448082,7,1,170,1405,1235,31.40808163539958,5597
46a8178e-491f-4f35-a2f6-4449c5ee037a,Commercial,0.36246999626116605,1,10,185,357,172,49.821383738406126,8689
3be61c29-b8ff-498a-9462-8f9cbc5dc1f5,Commercial,0.503594864658928,9,10,529,539,10,97.69493190946656,9838
ad655831-1ea3-4e7f-b566-a7f411252aa5,Educational,0.5303474388657068,28,36,649,1375,726,81.32329525049072,6491
9e6ec0c6-ef4e-46b7-bf13-859894f57b34,Healthcare,0.583385450050837,32,11,566,586,20,88.31404374890502,4380
d949e5f1-4ed7-4635-8a80-3e4bf649e813,Residental,0.19356577389633156,12,22,653,911,258,54.19877382654436,4244
aedae3c3-ac66-4948-a51f-16aeeb49c08d,Educational,0.18817030887505604,43,7,201,1155,954,91.53760885088272,1395
79144a26-ea15-41cb-8572-2b40f63cd101,Residental,0.9020893847767899,10,9,538,706,168,32.5202159066975,2859
5051c1ee-cc60-489a-a174-5b783e97e1b2,Educational,0.05607441732942342,3,10,63,98,35,50.26602775643835,5158
6dd6d2c7-fbe0-47ec-8e8e-c614bafc5b91,Healthcare,0.01631763123312402,25,33,98,528,430,81.38058677783806,9046
33f5fc43-e26a-4208-b4a1-e22f402e5b40,Commercial,0.6938079769656363,41,29,413,869,456,21.334460308661548,7376
8d61a90a-43e3-462a-8832-b15b2f3a3d4a,Residental,0.18263241105986994,1,40,164,1199,1035,28.27247270478763,7546
92c07fda-3c15-4e44-8dbc-2e5549f818e5,Educational,0.43580297715705096,49,3,132,373,241,88.37915728722562,2690
b4574466-ea41-47e7-a147-66cfc6687057,Educational,0.37855421233550846,34,27,205,1140,935,14.371663743422573,5649
9deb34e5-38f3-4552-9c0c-0b4b7c92e83b,Healthcare,0.9749842808037813,16,4,392,653,261,21.084118514846917,6674
97f51a97-04c7-43c1-b71f-6b1587aa83e2,Healthcare,0.23692162063956146,39,33,665,1011,346,51.0396161844459,2252
7794903f-e78c-4c7a-91a2-c240e09cb037,Residental,0.1636714035744531,11,3,86,1423,1337,36.882325206101,9546
1e720e2d-a624-45f9-bd4f-466e2c85d59f,Commercial,0.3470038718371242,49,3,314,509,195,99.01798115357632,9189
6c5168f9-0ec1-4e27-821e-d8466d62f04f,Commercial,0.4276173749159785,44,50,164,629,465,45.41145387400858,3663
f8aed2aa-ee66-4011-a0d3-50f4768e0fae,Residental,0.3118444545607483,27,12,347,494,147,70.51551126948999,6503
d5ae592c-15c1-460e-995a-0ca8ae54e6ff,Healthcare,0.20328083184037604,5,24,300,690,390,11.354723247190904,9572
ecdd5f93-d99d-4d31-9997-2a5f17e21606,Educational,0.8554492050151057,41,14,704,795,91,80.33392955309206,8748
48d38c17-5208-4177-b87c-f9f7674a1302,Commercial,0.7727670635883285,11,2,476,1388,912,84.1695581103192,3659
7d2ef732-d18c-49da-892e-fb30c3ee5c36,Healthcare,0.674978033840328,1,4,592,884,292,21.723625210454948,3263
3c625280-fef6-4281-85cd-e4699e504feb,Residental,0.22384477476210052,33,23,382,1292,910,60.755418922069246,1201
a3f2cc08-3762-4099-b9e7-32b554f6e22e,Educational,0.49515910960713605,41,48,216,657,441,55.83614040823737,6431
b139e20d-cab3-4d36-9fda-391b5e42ca06,Healthcare,0.42719473124917684,48,9,51,1357,1306,22.305648451463032,9292
db22efee-7cc1-4beb-9d50-3a76c50c95f6,Commercial,0.8720508344539235,15,30,588,774,186,46.629148063498874,1359
7eb48e6d-1b59-4bbf-8ad9-05c798c012ab,Commercial,0.2292765557882125,46,43,158,708,550,56.80063717164313,9843
76df6482-a3a7-41e7-9713-5e0fe0b6359e,Commercial,0.8445830820745598,18,36,356,1435,1079,43.04581033976456,5804
8292dc37-b8b0-489f-84c2-9a2f515bc504,Residental,0.0191792578851947,10,18,149,453,304,57.11668690486056,6130
0b5d41e7-13c9-4e40-be80-fb6898d98c75,Commercial,0.61553847023814,43,38,562,1319,757,34.90566249133806,2295
d5e2ea6d-1528-4956-bce8-4584bf4faf46,Residental,0.6885704303782005,47,44,211,387,176,15.328229666357265,8993
3732cbca-22cd-490a-9d45-aa255d8c817e,Healthcare,0.032816653479793456,14,50,119,171,52,91.51839097205998,4441
7c2a2c93-69e6-42fc-ad67-99edabd42946,Residental,0.604921849570899,21,47,578,634,56,80.83466024427753,4212
c5ab0cce-9e06-4667-9f50-87674d57515a,Residental,0.6371146182950517,20,5,113,142,29,43.69170158627751,5182
aa5ba98e-9140-4bb6-8129-c614c86c3296,Educational,0.10667042620713796,20,41,297,745,448,61.065262996633095,8758
3692a0cc-21c4-44e3-b147-b9a933b186a8,Residental,0.5433156197784599,42,20,550,1214,664,49.97941353502106,5441
a3089f90-9657-4e87-8ce4-f96fa9335e9d,Residental,0.9690054733469241,13,14,490,570,80,22.704714285905766,1761
f72cd50f-e286-4222-a625-67671323945f,Residental,0.8958931487347337,12,21,428,444,16,61.08409804298234,6131
8fd5d737-1cc1-4478-b0a5-420f372f1e52,Commercial,0.7265549495322753,49,34,575,687,112,13.377625650066925,5207
a041bcb7-a51d-41f1-838b-c4b5502be4a4,Educational,0.3354886862737305,42,22,26,1305,1279,47.23145323930458,9236
f49d1baf-79b0-438c-b78b-05a31b218c0a,Residental,0.9166437482393626,11,4,31,824,793,16.71564820724401,5109
db8e26ad-a72d-4df3-b751-218b53e0e0cd,Educational,0.8828896231403387,9,17,380,1430,1050,72.25856360253059,4651
b6479559-31c5-4a01-afa0-2041c0f10a39,Commercial,0.7245871581011415,40,47,666,790,124,77.97292029585716,3801
54d9d892-092f-44f7-a5e8-f5f0fca923d3,Educational,0.4485852997105738,19,26,194,401,207,16.885608317344428,6992
2b93b373-0b66-442f-a5c7-2396a051d971,Residental,0.9983417341877386,4,39,214,1231,1017,47.53764258955542,4778
b3f2c26e-00d8-47a5-b541-f76869d7d94d,Commercial,0.961556136259285,18,40,149,433,284,24.47820457991908,3189
ff8fa974-b213-434b-88ff-c4824c1eacbe,Residental,0.23473824263202236,24,45,526,1087,561,20.42964733116208,1326
7f023fff-d6ec-4e6a-aeff-5a9787e3c185,Residental,0.8423392947059039,10,26,58,847,789,39.88895612521946,3127
addf5833-1b4d-43c6-a0e6-21e8c4b612d8,Educational,0.7865627009866284,39,40,19,722,703,27.90825495311597,9272
274644a4-26a3-4e66-85f2-2373ff82923a,Commercial,0.8119649362456072,47,50,696,1149,453,83.84900321390239,9269
01828800-13f0-4ad1-bf72-d3dfe84dff3a,Commercial,0.6545327452845301,33,1,138,1046,908,55.18959397237554,5512
206f3495-4ed7-4fba-9bd5-3ebc9eeea458,Educational,0.4248415906245181,22,29,508,1320,812,73.8131103164299,8860
e36b3469-e327-4dac-b4d8-b01fcfff958f,Healthcare,0.7850757538094272,4,12,204,431,227,80.41299651841226,7397
e9c5f04e-d925-4e33-ae11-379baf98ff24,Educational,0.7415972650634993,19,30,589,981,392,32.52983395860653,7214
e5ca9770-ae75-439c-909b-07b7b89fbe46,Healthcare,0.5697054712644621,8,25,4,5,1,42.88350988552329,3634
3326f8ed-d887-41ce-8896-cfdf66dc722b,Healthcare,0.5710518190114172,30,13,193,310,117,12.894344537939393,5412
9b906f49-b772-478b-b843-80bc968ff759,Educational,0.812763935749473,33,33,677,1402,725,12.832632507188203,4036
8669f3c4-8c30-4d86-9595-143b8c30b3f5,Residental,0.9519688147034149,38,48,319,370,51,60.112023130962704,8451
78d8c9f1-cb94-42b8-b09c-a2b6a3af502f,Educational,0.9710806103085102,23,25,255,1439,1184,54.937296869406765,6470
e63a4462-1183-4e27-b555-91da9a779154,Educational,0.31036455670339225,43,5,115,786,671,72.98673785739231,5426
513b0c35-b587-4c1e-ad05-2036a59cb775,Educational,0.9222130090709773,22,6,631,822,191,57.774255947409465,8524
c4a7e4b2-9572-4cce-9e8b-86dd2de1094b,Commercial,0.6015383992475125,13,31,713,1440,727,12.869558505414897,1227
c348da21-ebff-4ac3-8121-da0222f61edd,Healthcare,0.008963091386229971,14,10,252,1094,842,57.998762730388655,7530
7414db30-b5ae-40eb-8b31-a03b47cf1e33,Commercial,0.845860371956864,26,48,69,154,85,79.05281575775209,7556
a0ef5ceb-0822-4b73-aa78-a21d5c6a50ca,Commercial,0.4216605300483164,15,25,416,1145,729,10.453300072771931,3554
b937e047-f1ea-41ce-a984-d39db1470c55,Residental,0.457224018688569,30,50,573,1145,572,16.939669271102943,8837
949b0a76-f2c1-4b0c-9887-3b2c8f6db4b1,Healthcare,0.7676807861365934,29,28,714,1158,444,38.233600507960425,8347
558360b7-311f-47bb-b03f-d4b863fe9269,Commercial,0.2948642517085116,8,36,578,587,9,29.44046502895671,2438
b20eabce-a50b-4866-967b-36c13b52885f,Healthcare,0.14982326520404987,30,10,38,65,27,77.27675936699649,8048
7577751d-97d5-4556-b2ec-b94e9b9460e6,Commercial,0.11506511481083781,3,25,132,260,128,17.727058075446003,7938
b7e5f4ae-bc76-4cb8-ade5-b37d59f7cae6,Commercial,0.9036477965839695,28,43,263,1152,889,52.03738939147336,6887
eb347d26-d12e-4dc8-9748-cdf8ecd950d7,Commercial,0.778842832290533,22,14,463,1229,766,33.436929944100584,4719
37173f55-0079-4d59-ad1b-f208b6b32290,Healthcare,0.6283401959423486,11,29,309,1177,868,85.92160690434568,9707
56bde1ef-4a95-452a-97ab-79293f01cd57,Commercial,0.678958208555425,34,27,190,324,134,49.305898919605944,2096
10e89993-1713-4ac4-b758-5c114fca94fc,Healthcare,0.3895369077540547,26,33,200,817,617,49.840845353171595,8417
9c14c31d-bda8-4974-823f-6964196dc79f,Residental,0.11947338577235977,31,17,499,784,285,40.07109769526373,1561
2f373fd3-f633-4e93-93e2-b73d73cde090,Residental,0.7041948607248685,14,21,271,294,23,18.676563376540983,4530
29e055a8-d17d-4aec-8d4d-de16f4a38498,Residental,0.41936583575298236,48,13,463,1439,976,90.8053880312302,2228
9defc854-39ab-4c78-87fd-4c6928b869fc,Healthcare,0.24121581759269706,18,14,674,1086,412,37.61538532636405,2919
c4c7fb24-3a47-4f40-93dc-0cf23d6f71be,Commercial,0.31860155825300707,30,19,717,823,106,16.195646489982984,8181
34c0b725-c64b-4173-8858-9f95dbc8bd78,Commercial,0.8597885704918871,1,25,156,403,247,56.53668205663042,8230
303cb40f-d5ab-41b7-8797-9c42df90088a,Healthcare,0.9406467698683926,32,42,161,856,695,40.20199098438651,1681
a1bfa05e-5ab0-4dbd-acf6-ba5266b702b6,Educational,0.46723437122106926,29,31,595,761,166,85.83800329709796,8317
63eaaf63-df37-42c3-944e-2c11e7e1cf1a,Healthcare,0.2171938797908637,8,18,262,1235,973,20.56408791007886,1015
a271ea34-7a91-4d7a-8b91-b60680f71442,Commercial,0.753699806609045,8,32,265,1247,982,78.28569568530185,4791
a9869c84-e0a3-4510-9940-bb26b4944908,Residental,0.4430651794277136,34,22,92,323,231,21.46543433717029,5923
74a4a004-0107-4cda-8bb5-d839e6a53d0b,Educational,0.9106149478016317,28,50,40,843,803,23.520329917792967,1210
c64ef355-8a9d-44ed-92d9-0d948b8ef134,Residental,0.14126825527921216,21,41,422,506,84,85.19665272117517,6327
461b2163-f483-49ee-b92a-c142a5fe88d1,Healthcare,0.37094773072405507,11,46,715,767,52,57.21539057199213,9551
37b599bc-9aec-4b50-a55a-9b2025ae06b9,Residental,0.8149850382557514,20,19,327,595,268,92.995541456123,6576
e472dbf0-03f5-4af0-95f2-74d5dd0a9bf9,Commercial,0.355894901623235,44,44,42,1241,1199,42.66253329313258,3336
91c32d69-3c60-4d37-8113-3ee6a57e3b4c,Residental,0.5472090515610402,2,9,428,818,390,58.40457017291016,2179
24997667-031c-4a12-93a4-9c5ef886591b,Commercial,0.053197797046049766,39,7,491,1109,618,14.512148266052307,8622
c1ea09b1-c9b4-4e9a-9e47-02df415c4930,Commercial,0.16211983377059702,3,45,149,985,836,43.72865924744056,6005
1e48b908-c22e-46a0-9f73-b32f630cc84c,Residental,0.226969106762264,48,27,1,478,477,15.516135654525408,7157
dd907ae6-9052-40bc-a82c-4718aafad7b3,Educational,0.4349622022377031,44,24,643,1150,507,11.016372361054241,8247
c3aae78e-ec78-4b69-96dc-ebe55a3eb9f3,Residental,0.5100116188612421,23,48,654,1001,347,63.634371399650114,8937
636dbe63-061b-4b19-a767-bf18677a70c9,Residental,0.7098324149864257,38,34,627,1031,404,89.91095284862476,6217
f310af55-3c09-4b03-a67f-3be89ce8c774,Commercial,0.12414729495046506,2,42,713,936,223,30.92006826043909,2267
375ad357-5c5c-475f-b310-d9dacbe73e76,Healthcare,0.09151887324076746,22,27,67,1329,1262,14.190272282969843,2201
dc86a9b5-965d-4c1c-84ee-7f847db847d1,Commercial,0.32837107112074426,39,28,122,160,38,42.30761247888315,9480
f413c5c0-bbdb-4a1d-b059-8277912933ae,Healthcare,0.6056261283090122,29,31,227,304,77,44.64758648972295,8068
d7f5e438-7f54-4e18-bc7f-efc9275c5d42,Commercial,0.26726330789720876,1,34,636,1267,631,19.933368658045588,4131
7c1510e8-91ff-4c66-985c-f9cf9ee034e2,Commercial,0.5180025533460456,12,2,112,199,87,95.99187528278895,4407
977ea51e-f083-4c8b-b380-f7af61bde5d0,Residental,0.4699492946167082,24,29,658,1133,475,33.83161481274837,4052
2f031cc6-1689-4133-aa66-b849fc7aafba,Educational,0.6144836569888947,21,31,525,1248,723,46.643543886914955,3914
aad32f6b-dc24-4ece-9917-41f96b3bb947,Commercial,0.041018660591229494,33,9,570,1414,844,79.20178899345815,3238
6ae5fa19-8157-43c5-8df9-29c57a1dcf27,Healthcare,0.3768807863088972,26,13,404,679,275,77.66167632923508,7358
8373d1c0-5b96-4c26-ac9c-6124256df62f,Residental,0.6624806792602793,31,33,199,829,630,67.90511029952037,2493
2059c581-8aef-4f82-95cc-e28f0f220fe5,Residental,0.23361199557059142,46,13,550,1097,547,25.128813035350298,8965
a6524b3c-398f-4c45-a5cb-da0e91d17c0a,Commercial,0.6782264670334004,13,20,331,731,400,28.498173284782755,9934
51377279-8416-42e8-aff9-e00aba80b8e8,Healthcare,0.4549836663639891,25,11,349,1048,699,52.64242400483887,4796
bc065dac-8195-441a-b680-c5625a838b4f,Commercial,0.39715830517057016,3,37,269,523,254,27.3757449790698,1362
a83e686b-343f-43e4-bf82-bc21e0f3e5b7,Commercial,0.9382454743519173,13,24,317,1196,879,31.392032821946287,7344
a3383404-9096-47e4-8337-deebc8e749d5,Residental,0.4350822976727179,24,43,672,1409,737,82.7705481970897,1552
5d909d9f-9908-4d6d-b6b3-7f6f77f5f473,Residental,0.24733106871067945,45,15,45,1068,1023,39.00701861934416,6250
e1a60dbe-ddc5-471f-8d15-ac5b1246c234,Residental,0.8123927823205656,43,25,344,366,22,20.54428382309112,5415
b8246679-d8f2-4c69-8e50-ce1c738bdf93,Residental,0.08889804646471078,13,38,329,482,153,58.98623133488811,1641
32507ff5-452a-4c13-bd6b-1bd393fe76b1,Residental,0.6104020494246901,38,29,423,671,248,80.77991230728078,4168
820c55cf-d42a-4261-a4b6-bfaf040a7cd1,Residental,0.606468034505775,36,38,334,743,409,64.84072544126482,8743
6890318a-f394-42aa-8675-221026cac104,Educational,0.027998464240027277,29,2,491,1433,942,42.07615542505773,9543
6a8f9eb1-719e-4459-a1ad-b01d9a0018d6,Educational,0.4295589002904576,45,22,259,647,388,27.890165388115957,5052
0a078a67-dbfe-4cb9-a202-72ce579526f1,Healthcare,0.6594674922246715,43,44,335,1161,826,24.27382837709569,7879
b21d3765-4d93-4a07-b0b4-7b105f524c79,Residental,0.03280919520468062,42,1,294,1276,982,22.15908109433009,1745
27a4120e-bd1b-448a-a147-30d0fa218981,Healthcare,0.09446072240922188,1,15,679,1362,683,15.585717206884329,2784
1af33461-dcaa-49ba-93f4-d3fe08affa74,Commercial,0.3395407127486312,27,35,587,900,313,87.08637409408456,7968
d7754035-6820-435e-b639-1c3779a6f084,Educational,0.5263337986190608,27,21,446,1345,899,59.71205403012432,8976
d2ddd70e-bbbf-4edd-b193-83de17fc374a,Residental,0.5994810878806239,20,34,453,460,7,84.57480236392435,2706
bdcd83b9-c7fa-4e93-9204-815a2fc14923,Residental,0.6930008403590963,12,24,695,823,128,47.6989397087646,3714
dfa78339-e1ca-4985-93fc-a0743db2c267,Residental,0.16450275945080484,5,10,199,286,87,83.99709283439722,2459
32f8100f-0b3e-41c2-8108-f66944523332,Healthcare,0.8226584743783617,46,37,109,1142,1033,63.01193848709351,3244
834049da-d74b-445d-8e73-05023046509d,Healthcare,0.7364220637210959,44,41,177,876,699,85.459195286569,6325
8dd32877-eee6-4ecf-ab14-95579f0d9da0,Healthcare,0.027045700596282196,17,29,586,871,285,10.80046440226346,1960
e7f3ee24-ed48-4cfc-9de4-145e6b492d48,Educational,0.6791411696583584,21,14,122,924,802,74.02587843088253,2443
8e3b483f-2864-452f-83f9-54ed740f2fb6,Healthcare,0.3736566020596208,10,28,410,681,271,47.41119652951477,2540
1725f624-4ea2-43b1-8594-e60e3396830d,Commercial,0.389960924898464,34,44,118,768,650,61.06672842902044,7365
ae4b9c57-2589-4cc0-9cae-1116070f6c70,Residental,0.6827123952808646,25,39,639,1323,684,97.2156694288552,9457
f8aa6352-efe5-406f-8d6c-1c4a14dcbedd,Healthcare,0.43678020488000746,44,33,679,1181,502,31.67836998440837,7622
d4c9d83b-73b9-4df5-b880-ad297ab4a3dc,Residental,0.520171918481632,28,10,433,1214,781,29.471999729998746,3014
493f70b0-9490-438f-85b5-d22fba9f52d9,Commercial,0.34877933885625967,7,30,312,641,329,95.60847708552039,6200
ae21f496-d806-491f-baf6-1ececfd8359b,Educational,0.7485930095974133,20,8,108,637,529,19.49874780478008,1560
1692b601-f688-4151-8a06-4af39d180c82,Residental,0.31691889007533036,38,49,390,743,353,94.60179831729039,7085
bb5df702-cb81-433c-9146-f5ac829f41ed,Healthcare,0.6681015346893914,14,47,39,318,279,64.86712287719517,6571
c56a684a-3f05-4759-bb17-56cdb9af00a8,Residental,0.9833576387202793,11,49,188,330,142,92.30138175580691,3896
cb1068de-deab-407e-8e6c-a185cda8e4b9,Educational,0.5513515416123544,1,21,494,752,258,16.182316567238804,7288
7812504d-4aac-43a9-8749-e931a301faa9,Educational,0.5173652699096815,1,6,605,907,302,97.73022731709233,9039
c579519e-b27c-4d69-9811-a1b5a2194a2d,Residental,0.16841275148098,27,12,638,1390,752,20.181596531225246,4014
98a289fb-edf4-4666-8b9b-f8c3aa241c68,Educational,0.6201738641771947,16,28,23,109,86,80.37944584248046,1935
875df543-9b2e-4b9b-97c2-51b00bd78715,Residental,0.9501703299756032,20,14,143,816,673,47.82495795134967,7616
51491d2a-4761-4086-9d0d-e174d6187915,Commercial,0.9872474287162945,12,8,383,1376,993,23.87076372664789,8570
b91a1919-ca73-462a-a87b-223b1d659db5,Residental,0.7407571340056038,36,25,292,1036,744,37.3067714560748,3230
ad4ce73b-4171-4655-af41-7d1236715277,Residental,0.8606957312579088,39,6,433,1279,846,82.60154906479428,7631
08f301f5-ec5f-437a-87d3-f01224a6afe1,Residental,0.5742772522676025,12,22,586,783,197,53.21357027911345,1988
84c0f8c2-e92c-44b3-af74-6b266a49a6cb,Residental,0.8787601107468591,2,44,163,1349,1186,77.56518172847197,8375
296a729a-c380-408e-946b-904ba78a131b,Commercial,0.21341583165506928,27,49,324,992,668,61.1140351381055,8662
3a214a77-690b-48d7-a5ae-1c717f8a87fa,Healthcare,0.909911871121661,2,32,62,767,705,31.295989139267054,4520
96726390-85da-47aa-9c76-cff55210f2cd,Commercial,0.13060057771032574,31,38,587,974,387,78.67394818769836,5629
e182cc23-4190-424c-939c-e1deb7e6de09,Commercial,0.5118091691982035,6,40,7,746,739,48.24684032899095,1706
6e28fc6e-b538-4ab5-b690-69ad8dc186fb,Residental,0.3434010207005228,37,12,108,646,538,94.31239210555074,7242
c947be67-25c2-47e2-af57-f184bf48319c,Educational,0.7576325483526519,48,49,461,850,389,56.60113126855387,6115
97feabed-1199-484f-94c1-7fbc49bb9aaf,Healthcare,0.28394148281623266,22,16,265,997,732,63.33640912799245,2154
822e5429-e37f-49ca-9d12-e5fee3554836,Healthcare,0.7366892219481043,38,17,208,807,599,10.727213034800926,7501
f6e4b623-d9d5-4c68-959d-96d9e9a5e8fb,Commercial,0.6168519702306521,14,11,404,788,384,48.56869072906464,9114
3935cdc8-e2f5-476f-90f4-826f2db725bc,Educational,0.08424280208175616,48,22,511,906,395,32.82706142561198,9738
1fd097df-cb51-4580-9243-fdae30f08e05,Healthcare,0.7095314293956607,38,42,538,957,419,41.59237488494195,3049
516e29a1-341b-4265-a7d1-8d1ee1263ba5,Educational,0.6280835880345835,14,33,393,1262,869,61.53608854476905,2924
27eb8b21-0d72-4059-ada3-7839b8be720e,Healthcare,0.4435593601454637,35,20,139,822,683,66.73420793605652,9605
76c3b432-90a5-4804-9d17-fc963897dff4,Healthcare,0.8184947231222923,15,14,19,336,317,96.64528162062726,2415
ce6e7877-0568-470c-b0bd-91ab12252fc8,Educational,0.6620301906180688,30,48,286,1405,1119,16.571578926080548,2750
1845157f-1092-4abd-8466-71fe55e7fb5e,Residental,0.5593624226916525,15,28,239,1060,821,44.35514748954484,3800
3f9143da-f551-4281-9555-aaa7f054a5fd,Commercial,0.6107733482272226,8,32,330,1209,879,39.31426613368175,9739
a46e36c8-1660-4718-8eea-d2caea2b4e9a,Commercial,0.2392113841869392,23,50,382,1240,858,94.09373284149979,8394
62a1219e-a090-4ae6-9e48-087be73d0a32,Residental,0.3637999586666576,44,36,44,572,528,83.38368966258284,9446
1e10a9bd-ecf6-4eae-a0cb-e515ec91b392,Commercial,0.8473594549727121,48,36,720,1301,581,49.436113489870614,9552
6501e853-603e-4547-a1f8-378b2489a9fe,Educational,0.8379601423306589,41,4,256,327,71,64.10014270673265,4304
8f81c8eb-e29f-4940-939e-4db46685fd64,Healthcare,0.026605317897601566,8,43,232,614,382,62.02702482389493,3641
48367cda-43bf-48cd-920e-af65f44d4835,Educational,0.8409082570473396,36,29,268,1221,953,64.03166047350238,7259
684d3a1d-f20f-4293-9964-06e572fa13be,Educational,0.517334008057727,5,42,597,738,141,78.2148963773327,9591
b325f6e1-09be-4100-ae00-8b9d041a4b7b,Healthcare,0.2649647230912566,5,45,614,1228,614,40.94671059831858,3284
07d996fd-5566-432a-ad61-49ce169297c9,Healthcare,0.2362621535135354,22,1,384,785,401,54.931988712716034,9833
9b527946-472c-441d-92fe-6e8963b42ce3,Educational,0.34758631807574303,24,50,202,428,226,45.252589808607254,4905
4c8d3857-caa8-4eea-96d4-fde69f031289,Commercial,0.8813659161299163,39,39,200,1413,1213,29.599674484338053,6948
f020e938-1f81-4564-a62b-dce072d2145b,Residental,0.27162782244601213,5,36,47,647,600,66.14104630629497,5424
ea91e750-ef91-4bdc-a65b-a11fcc541224,Commercial,0.06969449632391089,10,31,82,240,158,31.29516151532713,9260
2b444f92-c5c9-4074-aa02-5b52b7ab91d9,Commercial,0.21763613976063145,16,28,141,334,193,22.971117795219723,9606
eb5c8b43-4e41-4530-9e96-a50a60fd14a1,Commercial,0.6398158995431138,4,40,649,1116,467,83.10712084376904,7946
5c9b44f4-8166-4543-87e5-7eb4fce58a67,Residental,0.8506704698583886,48,41,623,989,366,99.98898398072994,6022
9aab89fe-087f-49af-8f54-f1b34bf22bd3,Commercial,0.3374140084805929,48,49,538,788,250,14.820631610033507,8846
40ce3022-7cf1-4ba6-8ceb-e4c9b5ecc985,Residental,0.8332261183231154,37,2,497,1381,884,43.362554309162434,8554
149538bf-086a-4bdf-9c63-4f0afb3baebe,Healthcare,0.45342981187791553,14,12,25,609,584,26.727445369482645,7568
d985c4c9-4771-400e-b4cc-1f71d8329c00,Residental,0.2567802417795011,26,23,468,784,316,58.203431974279496,1627
b2a11157-9c95-49d9-ac32-be7cb2712cb6,Healthcare,0.05027762870232111,16,34,528,977,449,69.81150783098316,3415
b0da1be7-64ac-4aa9-acf0-6cb959343302,Residental,0.9772106653890785,12,45,489,1390,901,76.18359049489743,6546
200ca01b-88e4-4a81-9890-e236732eab52,Educational,0.8615332677354351,8,23,114,511,397,20.48260814241807,5952
dc304059-dcb0-4c23-b677-9d6699b7ab43,Healthcare,0.6287129767649072,5,45,600,1378,778,99.29770703876419,8583
c90f5372-28cc-43b2-9f5d-41755c1ebfe2,Healthcare,0.5354412672232295,11,20,526,1202,676,40.16401021669709,5777
37d9d574-06d9-41f4-a3b2-db2a56b4fdbd,Commercial,0.11345374932120977,20,40,445,583,138,26.227240721045916,5855
909d9f60-1a40-4831-a672-6c562e9b74a0,Educational,0.04200455838260231,31,8,579,1344,765,31.335915038042298,6411
55eb6e3e-5572-4d20-8725-a5054cc3df23,Residental,0.4503266229448635,17,38,609,1058,449,57.50194105490829,4731
2f8262b4-03f4-415a-b76e-7d3878882496,Commercial,0.8372978000688016,37,18,4,1066,1062,24.542965745819817,2506
4daf38ff-8172-47bc-8932-f90fc299aa9f,Commercial,0.8577925503410767,34,27,573,717,144,95.14971809257104,2089
557473fb-3f26-461d-9b03-5125c422edac,Educational,0.2153438870192137,25,33,696,1225,529,93.88473748793442,7857
8187c686-b755-4d03-b04f-3ea705c04d59,Commercial,0.18451113304835598,13,35,256,306,50,38.16057878660223,7636
3d91d4c7-62dc-41cb-ab20-c1c84e658d98,Residental,0.8329953300162091,14,23,339,488,149,55.03061338839767,2587
0d050825-2da2-47ad-97ac-3c948e81b592,Residental,0.8500826590205931,35,50,715,1390,675,35.159052459685256,2809
0dd6cb54-44db-4aa4-8294-d1a9174d79f6,Educational,0.48054694496049355,38,36,254,376,122,14.97112676587378,1333
7e825b9e-5ea9-450e-9887-d62749f62197,Commercial,0.7656114056633759,44,17,575,867,292,13.350042558982672,3253
23a966b0-f939-4175-bb83-f11cc692b1e8,Educational,0.8177868000789701,50,47,644,1051,407,41.990018883708046,2095
ad378171-dd6b-4419-a4ce-707e1e70a078,Healthcare,0.045460572328113735,15,2,583,663,80,67.81865189724466,8792
77826784-5ecb-4e86-ba33-5168446f6a0c,Educational,0.10721871803900695,41,26,680,1243,563,77.7974102190904,8683
17fda207-a49c-4ac5-a4a4-d4edf211345d,Commercial,0.6272896704906206,5,34,706,913,207,77.40767778612356,6480
1df3387a-8080-4819-9243-70ce75152931,Educational,0.5882407182876428,17,27,426,903,477,59.58900115571498,9952
13f3312b-10bb-4032-b404-516e05d15f88,Healthcare,0.9763092107081206,27,10,529,1031,502,49.891273640456724,2285
094b5a94-f250-45e7-9009-8711601bcdec,Residental,0.3345772070409079,44,16,123,889,766,86.65920751837923,3337
dff9aa20-c8f9-4fc0-bf64-5fb87a828021,Educational,0.9056686673048064,32,45,475,839,364,23.94908954219865,9480
889c4cd5-3737-487b-89e1-70f82660dde7,Educational,0.4979332813661065,32,48,30,113,83,78.26157843827461,7098
7592b9da-df29-4992-a7b2-8621883e7537,Commercial,0.4976161627530715,9,48,177,363,186,63.74730486077289,1593
4a315bd1-5a32-4605-9ebb-2a8c9f20c82d,Educational,0.28634527648658425,28,21,321,1385,1064,78.10480452654895,3410
07341b1c-f38b-40fc-b7f4-8fe8bae1e305,Educational,0.8420522049526339,46,8,340,733,393,77.58630217673652,5047
0dd3a489-0639-4ee8-86c7-ada1b4bb4b19,Educational,0.49398177248151653,34,27,52,387,335,34.91452876610196,3042
750edf6f-bd45-41d0-a2d9-924a0fd5b2fb,Residental,0.5358029495735234,25,42,302,595,293,47.91800823644653,7187
0db4f9d6-13b4-4d19-ab65-7f1db0129436,Educational,0.06874838873972167,25,7,492,498,6,71.7008047258104,3662
91839620-7f96-44f1-97f6-b7a7e8a9e093,Commercial,0.80032893411056,44,50,686,1296,610,24.948151108011928,5726
5861c5c9-f835-4b2e-82b4-265758b36a24,Residental,0.6354263836034275,42,7,360,981,621,87.66684004838463,1641
8ca699f3-38d2-4891-90d9-9aeeb98ae065,Educational,0.05456582878239702,8,47,279,777,498,75.69566302203998,2423
d3fc80a1-b780-472c-814d-91ace7593e3f,Healthcare,0.0035862796911217965,40,1,548,719,171,26.859069918251173,8462
c358c7ba-132b-48aa-91d8-cbfe4a88d951,Commercial,0.7734150798643912,16,8,79,319,240,28.36238501150378,6129
654eeb46-0ed0-4425-91fe-8365c9e14b6f,Healthcare,0.03494569966042793,6,17,14,334,320,21.307355480450568,1603
e18ce00f-0acc-4790-b103-8f727accf61a,Residental,0.6599794750254332,38,20,42,329,287,84.13391818640999,7870
249f4ae4-0fbb-4143-85b3-7a730a63ca72,Commercial,0.43526541862469514,17,6,620,1095,475,87.1958343087381,5307
52f6f4ce-1496-4d31-b304-7d30b820ae89,Commercial,0.3423463396182356,28,27,698,813,115,43.074607162234244,1017
5893dbd4-d2e8-43d8-96d1-45a2407bfd74,Healthcare,0.3621463334701256,1,19,308,1301,993,84.08814209482783,1834
a2d10c88-7188-4596-917d-a807c330678b,Commercial,0.3186852567721875,24,34,77,92,15,75.72409276020039,9541
9624619d-d24f-4f0c-a872-51ba076568fa,Educational,0.6066128205764707,34,7,122,591,469,90.79688661977823,4334
e238cb4a-d062-4c0e-891f-e1743aab6200,Commercial,0.14470709721228747,13,45,688,922,234,27.968526422574417,5572
939be60f-a236-4071-93e0-3b8faf9b3a20,Residental,0.24330184414417055,18,5,552,734,182,85.50762967200588,4088
4515f832-677c-45d4-a60f-1dcfdaa3bce0,Commercial,0.6064402789013209,5,39,423,1277,854,42.28074886928464,3550
b4d8e26b-a9a2-4262-a485-1b5d429577a0,Educational,0.006879319022235375,34,14,536,1287,751,46.94621007458683,3875
a964fd16-e111-47f3-845a-b8492ebd26b3,Educational,0.7369693213186327,41,3,663,1018,355,44.48431250442285,9936
1a2c2872-d001-448c-aaf7-18c69975e8bd,Healthcare,0.9442734981114859,24,22,393,1171,778,43.21497528231353,2680
727a5fe0-c309-4cfc-85da-1f8f6902c7cf,Healthcare,0.9177310197198333,19,18,166,873,707,35.05781975233285,8200
53ae4216-fa2d-4f17-921b-2f8797ee509c,Healthcare,0.9959822904468055,50,46,12,1242,1230,48.88264167026456,9394
262c3f2c-4bbb-4021-a791-346d9a1b6d3c,Educational,0.653664474588183,34,48,700,1105,405,99.35715211008402,8293
e1862d1f-5bae-4f43-a51b-069df512a45f,Commercial,0.03759650637043099,24,39,526,710,184,44.010141166363674,1094
67a426c3-805e-4cce-bf9b-b664b21654f5,Residental,0.38673008115801655,28,3,223,1368,1145,55.62570065734207,2733
022f46a5-9573-4ddf-8908-c6cf136b9261,Commercial,0.2750523533429423,29,10,439,518,79,41.07184785219276,3625
bea67ff6-e727-49a7-8017-c97862ec701a,Healthcare,0.9291375696825642,35,44,570,746,176,92.73507723122277,2390
568e36c0-8d1a-4bf9-adf5-4dbdffbedfbc,Residental,0.3161805506787967,38,1,528,785,257,84.41207327442051,9442
17ab91e2-b61a-4efe-9a03-a063d1ec7136,Healthcare,0.5507729598132431,29,14,451,671,220,31.95209855401055,2180
8ca8e832-e8be-4d03-9506-4edbd8662898,Healthcare,0.20293358185056876,28,2,305,982,677,79.31555391353025,3950
dc6da6b9-0747-44ee-a787-c2850248bb41,Healthcare,0.3875024032922586,37,11,199,1285,1086,57.095213844508386,1248
bc6fa9d2-5d40-4f6c-a13d-20e605639cd4,Commercial,0.6994393923661705,44,38,638,947,309,16.230590556820832,1722
3ca61fa9-48d5-4e54-b895-07309800f4a7,Healthcare,0.13107763108576265,37,3,387,530,143,33.27739804383347,2006
5a90ca52-9b22-4d1b-8734-7ba31ce372f2,Residental,0.43533375965872845,39,50,594,1229,635,60.128361071396355,4127
b9d1777a-54ce-4090-8956-ef2316c06067,Residental,0.8919552956186191,26,35,170,500,330,97.47639897301303,2110
cb0c7ce9-c76f-47ce-87a5-633df347c65f,Educational,0.3915962859456136,46,47,586,694,108,39.56013707643203,5623
2b4da414-5a13-4983-8871-ff4310d61ee3,Commercial,0.009833706453114655,31,43,681,1234,553,89.28918211848803,7216
14557335-e82e-4202-a987-964b74fd7b75,Healthcare,0.08780614634421635,19,14,550,600,50,33.858047691008345,2523
33c6e979-78c6-4e0e-9062-bca014e6de35,Commercial,0.4551193338874069,25,26,285,986,701,61.7052540638246,9432
1ad59c60-ae16-4fc8-a0a9-f4efc74e0848,Healthcare,0.43713737779138173,20,25,614,642,28,18.13588977737251,4096
655467cf-ca4b-4eb2-a668-3ad8c2d4f769,Commercial,0.9910415127215509,28,29,482,934,452,18.829864471547815,2533
1a596fab-b648-4d92-82b8-d2209d2c29b1,Educational,0.35270793231582653,24,28,581,1430,849,56.18378671465148,1459
b47cb9f6-9e37-4348-80ac-d13d108041bc,Residental,0.22136353663766128,23,11,126,198,72,58.3190670005574,8871
bf6fb41a-f412-42a0-bf04-8a16520790da,Residental,0.33388492274598724,20,15,657,851,194,37.80406649241371,4675
955f0ff4-b816-47e2-823d-e32c72ef9584,Commercial,0.16093011813609093,37,50,81,282,201,79.66293013931063,5749
e234fdcb-0011-4f1c-8a5f-857ba3f818ed,Residental,0.6012671253572648,31,9,98,379,281,49.158298626437826,9473
d57a21ab-63cc-4ea7-b0a4-f76551c27dd5,Commercial,0.8813076791239751,46,49,680,1103,423,90.4347472781732,5881
fcf85a87-1f53-4a82-9bb4-32dd43b688bb,Commercial,0.308633824335535,28,44,424,749,325,54.50770220124781,5047
c9a5630b-c82d-435b-bf0e-8d7fe461b4af,Residental,0.5400102817065342,50,32,399,589,190,43.195330740851915,6316
9efb8f9f-6e69-4cf8-8fd0-3d25859ec831,Commercial,0.9298631035287835,23,37,127,510,383,41.33202892113998,9080
84b96b1c-abf6-4119-be40-a28e85b2d9a9,Commercial,0.8968295195652478,46,32,705,1354,649,43.38542006662267,9329
a06c2bb2-de59-430e-840d-fcd95454412a,Educational,0.02804038800239461,34,32,221,493,272,56.56604058732441,8996
f18c2c19-1e6c-44c2-ad69-14f2cb682c8a,Healthcare,0.8489870980053048,18,28,712,938,226,65.29584852984843,2950
ce62c310-c006-4e62-b46f-776457a3e7fd,Residental,0.2031149862596734,31,48,191,433,242,25.943045288228305,2011
384b011e-2973-40af-a0e1-0deb9743dde2,Educational,0.5831727687280702,14,29,312,1271,959,37.154501715208085,6041
39256698-e0bf-445d-98d2-cfa91bb53798,Commercial,0.7438943065335611,5,25,63,503,440,67.7846534350552,4437
b9b38b06-bb1a-4825-849e-3d9fcb315cf8,Residental,0.153158041063309,15,49,349,1276,927,71.48082198942534,9201
df2ed05d-5675-448c-8e72-f348fdc9e2df,Commercial,0.35773796319576745,14,43,200,815,615,95.89461799413283,7853
8e00f185-3f3f-4da9-83d7-aed3f4f9698d,Residental,0.6111449277505507,28,2,403,1008,605,66.39823920509235,9962
bd2f6d9b-cb19-4d3c-a2e0-c1be6e8c6d16,Educational,0.23318193978213964,7,40,34,1119,1085,76.10190187213912,2686
3b5921d1-0871-45fe-8223-a95e028829f2,Residental,0.07053802941259957,50,50,328,786,458,14.043811283650847,7632
d40d936d-9be2-4776-932b-cda54caa2088,Residental,0.9928029819615829,30,24,394,1249,855,62.88402285201825,7852
459ae654-8012-4a6c-bd63-b0040e6b9caa,Residental,0.3029146443505907,9,42,159,237,78,18.78239672788528,4486
6994a8db-2950-443c-b0d7-cfb178cf4bba,Educational,0.8027144807237874,50,18,463,1428,965,93.65776666989352,4573
b6fbab9d-cf04-4fd3-be3b-7a46613db60e,Residental,0.17205407777148107,41,16,219,885,666,72.00720196576164,6434
cc0b95e5-8869-4a6c-b844-d27e83e044fb,Educational,0.6731290654871598,26,40,706,891,185,95.36857103392286,7274
f4ce8219-2dc2-46eb-a4f4-ddbea5cc74e0,Educational,0.46394906958838156,22,17,601,689,88,97.3279658665778,7403
39557ac6-9f3b-4fca-892e-fe228123eecd,Commercial,0.12302852578716483,45,2,572,954,382,23.227841697644084,4474
5252a938-1f97-4def-a625-ce2a30a6e91f,Healthcare,0.6955680545857654,5,16,630,1290,660,72.11391672012888,5348
65e4febf-3416-482e-81c3-63023200e9b4,Educational,0.053061958618803806,42,45,120,960,840,38.71136352978647,8121
e5ec5486-8228-4eeb-a052-a9245d674124,Healthcare,0.5003072385570408,44,16,634,927,293,13.6520181445592,3212
4fff1f56-0d59-4f55-b3b3-fe695ec1e8a7,Residental,0.18255377667521333,21,12,389,942,553,17.045303044555688,8069
a92d68f9-986e-4b1f-8aba-e2da5a6a9b62,Educational,0.7874292295561895,46,14,405,770,365,58.714046383121854,6978
31c452f1-9022-4abc-8d57-3e43d138704b,Residental,0.9154873077829635,20,49,339,1225,886,11.104620261804767,9845
9eb46f83-29e6-4e0c-bb99-00f2711e1189,Residental,0.7171109923141723,7,11,669,1132,463,24.28021397723343,6030
55eeec25-9a67-4a6f-9c47-a12190a2bc0e,Educational,0.49918190573074683,20,25,584,844,260,98.78704312471642,9244
bd07dcc1-1d7c-48ae-b868-98f4e7acbd08,Commercial,0.2886124360177277,3,21,89,894,805,57.161134289399875,8470
c5e8b4f2-7688-4b96-b9f0-bf9d23beb1e9,Commercial,0.49528704666110734,40,10,221,579,358,91.23592341152025,1271
5139d27f-6bb9-41a7-92a8-547adb6d1796,Healthcare,0.5802202647754228,21,20,373,1393,1020,42.656513279023685,6160
34ef1cd5-40e1-4a2e-b5c0-2f4bd38af5f9,Educational,0.2170454697798464,7,42,23,1401,1378,12.101307189045347,6025
644711d4-a8ac-40f0-ad09-4b716549e038,Residental,0.7247118881326902,16,26,250,305,55,68.5135383589138,9685
06bc5690-d3b8-41e6-bc98-76f29104597e,Healthcare,0.619776198179443,31,19,175,377,202,50.501707206532636,3946
75876919-ae60-465b-aeda-c8267c332c76,Healthcare,0.5721420101362793,25,11,411,1002,591,76.09456756650437,2683
c0001ea2-dbc4-4b1f-988d-03dc267fd9a8,Residental,0.9100875983435499,30,9,596,620,24,64.36124304144809,9288
a3236d87-c6da-4daa-ad79-5e632f6a57b1,Commercial,0.9338444036065752,14,22,366,910,544,20.755415021294315,4298
17324fc4-caed-4935-a42f-50b72f5d1dc2,Residental,0.8126956544488239,21,13,594,861,267,52.645869178759824,6986
55120d81-af8b-49e1-b0c6-af82e132aca6,Commercial,0.1264201758148259,5,44,436,472,36,42.14944045575543,2353
f0682a11-3e40-41cf-a4de-69defe611338,Commercial,0.509805929604472,22,46,636,1184,548,11.470109112846187,7477
3db7b584-f6d3-4a6c-b122-9730b073f9f4,Commercial,0.26646849090944125,37,7,678,1263,585,30.31312107663236,6268
60cb5d11-e4b8-47cc-9eeb-74723343aa50,Residental,0.025571432901330904,34,6,175,1203,1028,18.429943834053457,8662
e01ca10a-d757-4ce4-9739-1778675b9970,Healthcare,0.07167580920473615,15,27,622,1343,721,70.51523304220967,9441
55511ba0-a7e8-48ba-9925-47ed0b17ff29,Educational,0.712445687514277,7,8,85,835,750,93.15780164314039,7823
38278a60-3919-4809-997f-e39ba7143b5b,Educational,0.11623850324518814,15,28,113,434,321,53.64375399687092,9195
eb7f8cc8-15f8-404a-b389-a692e67cfaae,Educational,0.4264484665093373,45,9,296,1296,1000,37.97881795229834,4221
73317896-0109-4c8c-93e7-73408985a6d3,Healthcare,0.9185657334825623,19,25,473,650,177,32.23634435071802,6858
584484ba-21e8-4412-9acb-46d6e02083f9,Residental,0.5002995903598083,25,12,646,720,74,62.04658981531079,8043
fbc9f027-2544-4338-9883-28787f371eae,Commercial,0.3127106479216857,48,24,708,856,148,33.82445407628711,2490
d04bef3e-b37a-4179-a25d-8cd822a011f3,Healthcare,0.9975609494929741,37,26,527,1079,552,20.670743513726414,5832
878c4630-4cb0-4927-ba74-5abf98dbb20b,Educational,0.14359396353786058,7,11,671,1066,395,35.88847234586329,5300
5fe4bb2c-9e5a-4f05-8e3d-1ff46aa3a584,Healthcare,0.5446165144776915,24,8,681,958,277,60.04386143962539,4668
19da2759-466f-46dd-8f99-4f2ec27bc08c,Commercial,0.271097978376885,49,8,104,1313,1209,10.679085572680233,6859
b598ad49-2394-4ef5-835c-5dc542b7792d,Educational,0.5047731731384691,39,13,700,1296,596,46.49379170703924,3301
43e7b33e-10ba-47f9-aa21-dfb201c5d4e3,Educational,0.18180317975997928,50,20,457,1361,904,62.748664556202264,9745
cd18aa9a-74ea-4353-a5c7-7cd7ae6112f2,Commercial,0.005314281523735365,44,39,558,988,430,71.80692089695088,8196
6cbdff0f-991b-4cc1-82f0-54baed514efc,Residental,0.6524984817695372,12,5,77,1306,1229,78.43198234839231,4020
d57400dd-cd9f-4da5-83ee-92307b57817b,Residental,0.13417159189310246,42,7,209,1297,1088,29.08333995896059,9711
52cce04f-05ca-452c-a928-f48ef35bc4a8,Commercial,0.5688035244059373,8,5,207,1376,1169,51.29394889179764,6389
48b625d9-6ccc-4e7c-8204-a143b5aa3900,Healthcare,0.34967480684305086,14,33,657,1278,621,53.509696949060285,4000
a621edae-97a2-4e19-ae84-db42ebdd6e33,Educational,0.776664115320444,9,36,133,764,631,60.14436637525764,6807
212e7333-7450-4902-bd0c-b3d3ceef7780,Educational,0.823367518418661,43,23,360,599,239,87.249230762025,6243
80d372b4-27a6-46d2-a432-55081a5570aa,Residental,0.2717884831639864,7,44,3,34,31,57.263785306278116,8238
6b10c41f-4f8c-401d-b3f5-e0798c2b47b4,Educational,0.8810641259980889,36,33,541,1191,650,93.1111897927472,9039
7f6d8996-bab4-4e3c-9a45-b18145bd2b74,Educational,0.756368845279987,18,22,290,700,410,95.3538473207877,4512
d00952db-3a11-4fcf-9d26-d841b7e876aa,Educational,0.9461841604812861,2,3,642,1440,798,89.77439955024835,2849
db4357fc-f668-4c61-9a3c-0b7461eb97b7,Commercial,0.024340551520305787,24,15,66,194,128,41.04594639226059,2333
e3f3fd9a-2a1d-4436-9475-0e77b91d643c,Commercial,0.8740160186671385,31,39,638,1160,522,62.497808609282316,7791
d008974b-356b-41d5-9e0c-f53a90b06c1b,Healthcare,0.5281991481465035,34,15,361,1343,982,65.06353248971665,6060
545ed726-0daa-4980-bcd7-1b96f65adb55,Healthcare,0.17469666485269386,24,42,66,749,683,74.11811702094897,7729
f8d3f6b1-553f-4603-88a9-a2a8ec677de7,Commercial,0.4069334451397403,10,3,469,1015,546,14.088489708810565,4746
4412dc75-1e98-4096-b191-5234d1b9291e,Healthcare,0.8423640529953347,21,31,189,513,324,50.53462301188591,3374
70cc6955-15fe-464b-81fc-8743267b0589,Educational,0.44166068912509904,46,5,100,190,90,35.98038437583878,1611
0bac668b-4784-493d-9b53-17e30d196e9a,Residental,0.4431314880445246,15,39,203,1391,1188,16.89214057572577,6415
5eb7209e-5696-4256-894d-73e4b14a9c22,Commercial,0.4999517998173596,30,45,680,941,261,48.98900311982286,9136
7cb44a03-ac7c-4f45-a9b4-eacdef999b2f,Healthcare,0.05363598014971627,22,32,594,803,209,46.37992116159765,1999
75521a46-6ce4-4a4a-8be1-620d383c2281,Residental,0.948754133231081,46,25,453,1063,610,17.019306661381208,4649
69e67b3e-afb5-4adf-9622-4ae8162fbd7b,Healthcare,0.6636441704998757,25,48,75,618,543,98.66086776257525,1663
e75645c2-5051-4ab1-9514-e0021923e6eb,Residental,0.48342597551715616,5,29,383,1122,739,83.848560385418,8067
c0a1e347-ff79-4a68-8bc0-3b6b528ca9eb,Healthcare,0.8564213801456888,15,14,35,1233,1198,44.796810875686035,3511
bc83f003-8b8b-4c42-b88c-153cebfc13e4,Residental,0.8195933819068455,19,6,707,907,200,21.710928037439302,9631
ec1e0ba1-53bb-44cf-b3a6-5dcb73b42117,Commercial,0.4071842032792946,45,9,602,700,98,62.965612609730016,7547
23293052-f0be-4a70-8221-fa433e32c8f6,Educational,0.48182939615046183,50,6,394,496,102,86.92317008796115,9131
a0af56eb-7622-428f-9c8d-00cf092ff225,Educational,0.1674659120314711,17,29,180,664,484,31.453845068831416,7051
5756ca34-d897-4155-b3fe-19c43c3bb55d,Commercial,0.8793410424139326,9,3,690,1000,310,89.88224697074308,3389
b16d0e1e-a64b-4a87-bcfa-4d567b9dc8f3,Educational,0.4332366118972044,8,14,314,839,525,84.17386131034992,3292
8d809388-a1e5-46a1-a93f-ada6de137cd5,Commercial,0.8229727061873277,28,6,152,1438,1286,16.402711329042003,3581
7cfe8532-e15b-4be0-b06c-347181925100,Residental,0.28565755215345334,15,38,377,1259,882,29.412561239990247,8474
bcc887df-20a1-4d2c-af4a-3c9080624637,Educational,0.7732556720030104,9,26,84,1003,919,78.6373451970455,1380
a0c1fb63-0a40-4f87-9609-55383e14bc4d,Commercial,0.5492290644389236,45,17,50,641,591,22.047004458051394,4377
e1a1e4d1-2baf-4263-861a-828890d5a2c1,Educational,0.39496691900777425,38,39,499,1412,913,49.52962537127502,9376
78935bd1-2244-4f52-aee3-646d964be143,Healthcare,0.7252131287433118,2,24,323,1112,789,23.772224323854477,8224
0b52a226-349c-4dfa-a310-f598c7e6ffed,Healthcare,0.35774413797952587,40,45,440,566,126,76.84808847149725,7598
5065c208-7858-462e-b225-414f2860d446,Commercial,0.20934968005419086,15,2,535,717,182,16.334859105239644,9234
d485bf11-29e8-4165-93e3-048c5d5737ca,Residental,0.8521609280900417,50,43,430,1383,953,31.015351037071074,7686
6b73d5e4-1b65-4bab-9b48-6cb7dc69d880,Educational,0.00841363857906352,38,26,379,1254,875,53.87265349529224,4598
1cf1be82-5eb4-4c6a-b82c-98fa04e08542,Residental,0.45381579192353527,16,32,107,318,211,99.42417230097084,9153
9df1c8ed-ff86-4203-94dc-d1ebfb7ee92d,Commercial,0.4839845439931899,37,32,665,1263,598,48.020723260913805,3320
12687fcd-7a0b-445c-b953-cb8703ee0a7b,Educational,0.3564732538998,23,28,720,1032,312,65.38107907680734,8774
386f4d3a-00f4-483c-8bac-521ffcccd893,Commercial,0.796254374656473,39,48,82,1256,1174,79.5358988546605,9860
25b00e93-1656-430b-9759-3a31c2cc933e,Commercial,0.3612259170051858,26,37,337,863,526,25.991664574227393,1655
26266fc4-9c00-41b2-83c6-19c9162cd62d,Educational,0.8783008862670141,32,19,545,1205,660,46.40078503830015,1839
cbc975e7-682a-4c5c-bbcf-99993c48ecf2,Commercial,0.6401083876614878,15,21,285,1122,837,30.319254277406802,6289
4a735394-d19c-4a4d-aaca-142d1cf0d9ce,Residental,0.8549086508715885,41,47,602,1392,790,38.95863680197431,9918
29a4e2c7-839c-40bb-8958-67fb1ebba90a,Healthcare,0.6862817494601131,8,46,392,935,543,44.71440528340993,1867
11294ac2-d84f-4f7b-b824-cc573829bcd8,Residental,0.1099385457854326,20,1,572,732,160,35.15765352514862,9068
fc9bc024-0370-4b0f-8368-2f92ff520f99,Educational,0.16665086175650068,32,31,41,717,676,72.44730743102284,8252
e2e45ccb-e8a8-457a-a8d9-c265b04b0ea6,Educational,0.06879779725131452,4,1,10,49,39,23.72942898028433,9820
40c588af-a168-4d6b-9aac-66d6ad1baa6d,Educational,0.3926570861539327,48,16,596,1390,794,95.13634830319295,7351
f5e72ba6-f59c-4743-84c7-919abf7f17bd,Commercial,0.19249343423080545,36,2,193,998,805,36.20337358011011,8002
cb65c780-f1f8-4da9-b400-767250b1468f,Commercial,0.42174705905079735,29,39,559,728,169,11.120929742625492,1361
0c1ae6c5-381d-4694-a07f-bd26731dcae5,Commercial,0.8860185159014929,5,20,638,737,99,71.82211709286426,6733
a2fb876e-2151-43c6-b6a2-999a03362d0b,Residental,0.846188363848992,38,2,320,538,218,87.70272140717194,5100
117a8919-045e-49bc-aa9e-5d6847a2f698,Commercial,0.6921696595492814,9,23,80,433,353,30.842794299636232,4025
c778938a-3879-477b-a7d5-d6a96ce943f9,Commercial,0.48282204958045594,48,7,441,1228,787,87.67363606559125,1134
a310de96-f56a-4596-9c1e-ca29dc960dc7,Residental,0.6268062686242559,15,46,50,643,593,44.062912079053845,4216
6ff80aef-91c3-4a52-b1c4-b1c086cf23e0,Commercial,0.7249570935079722,7,7,501,1055,554,49.83512814735083,7544
b42b28d7-0504-4816-bf17-b17e5a31abc2,Commercial,0.06458039954842543,50,1,272,1160,888,11.972348322188152,1858
1c4a99ff-7b04-4318-9e14-2037d8410fbc,Commercial,0.079103842321949,10,16,131,1371,1240,42.00999195133041,1053
031d40a1-0788-4130-8e87-92ed470f3a92,Educational,0.1272393512842005,36,35,603,995,392,80.28923676875648,5233
b18e7e72-019f-4aaf-b0b9-aca347110971,Healthcare,0.21402808541056084,17,26,717,1298,581,80.50630888947339,1287
c72d310e-0859-4478-94ac-7506773d5b2a,Educational,0.03691193702547957,1,28,467,753,286,62.213605998759064,9679
7d394d04-c361-43d7-9a27-0394e5741a53,Residental,0.27513124360860064,8,18,259,660,401,31.988719748112814,8697
88e2ff79-146a-4d69-8e7e-9c8038bde64a,Educational,0.9916452228283142,33,7,718,1175,457,32.95527063243715,3108
5fab0fcb-fbfd-48ad-a83e-9b288f85e91a,Healthcare,0.7361923768194608,28,43,58,176,118,59.66199976162852,2119
3a69d22a-bd98-4afa-b311-5d050be1256e,Commercial,0.2966333300137004,29,46,598,908,310,42.466890029318535,3478
925baaa1-99b9-4f58-aa65-11f1e843ef7d,Healthcare,0.8443206152933166,39,38,35,341,306,54.81235046861737,3283
7691570d-afef-441b-9644-faf541680837,Healthcare,0.782352720308259,32,24,686,1146,460,62.529171018533596,4407
3c81f844-2894-4538-8440-52581e6a953c,Educational,0.6202845706418699,5,5,392,1091,699,40.97810890383195,6197
9d9510ec-7b63-4503-b826-2a45ae5d27db,Commercial,0.6788647285264034,26,47,357,760,403,40.72919534288903,7454
f66cbd50-1b6e-4a19-a606-816bf7a21533,Educational,0.2294835618473695,24,8,5,83,78,70.419502013612,2241
e8d809dc-0acd-4229-a273-baa2e95f04bd,Commercial,0.7092765589916901,21,28,596,722,126,61.12471550143012,7674
3eeb00d4-d42c-4831-ad14-3ff153a26188,Healthcare,0.6958158251810533,5,49,222,335,113,30.962450229503474,4993
4626bb38-8e32-4b48-b490-b58d8a97e61e,Educational,0.8288459063712695,16,21,116,594,478,23.039299978144314,7130
a51a8f45-5f67-4ba9-a092-6763abbf14ac,Residental,0.30290813914199033,49,36,719,987,268,57.78143173522309,1124
55b17273-3786-4fed-ad84-a0175a13dbfb,Commercial,0.5283460623078047,17,4,40,1146,1106,29.845430014856436,6440
cd0e9cf6-6ee7-4ab1-b2f6-e2a7ae643d35,Educational,0.1109291396009423,22,27,429,1194,765,52.16661519230049,7498
36ccefd8-8129-4a34-b901-50f9ebc167a2,Healthcare,0.7119825593740069,50,29,323,561,238,71.5970613482945,7562
f1d98c22-ec5b-4f99-9815-c5300d4fb2a7,Residental,0.5668216607237418,46,22,682,885,203,46.10561782860874,1992
a63215b2-8857-46e0-8df4-67732f89663f,Educational,0.04302132166886807,30,41,510,1136,626,29.97830987273154,8003
1fa58659-ebda-4ac2-a749-8b9ccfd919d6,Residental,0.8565935791551628,42,46,347,537,190,31.694461542175244,9585
218be8ac-fa4f-4d1a-8550-ebfb4b355961,Healthcare,0.4883460449969884,12,39,533,934,401,22.461669686849984,1875
0974cdf9-ebe4-4df4-a641-6ff415a91035,Healthcare,0.022389478530617346,49,23,573,1092,519,21.807133419941636,9261
9cf6b76a-cbe1-47ba-945c-08f16c76715e,Commercial,0.7661740875254346,31,27,89,1191,1102,43.537719419783,4652
efc7f80d-910a-46da-a253-88e93197d8b8,Commercial,0.6137831261977125,14,35,308,523,215,54.79567497089896,9797
39a71ab9-9b3d-487f-a4a3-4eca9ba62845,Healthcare,0.7978359489671375,9,2,628,1416,788,49.405247624930624,8097
6c0e5aa3-4017-4649-8de5-3bbdea8b6538,Residental,0.7315706177467227,40,25,335,687,352,67.96750549122427,5219
a03b08de-ae7e-4c52-878c-c3e9cfd52465,Healthcare,0.37551321326467235,35,3,148,938,790,66.08716484950236,8812
a77b83a6-35a1-4219-a2e9-edcfb5ae9fd9,Healthcare,0.1671758175457908,26,15,563,1206,643,40.40260732507055,5723
a9bcfaf0-dece-4602-b8ed-f3d07c32a74a,Educational,0.17139727744980282,34,6,467,1427,960,11.181521973335798,7797
1aa7ca70-2c17-4209-896e-f4634483bc2d,Commercial,0.07208704052225812,12,30,439,815,376,69.41315646720226,3967
5cd9152b-6d72-419b-8fcd-ef432cc24d75,Commercial,0.6373063313773699,19,23,565,677,112,82.39170059558282,4952
46b3fe6d-f649-48ed-98e3-0c62c38c7682,Commercial,0.12830976857401089,33,44,219,544,325,36.54228095421281,3666
d6eb3682-173c-4ae8-bf04-9a28dc338e08,Educational,0.7312243996885454,6,38,432,1101,669,47.531223107885985,2414
5f952fb3-69f3-41b2-bdf4-5a646be7eaa5,Educational,0.9328990362661953,31,47,349,1179,830,33.385437923861375,1991
bb83a0b1-8a8f-43cf-8511-1b08904b96cf,Commercial,0.47623939806936366,20,40,585,1007,422,15.444854726603946,7442
ab42d6ad-9156-44ae-8f08-ff656010eaad,Residental,0.9074071417932792,17,25,230,1092,862,84.0473754702514,4243
426b25f1-90d6-4e36-9bb7-68cf911bb7d3,Healthcare,0.846079264242617,22,37,55,765,710,68.71931845754636,7047
39f1bad9-4de5-4a97-b621-01c44af537a9,Residental,0.08707709804560237,1,38,105,998,893,68.91162219481404,3189
27531b1f-7cfb-4523-b35d-e5fc07f13259,Healthcare,0.3632990740018107,14,31,61,779,718,43.47965035694045,8596
d141e349-f112-4498-84c0-9589fe7bda59,Healthcare,0.10183535200414218,2,1,564,898,334,53.58680714173835,6198
0ffafac2-4c05-49c0-aa8e-89fade5b4ac6,Residental,0.4585385178825331,49,48,5,213,208,54.58918679105785,5114
e3a19739-88e8-4eb8-959a-11394ad63535,Educational,0.32729293573994,4,13,145,481,336,20.510853460210164,1612
7de78074-c837-46cd-a556-48c1f6079195,Commercial,0.024961315171437848,47,12,458,834,376,11.23721637797183,9085
0f1a22a2-9aab-40cf-8bf0-b09ed965304c,Residental,0.15853652504667715,38,4,687,1116,429,22.39276407865816,5388
2140ce24-53b5-4509-982f-e72b1c6d2675,Healthcare,0.571645828151135,28,4,486,1433,947,99.70657539422328,2581
bdd8f604-6d66-4d1a-a16e-c3b3be91c71e,Residental,0.38676365179752725,8,5,496,825,329,61.787643337910566,7116
9c88a0a2-feaf-489f-a13a-c82f531ff939,Educational,0.2548350955509895,44,45,148,824,676,60.8520398600343,2668
e398bbaf-61da-40a7-8dc3-3e095fd871f2,Educational,0.6924714554720939,11,2,627,1332,705,82.56468428040714,5473
99b161ff-7392-4584-9797-d66bf27873c1,Residental,0.7648350135268601,17,18,558,1317,759,38.58082644805114,4697
0885b2ca-ae1a-4145-b095-15826f8084ea,Commercial,0.6471487300010944,29,11,105,310,205,30.728603486345957,9440
aa4b0e6c-37b5-407b-aad2-61b44880d875,Healthcare,0.443827616096392,49,17,572,1019,447,36.070389131554315,7471
e6d7cb87-5501-4921-8315-4780627b7e97,Healthcare,0.7350682118811851,5,37,414,606,192,40.531952585121346,8321
50ad7f39-639a-482a-8c6d-40da9501a392,Commercial,0.6769368199359855,30,8,640,1135,495,57.026205563362566,8772
e5caea1b-f76e-40d8-8dec-b3a893d68731,Educational,0.7345259154455729,44,32,509,589,80,22.737553384300522,9898
62b9b90e-8a0c-463c-ad32-4c23fa011d71,Educational,0.6827672096537277,1,28,703,1326,623,64.42312911047668,4303
15886e0b-495b-4da7-9e9d-1d5e9b542b7c,Residental,0.22009401935387618,22,18,537,709,172,71.83161795540116,5320
b85f69b8-5f84-4b70-ac66-3f231680cb7e,Residental,0.36729140682002137,31,41,215,1063,848,23.620336268734818,4404
27473ec7-a8a4-4716-be33-6ec54727a7df,Residental,0.7170066411674557,40,43,513,1234,721,66.11188644216296,5140
b380fc79-74ea-473d-bfa7-a6f12f737364,Commercial,0.951632537715132,36,15,111,974,863,57.34304855513132,7528
3ae3a103-b910-4a6e-9630-f606bc2c6581,Commercial,0.5924210772137055,20,45,539,1440,901,79.64533179631304,7858
1ae17f8d-95d7-4568-b11f-6dd95f850912,Commercial,0.9466649170144146,41,5,603,643,40,77.10922599830947,6853
e720506d-9921-4fea-9e26-a327edeace4d,Educational,0.40686822869088113,42,43,153,845,692,50.37456876846487,2805
ae56cbcc-e2c4-4a21-90a3-52e805ae5d31,Commercial,0.9971579447469257,31,22,17,272,255,12.699407703993401,6290
9a08b02c-d5a5-4708-897c-a1c0d6b361cb,Residental,0.8935256319079556,19,28,364,1079,715,66.38669501809652,6526
bcdb982b-2145-4bf2-9dd0-b1253ce97485,Educational,0.36727938269475857,17,49,650,730,80,29.78025386290864,7479
93e1d76c-22b6-45ca-8d4d-3458216acc77,Healthcare,0.15015237758459454,41,1,103,985,882,33.85358713593945,5138
7346a07d-c52b-4f56-ac35-e8e4c5046e7e,Residental,0.3495950495788259,3,41,24,1248,1224,95.5489558179757,6042
102bb7af-6db0-4096-aa1c-c3df4ca78456,Healthcare,0.09500474365414835,9,41,596,1164,568,21.642810110724213,9736
e1b10765-5bfa-43a5-9b40-19d8f03ee6ab,Educational,0.11653057300276937,35,32,286,1160,874,39.96324289672713,6636
843ff0f6-8016-4624-8817-bacde7c45d50,Commercial,0.9859362795326048,29,1,281,486,205,98.19598793489249,3105
2a59a31c-1d04-402d-b1f0-ee729ca7504b,Residental,0.5245891482649662,14,9,29,969,940,72.69204181122467,2245
8ec35d2c-42e1-4558-ab43-02930fbce0dd,Commercial,0.8648416766464582,10,35,146,807,661,96.66547448849083,7435
9444bf9b-9cb1-4bb5-a611-dab8143c2e2b,Residental,0.19949205018287697,42,31,665,975,310,37.37288004027196,6515
3137d4cb-e038-4f65-a203-2d91b9ed5a49,Commercial,0.6698751873841078,13,10,443,983,540,11.628628013950797,4657
90a4189b-5605-43ed-b06c-b56182c2534c,Residental,0.8358481552519277,10,40,378,1264,886,38.254702384506764,4853
b5d5ddb0-d86c-45e0-b130-0d2a88538b43,Educational,0.8633100750339452,6,24,566,629,63,14.212627400817404,1656
6892cd21-e937-4b77-80e7-4b55ccfc777e,Commercial,0.3395659357960674,15,20,412,1352,940,11.415596756906808,2913
f0f55b24-3db8-414d-ad8c-53d029cbde35,Residental,0.3002768414038517,32,27,546,754,208,61.52378810271959,2632
11eed911-b476-421f-b269-e92596ee408f,Educational,0.16402283058773703,35,24,599,1069,470,83.6238437232257,5281
aedc020a-3aaa-4ac7-a721-45bb13ce1d56,Educational,0.7635895475188264,30,4,398,643,245,17.555444838896552,2737
5a06b3d1-6376-4260-a8f9-f229655c00a3,Healthcare,0.6984862890207393,21,5,196,862,666,40.384768680097245,5568
2c913d29-9c40-401d-ae2e-580b035225d0,Commercial,0.4965511680104525,40,5,343,952,609,25.740081748587368,3712
ac6ec797-0eab-4598-81a2-d23e42a2f4fd,Healthcare,0.4263937817415223,33,14,182,866,684,99.07279250633218,6196
76a2d6f2-6a4b-4a2c-ad0e-7e82a3622cf2,Commercial,0.13566989206849656,7,14,67,1264,1197,20.6161402180665,6005
588bee46-48f7-4817-ad4a-fef036dd9758,Commercial,0.02347902369931465,16,6,649,785,136,69.50553770998943,9150
fb461caf-a09b-41ef-a362-47c5ba1726f5,Educational,0.9888700710264323,3,49,371,603,232,47.89841614890821,9444
724e6d47-a1aa-43c5-8539-afeee397056d,Healthcare,0.8801364837806108,23,24,94,1326,1232,94.33174273738325,1516
7794021d-8b40-4780-801f-b003de7f3705,Educational,0.8717059453676226,23,48,235,398,163,51.80656592276602,7712
b5ec38b7-8a8f-46a9-a7d6-5402804e8064,Commercial,0.2608418394695806,14,43,622,1216,594,17.534018881317035,3093
f1d031dc-2826-4a29-bcb0-9ab7879465d4,Commercial,0.42909827024565894,1,12,109,1266,1157,32.22726717452855,3965
a54bf91b-5c0c-4ea1-865f-69b1ccb448ce,Commercial,0.2584235137168863,33,26,621,1339,718,54.78340302932298,5546
b6cd2720-f1da-4536-be33-34255535847f,Educational,0.4614671212851338,10,15,217,406,189,22.261202594489003,5688
9bc04884-563b-4d66-9283-298207843be9,Educational,0.6719761974166942,35,43,592,1227,635,72.94356687125548,4756
136e5648-1b25-4211-a256-f52016e748db,Residental,0.14494388215750154,18,28,391,1422,1031,50.82348154845125,4063
1aa285c4-2eb4-45a8-a238-ffe590092a89,Educational,0.5024045195399498,32,32,665,979,314,72.44452938885333,8317
5ee93c2d-36b0-44bc-8823-18907a8b8cd7,Healthcare,0.09088837261212646,23,42,175,1397,1222,61.90538554318844,7606
131fc9fa-d168-4b14-bb26-bc836cac1ba5,Educational,0.3888723978614541,39,29,692,1172,480,93.0671538753474,5723
9044276e-a5a9-4215-afed-36ce627a6602,Healthcare,0.581974655051308,21,37,482,989,507,91.37651305507023,9410
f24bc9a2-9a88-4781-8f9b-5728cbe93d10,Healthcare,0.9271839752777478,24,24,337,992,655,72.1781434103994,6203
2752c40f-483b-49b6-b36d-3786e9f38ca5,Educational,0.295854174058356,50,26,554,1089,535,82.96748081097869,3976
6c8211c0-c6f6-437f-be1a-5ef17307be24,Commercial,0.9404191805496681,3,46,497,1084,587,14.466304453172974,8630
968323f4-2265-4398-b640-38e0fcbbb9a4,Educational,0.7090278457037206,10,40,693,881,188,19.91743381484285,9495
a560c11b-60bd-4cb8-92f1-555ce25d97bf,Educational,0.1746481410758668,5,17,512,1144,632,80.80182687483011,5733
05a493d5-47f6-4ac2-8d5c-bdcbbc7a0bd6,Educational,0.2501527590290874,13,7,541,1266,725,75.67972103066597,3050
4c2fe6bf-d149-4838-a475-65c0d098558c,Residental,0.6860813311363315,4,24,623,645,22,61.01184731052514,5828
5b736d0c-7fc4-46ad-bea5-28136c34103b,Residental,0.582676303703961,8,36,698,1166,468,16.99762710144019,7476
7f059b50-266b-4814-ac49-37a0b0b8c36b,Educational,0.11568994486666528,14,35,703,1411,708,21.998555439879233,3650
0e8da3eb-924e-49fd-89f1-3b786c632149,Educational,0.5979221217297535,5,7,694,825,131,75.00755877158225,9614
5b95df2b-195b-419e-80dd-18a3368ee93d,Healthcare,0.519979860459,27,40,709,1376,667,64.23969819007696,6077
55d5f740-4b66-4a61-bc31-f902e10f7ac6,Residental,0.8275904026734002,10,44,159,1044,885,31.77024725569936,4770
3c689c81-63af-4beb-b72d-2e93010e45e5,Commercial,0.7003429912658249,39,40,195,417,222,28.533776275577388,4479
fe1a7c1b-ae9e-4f18-9fec-f79f62730fda,Healthcare,0.2101046044784669,22,34,89,1417,1328,94.59953044166119,1334
0969e78d-0371-446e-b918-c3bdb9efc867,Educational,0.40207006960356384,42,45,524,766,242,19.691250076088984,7610
5f2a69c6-b8b2-4b4a-a519-05354ee65b84,Educational,0.8402642760121253,13,49,628,685,57,87.09500304539047,3355
62f0e039-1954-4388-97fe-c82a13e8ccda,Healthcare,0.2577012196320705,36,37,600,1260,660,18.718907436595305,8588
d0991be7-c067-4280-aecb-99f337d7ae0c,Residental,0.1300997351822738,12,6,241,821,580,73.29010330555275,4991
aa85f913-3802-440d-8a7d-455dfe86c3ec,Healthcare,0.6708214051878759,39,16,559,1325,766,95.29270164515442,5931
68e2ae11-ebfd-4d00-a959-cb2dec7a2a86,Residental,0.18984545652530282,9,24,117,1291,1174,58.61220871962993,6744
c37e7162-3209-4644-9cb0-9e209be8c016,Commercial,0.7939406843497243,46,22,536,716,180,55.90698028220701,2023
5e0c30f9-428e-41f8-ac76-75473be4d4a5,Educational,0.44927792138857137,12,43,529,800,271,18.068036200428562,2236
1301d079-dae8-424c-9d18-19713cd17361,Educational,0.8752653954897333,34,4,602,1341,739,28.40726589864062,3356
7b6511a7-7e2d-4e55-a1ca-6df282543b59,Educational,0.9157966365806482,26,17,623,1261,638,63.92871826233508,7308
d9fd3965-6b73-499a-a31c-ec4e10755ec5,Educational,0.3971489573992498,15,25,345,1252,907,25.01489813285289,9253
8886b2c4-4976-410e-b3c6-3cf71f5d9abd,Residental,0.40090972566398153,50,34,622,753,131,66.53758794492364,6141
3af7b7fa-aadf-4ced-91ce-82aabda6d491,Educational,0.21880734462822315,39,13,6,511,505,39.705305586372845,2245
8df17036-2a66-4574-b730-cca030711dd8,Healthcare,0.620463754492939,50,38,410,1131,721,43.96689075141433,7218
2f5d29f1-0939-4a65-8edf-452053afab69,Educational,0.5955998223718866,35,38,710,1197,487,84.8444804293572,9432
ce648cd3-5ef2-43ba-a786-d84dc65fd119,Residental,0.6815736171827645,1,42,132,1207,1075,33.773921384396125,5792
f8301070-4f3e-41a1-a4e2-e5374474a7cf,Residental,0.6321878985051609,13,6,220,740,520,65.04891889697885,4688
f86f45f8-60fd-49d6-bac4-dc9dd8b089f6,Educational,0.5450074318710982,43,5,137,1209,1072,97.74482294370716,6312
13912c9c-8a15-48af-9a99-47258a063ea4,Commercial,0.6682055310772531,28,15,161,638,477,27.177988996000504,9773
3f4b1ef2-8022-4bce-926e-b7a90a26464e,Healthcare,0.418700593087046,19,47,679,861,182,63.27603288093362,6141
1fb63719-1424-4a63-aeb6-0aed55e1edc9,Educational,0.8131571369833331,33,44,704,906,202,90.17168990001278,9236
f546151b-9c41-4783-8472-0a153307be2a,Commercial,0.5834153186488445,8,36,450,623,173,90.12763706670376,3464
b5f3be6f-1c40-41cf-a475-1ab8114e88bb,Healthcare,0.5324167197170037,18,3,508,674,166,94.12685107252048,3782
8804c8e7-b6b0-4ce4-a1cf-8ea8428c5d37,Healthcare,0.015101115933377596,35,18,526,694,168,50.350330018086844,2629
aedd7a67-844d-4ee1-9975-c96c7fe77b00,Commercial,0.22634486797618936,42,40,677,1022,345,11.973310288623022,9566
23ca126c-b6b6-4f55-a6e6-0a49fde8070b,Healthcare,0.523234311262938,3,40,318,600,282,50.20476430826033,2158
2823065d-6984-4109-91ea-421eca9418cf,Healthcare,0.7970969197912428,13,20,716,865,149,49.11653512524348,4048
efc5ff84-b28c-4b3a-ad6c-dd0413ea26e4,Healthcare,0.5666840794023765,41,39,691,740,49,50.78737631146205,5462
548c15e9-efc4-46da-a69e-b868cfca3479,Residental,0.9557556919107738,9,41,419,1141,722,36.30924637046802,1773
b022eb0e-c65f-4c2c-96e7-869eda722b35,Educational,0.2959540294941416,15,20,8,160,152,98.55817472820827,7172
b7226615-a2ca-41e8-a884-a20f9cfc7b2d,Residental,0.27210754696486694,23,6,605,1439,834,30.285833582346207,4700
2bbf4153-9f22-43c8-82c9-a436f924dfe2,Residental,0.7568519287548662,3,37,69,521,452,86.20203084779482,7106
fe4bcf60-d125-4b3f-ae2c-4f6c7105c306,Residental,0.14287432590072846,49,6,615,1143,528,82.81579708393703,9680
3d7e13a2-5956-4a57-b855-6e2e933a8fc6,Healthcare,0.8245001965413332,24,47,193,286,93,12.978063712874032,3466
b00cbeb3-9653-463c-bc3c-1f27a85c75ec,Healthcare,0.11081884604946013,10,24,236,515,279,34.49815296521457,4476
91434702-69d9-4a8a-8e50-b59d89b80d1f,Commercial,0.44662119222619256,19,21,197,1089,892,67.84519106136814,8682
87a9392c-8feb-441f-bb8c-e16bae69e9ad,Residental,0.560039412252001,18,23,337,351,14,96.1989270648145,2918
5d91068f-711f-479d-921f-eadcd950d527,Educational,0.14607094364708517,38,43,321,1208,887,22.531263339872368,2432
6e401375-eb49-4d6e-9745-f6962ffda763,Commercial,0.10328469372822213,9,8,36,101,65,54.48237012181449,9925
59d1493b-6832-4062-834c-9d8fe77639a0,Commercial,0.35483868241297656,4,46,43,1414,1371,64.21365928864904,4908
4dc0c3d2-451d-4ebc-8426-e96b188204a3,Commercial,0.3501693208802489,12,17,230,531,301,92.99711526226784,1116
727fe1cb-a37b-46cd-abbd-e1ef1590556d,Educational,0.5442298569026075,2,14,146,1013,867,45.30211813229384,7375
0e7edebc-a748-426b-8dcc-fc975a4f8531,Commercial,0.3181060214190248,30,47,659,1422,763,47.889353174721066,7550
38bfeb55-c6f9-4953-a665-5e69e338be2b,Residental,0.7659484032270545,10,16,203,422,219,76.28089282659394,1259
6d23cffd-3f89-4a25-8b33-a8d202fc144e,Educational,0.168935776907443,5,36,514,560,46,23.305959356224264,7786
c9103da9-9d05-404e-8e70-c51ed3e73b5d,Residental,0.8689453292280316,46,26,1,1266,1265,86.94603252969554,8382
8031e7d6-fbae-4edf-b13a-c7d35d798b55,Healthcare,0.7918768921666975,25,42,58,704,646,37.104536232741665,2580
f64c9be5-bcb7-43e0-ba0c-e9d40ff4188c,Healthcare,0.8573332023756525,33,35,344,1116,772,98.54171781084658,6143
1064d4f3-cc05-4e80-a4e7-233ec71a424c,Commercial,0.8382199619189573,22,10,152,935,783,59.14374909180612,9824
97717f34-409b-41cd-9356-e4f82b384786,Educational,0.26572123072070186,8,20,372,1225,853,38.985123557820856,5683
e5330543-043c-4d71-a811-d13401414c56,Healthcare,0.42005713836076053,34,38,144,1199,1055,78.10525243023399,5917
10db2ac9-3c19-4c9d-b72c-a232e2644c82,Healthcare,0.12501886100254955,8,46,615,1416,801,33.78051484999383,8290
c63e41a3-605e-4304-ba11-a08b4711b40c,Commercial,0.9521630838121161,28,24,389,705,316,69.03051046654343,8927
d1b77b65-39fb-4b73-95b5-403b9186d216,Educational,0.8868943132993163,17,39,639,920,281,92.71387867536365,5377
4b78bbf4-8375-4fcf-a917-ba8c92dcc531,Commercial,0.2820754535828791,23,9,663,877,214,13.847285658898539,8680
5b0d9a5a-29a4-4f3d-94ae-9e27cfd1deb5,Residental,0.2871421263244903,22,46,678,1419,741,20.31031858811103,3955
5f24f8b0-8431-454c-bcda-a6bac596c538,Educational,0.8966902396700748,11,27,577,1323,746,95.86637824175355,1260
2022425f-c63d-4191-be2c-7eee58b2bad1,Commercial,0.7897175674855009,9,19,327,990,663,56.046699510048576,7408
741a3513-1ee2-46bd-9c25-810b90efbd5e,Educational,0.3012730359484095,25,2,346,429,83,79.84843429645036,9333
8be7495c-f37b-49a9-a08f-857b22329f74,Commercial,0.6522941692750305,15,37,605,1114,509,25.847489882187773,7740
d1ed0970-2aa6-4899-b912-5ed5a43afc3a,Healthcare,0.10377126960295613,21,47,603,1389,786,69.45501583251485,7944
f8d74b48-9f25-47d9-8be8-6c7fe927899c,Commercial,0.6926363508798552,28,39,288,638,350,87.97958127801213,9714
11d63257-84ff-4595-9661-94680d7404d0,Healthcare,0.20547165685846835,10,39,309,373,64,16.057026586232467,4276
5ffa082b-ff51-42b4-bcb9-41afd2c91877,Educational,0.4987017816134921,8,39,224,1046,822,48.30352185964279,1597
45e16f8a-edaa-4e46-9223-ab7e98ef5769,Healthcare,0.5296164760090049,35,32,118,796,678,33.446536104984474,1356
d4504847-d87c-4b5a-a33b-76d203518e67,Commercial,0.7579448063372112,24,34,59,211,152,10.943447579504872,5977
90721833-461e-46dc-ab04-f3accc3ce576,Healthcare,0.4372854845167362,28,5,214,1175,961,99.08050540445319,3406
538e6451-bafb-4bec-98a5-f871fc71a243,Healthcare,0.5539907437430015,6,11,183,332,149,64.40312470187098,6085
185cb58d-6ca9-4cf1-bc0c-2cab841f7cf7,Residental,0.9537575826980156,47,29,54,294,240,85.67299608310798,4136
384f48ee-cab3-4977-8d44-fb9e85f80953,Commercial,0.5981493113553835,36,34,614,665,51,23.575859032066234,9396
dcdc6eaf-7558-439c-909e-f7e6fba55baf,Residental,0.7786069758794794,38,17,55,552,497,60.065277466471166,9359
de803392-402d-4216-9320-b5b928e11bba,Commercial,0.2427140197889327,23,21,440,1344,904,34.12523040828479,1277
a0995f99-c865-44f5-b3f4-8fa30e0dbaf7,Commercial,0.0360463533407005,48,36,100,485,385,97.57740660609421,8398
8a1f6ebd-a61e-4dcf-8900-974be7accbdc,Residental,0.4684174522958159,20,12,201,1010,809,89.31196593405063,5675
835f86e5-0366-475d-a35b-18b7bfc7f07e,Residental,0.33680428698536,43,49,280,1034,754,85.76173246134363,9911
f96207c3-5a90-443a-adf6-7cef5d323209,Residental,0.9751755581627365,34,23,112,314,202,85.47570079363551,6619
8033db0e-3a89-4955-bd91-ecc13edc7bf7,Residental,0.17091660504704054,37,9,82,905,823,43.46655050830446,1620
7754c862-1b81-47c5-86d7-568f750861c0,Healthcare,0.7633363016155678,26,2,522,721,199,50.64691402655785,6070
71ccc55f-9232-46c7-91bd-0712ca874be0,Commercial,0.31934833400338736,29,37,240,330,90,32.030289896883176,7082
3668f779-04d0-4fff-947d-fb231d49aa1a,Residental,0.8179325609519781,8,3,455,1438,983,80.17535272232149,7937
911b4481-f26b-4029-82d8-ce0a95674705,Healthcare,0.2311002726792023,4,15,334,571,237,11.061799033485933,6117
140bf66e-2847-4be9-899f-1cbdcec07560,Commercial,0.7239882408390188,11,5,121,1087,966,14.581377360738433,7796
21d895db-343c-48d2-8011-81e0620414cd,Residental,0.5031479473108181,3,43,680,1027,347,78.8954019794153,7879
75c3014d-3f80-433e-947c-695a771a768f,Healthcare,0.7833750380494745,6,6,328,1224,896,49.0856153978931,5569
c090d3d5-7b03-4974-ae10-c4b5ad720489,Educational,0.1196725940900466,29,12,533,1041,508,43.03904963492828,2159
abbdd335-6055-4130-aca1-f88c3abb0131,Residental,0.23872522525430917,49,11,414,1181,767,49.78045560935986,6401
47be468b-78d5-41b0-b17f-ead82e221e64,Commercial,0.4762277158264795,44,17,561,1018,457,89.13032377192451,8154
bcca901b-b1a9-4a54-b673-a3a39518d886,Educational,0.15419931218785865,25,9,210,1164,954,54.676718011833174,8362
aa7c88c1-c4e9-43de-b387-d3fa1303ab3b,Educational,0.28433399310707774,18,12,223,1270,1047,54.62695588660211,2518
eeda5283-2acd-408d-bf81-597bbeb4e499,Commercial,0.4433003626470876,28,45,652,724,72,76.07791621585363,8264
19c38c19-b63d-440b-9df8-079a35e4e9b0,Healthcare,0.2449408954420711,45,36,542,1212,670,31.36243568238336,6455
86253743-1c18-4d81-b8ce-71b6672b3d9b,Commercial,0.24375465651291084,8,7,616,1359,743,33.16466309838511,6344
686b4266-5072-49b7-843e-5fae15ad9eac,Healthcare,0.5668680970318116,37,24,180,877,697,89.5746584838406,3456
ad3048e9-39cb-4a73-9eed-f1536961647a,Healthcare,0.9917385905730111,41,38,325,430,105,55.599465531231864,9510
b09e6359-36b3-4488-89b6-ba76358c5db5,Residental,0.7122594137209645,48,11,240,656,416,15.43647782305991,1881
66c198fc-de78-4589-9ac5-856963e88b76,Educational,0.23846104528868806,15,7,718,1212,494,95.15011281126353,5803
799d93fa-b1b2-4feb-90b4-3e06a9b8ea13,Residental,0.8165850386957616,16,31,631,893,262,52.16569233692342,6673
16f007df-45ce-4cc9-a07b-c71ea3b6485f,Residental,0.48098536020365945,12,5,668,822,154,68.97042732686074,5625
3144003a-0cfa-4a93-adf3-b1e2b6bb9cea,Healthcare,0.28925014426347573,24,29,431,1356,925,32.10206158107598,3400
4a195676-c1f5-4beb-a484-ac722fa0f73f,Commercial,0.7515572360499602,27,27,513,964,451,73.30092925528413,1279
8dbc040b-8e8a-4602-847a-a2750ba33863,Healthcare,0.28949744250289255,10,15,106,1336,1230,45.8589000709768,1169
9b9f737b-394d-41fb-9b93-389dc6f529df,Residental,0.8387141686756159,40,20,472,1259,787,40.418788901760806,8740
8b724bfb-49f7-43c7-8432-0bbf916982c8,Educational,0.2524288337513797,8,5,96,840,744,49.229969072755765,4682
fdfabf3b-c936-4768-8b38-5335025783c8,Commercial,0.4647592590875397,18,18,119,1150,1031,81.87083553079131,3883
675a5523-25fe-40f2-aec7-65d6c99f0ab7,Healthcare,0.8868446619969147,27,30,296,1013,717,95.83467157586601,9472
37b5308a-6906-4a09-abb0-c16fd629ef36,Educational,0.5256875568721757,34,49,259,629,370,80.01968546416634,4765
2f962786-9a20-4b45-b654-7f373aad67ff,Residental,0.46686788925917355,13,12,224,1297,1073,22.092109965074698,2219
0fc5f153-fe12-48e1-8610-a92d1bfd3957,Educational,0.33618490575828985,31,26,243,277,34,21.727647163289575,9371
da5757da-c4c6-4f46-9f39-7dad42c16e11,Commercial,0.6778358843975133,6,8,403,572,169,13.6356349323876,5604
21392c31-2367-4f26-9d05-8b08b964f734,Educational,0.6354792591377473,21,28,527,581,54,47.659619988542936,4824
ee5c28ec-d7c6-49ff-8f32-c53400ffc4c4,Educational,0.04040776148160763,21,8,326,368,42,80.70049272853561,8796
c88f44a4-548c-4c0c-99e0-5b9276a026ad,Educational,0.13611928442651267,5,38,703,966,263,67.77792576958277,6836
7c504d15-f1f1-4713-8266-15077bcbb456,Healthcare,0.947301725452928,30,38,70,884,814,90.80579975287363,7493
7ac42369-d51f-425e-9138-a211bedd6672,Residental,0.5001499686155656,15,16,95,991,896,39.87101236026275,6099
82a566c6-186e-4b5a-83cd-16a427527d9e,Residental,0.8101587975997999,41,27,674,912,238,28.32830470627341,1731
59556bd7-4869-4fff-bc25-d857aa4a07a1,Residental,0.05707346736731589,43,42,322,351,29,75.63086098098749,7895
f80024bc-a1d3-4edc-a044-39b4254b396c,Residental,0.7300088805614551,1,17,488,1314,826,10.734981579151302,3800
104c30fe-3d83-43a8-afcb-3703a871074a,Commercial,0.8814603888402885,26,40,444,782,338,12.675749976643237,4949
4c03dd99-3116-4b12-bac6-33271bc0ead4,Residental,0.6050942843497533,43,14,240,756,516,76.48927699803758,6394
34bedbba-b95a-47eb-8fb0-313ecd09f7e5,Educational,0.5985269893229844,38,45,460,905,445,42.424470518757474,4767
c2a97416-b95d-4350-bc78-60b237490638,Educational,0.7982438411385212,37,49,12,560,548,93.62509316298795,2119
726b5ed9-4812-424c-8e2f-4fe43c16e4a4,Healthcare,0.6977981199748903,4,22,99,349,250,85.3837604825435,7538
3679cc05-ee46-4cfa-a2cb-8d85cb749e4e,Commercial,0.7378237043095126,26,27,665,916,251,88.73215015420222,9039
89ee70a0-66d2-4c1c-8f52-a8de581bdfde,Educational,0.8212465357853337,4,6,178,1112,934,24.594699692270567,1342
d47010c0-5b92-4745-8e90-936f8d2696bc,Residental,0.6427743148220104,22,18,277,726,449,15.750830442077843,5090
d321b933-a8a5-4e86-a4f6-1cde8fb089a5,Educational,0.8857135324827177,37,45,296,1130,834,59.066799621432196,8623
61d25f43-7896-4bf0-acd4-a27ebdb54e8d,Educational,0.1318770704104213,42,13,155,187,32,19.113299505331995,7004
af7351b2-220b-4f69-83f4-c310dae86bb5,Healthcare,0.048343799631920925,38,9,337,1338,1001,73.07756559672711,1864
c16e9561-fc82-4bdb-837e-6199d5ec96aa,Residental,0.3453401098503809,39,44,288,1283,995,94.16959042226796,9215
818f777a-015e-47af-b62c-c22297ed1236,Residental,0.11228481501044218,1,31,608,977,369,17.554580707769368,2460
6efe85dd-82ef-4d3c-8cb4-533b5cd3a155,Educational,0.779679335495894,1,23,400,551,151,18.750222778313926,5841
bfd5e216-8418-492d-aba6-c568712944ed,Residental,0.3929867058662144,5,30,476,793,317,96.13400832063925,1676
168213fe-2d2b-4382-bb63-09f7a4da95fe,Residental,0.30565574691294917,5,8,155,987,832,65.59769413003099,5352
7c8c68d0-4b5a-4c56-9235-407fe2f608df,Residental,0.9384725213758098,5,23,245,982,737,93.65987646941284,4294
ba989244-3120-417b-ae5a-e7eedf9e4c7f,Commercial,0.15798126121860656,19,22,650,864,214,60.77262296447578,6173
0ea36243-8d58-46ca-9ea1-dbb5107a67d0,Educational,0.9951027519967379,46,16,649,1127,478,82.48542974278084,6795
5edbd712-22c8-467f-ab5e-709badf2844f,Healthcare,0.040862057900115656,50,24,296,1078,782,19.070590092440128,3206
589fb505-214d-4ac5-a6f1-0d0081738e80,Healthcare,0.3343450653163734,38,9,88,1270,1182,74.24212167121536,5887
3ec06305-cee4-4d67-8b63-9928bb902f97,Educational,0.6671782798424387,7,11,268,422,154,23.935220562202016,9678
1303c751-a315-46e6-93fd-30c0d2509180,Educational,0.8941722962500239,30,24,435,891,456,49.603180537028884,8369
ae90b3b6-85d0-4294-9a1a-84b728c3013b,Residental,0.7939408628200314,21,41,477,973,496,45.28629899142213,3819
4bb36107-f6a8-4009-8499-cd667528604a,Healthcare,0.39201023997092654,21,32,637,839,202,41.06067911103256,1602
fbc4acf7-6220-4650-ab9f-16ea289fde35,Commercial,0.2147694896311354,17,49,365,1134,769,94.96021888911125,2493
6491b9a3-76a6-4e0e-9acd-0fba8e4f2f9d,Commercial,0.4730365024883594,41,11,368,733,365,49.00819899586484,4135
09b08f9a-3030-4f34-83b4-5176ce0ef32c,Educational,0.7302487639159551,9,28,195,1359,1164,53.2864834966761,5805
ade8d01c-55ce-43d4-b4f6-8e6987cbf845,Educational,0.06744063254186006,49,25,510,1219,709,28.32310486939948,8246
4ff721bb-eb4b-47c7-b267-e95624e7f892,Healthcare,0.7538855503758866,30,43,31,124,93,13.184939924852936,1752
45ea7615-96a8-4872-984a-1923ab596b48,Residental,0.02453445887822603,29,18,599,825,226,79.43817864352971,5807
b90b5573-7082-419f-85c8-f713c6fbfd96,Residental,0.5066123307526544,27,43,589,1012,423,12.110688797357565,9341
3f0b1c2e-507c-4a98-84a1-be6a98d026cd,Commercial,0.1302170367180261,12,29,232,417,185,22.09379627168026,2184
5e08e3d3-2539-43ed-9897-6deaedc32feb,Educational,0.024718507298366776,49,40,400,1150,750,23.744007988361883,7605
7ae00c4f-548f-478f-a542-3fc66a3b2963,Commercial,0.7644418685149029,1,14,703,852,149,29.364720272608395,4049
6db17cb3-0924-4678-93ad-3ce46cdbea20,Residental,0.9885253158569376,34,6,424,933,509,87.83212011090595,1665
7d80a380-a348-4f2f-bfe3-194dbd395f64,Healthcare,0.7102820961002075,39,9,11,493,482,78.52861992269652,1988
e15d87e4-8aa8-472c-b763-6f4367159487,Educational,0.394216578925879,39,12,198,393,195,92.8570769759398,5837
9a430c30-1d28-4b61-89b4-49919e9c827e,Residental,0.4993501357391046,27,38,544,1108,564,20.994365630821502,5039
656d6656-9ccb-415b-b669-618a11787d81,Healthcare,0.20952735262162026,45,4,139,476,337,23.197333167650054,2129
7871274e-8d4d-46e8-973a-b558e38fb6cb,Healthcare,0.47339134495314283,33,23,415,765,350,85.59453406325065,6851
e6a13513-23ca-4cf4-bdab-95076c9c9f6a,Commercial,0.9311186625222683,20,16,630,1353,723,19.444227101677974,8831
657d4a60-b54a-4748-a4d9-f1f48be2c61b,Residental,0.6424539956616584,9,29,565,1320,755,64.12973211135412,9039
d4edb17d-3330-45dc-82f0-88d070673046,Healthcare,0.261980978242522,42,30,44,1054,1010,38.48334803865892,2765
78e96783-4b56-44fd-a6b2-5dfd0dda8a2d,Residental,0.7820632540910076,27,19,601,1416,815,13.675708455429977,2375
7837d504-3edc-47f0-8161-744860048fb4,Residental,0.9805170133654326,41,29,663,1358,695,84.31812446840509,3628
fe45310e-8230-4a9b-a117-8e113c342326,Educational,0.8451287593011841,19,14,172,343,171,33.52954630691434,3669
513411e1-f0b4-46b7-bdf9-3f2f24936514,Residental,0.20196033433157745,30,7,550,893,343,59.05163663744111,6709
1dfac94c-6b0e-44e9-a96e-20fd4bc0d974,Healthcare,0.15569781753437117,37,45,128,1168,1040,56.30986876842216,8564
f7a26d39-8c5e-4761-972f-b610eacf1eb4,Healthcare,0.009377578233274453,45,10,185,1314,1129,42.97073094972584,2698
277ef6f1-452c-4676-a568-fc39d0adbb15,Residental,0.26214220301577107,48,11,549,742,193,24.34001722105836,7178
be61b8fd-2c2b-4d90-ac22-37f5d42bf023,Healthcare,0.20475029731769012,21,38,306,1293,987,21.88499536315849,9537
fcf89d16-381b-41d3-b526-8d166f7e3e22,Residental,0.030088566855864585,5,29,16,224,208,79.80836405593693,9039
1a667134-17c4-42b2-aa69-9f7652814ef1,Educational,0.4759340339393048,29,26,149,1294,1145,47.963822098400726,8771
6820792c-fb61-447b-8ae2-525a61f6116d,Healthcare,0.24667631526766443,20,46,458,1200,742,87.98237586765262,8492
1b3acaea-b7ee-4816-a8c9-092072f709c1,Healthcare,0.310810847367329,16,21,580,680,100,55.312767041434874,8635
6b4fbc61-bbc2-48b8-9591-44d1abaeac55,Healthcare,0.5708798107379945,38,33,584,715,131,54.675050068064856,6662
00a5dc73-133c-408e-8bc9-8b752c40438a,Healthcare,0.912400643560707,2,15,353,1047,694,99.44688033568617,4770
c0b29b8f-1a94-4d55-9bf4-1f3c5aa40faf,Healthcare,0.5883483555234232,10,15,330,1264,934,83.26318843886726,4835
67f85d86-e2f0-4dd6-8c09-695721069728,Residental,0.9253062089027757,26,9,430,481,51,31.612518586906734,9772
cfe7de08-0d27-471b-bb83-28014771629c,Residental,0.1672594271103296,33,41,347,1234,887,25.89852624122704,6306
9ae7b271-b6a2-47aa-867d-d73d41957c8c,Educational,0.6030034131024864,14,47,616,1431,815,13.950759066498904,3116
193b7093-eb13-4c36-a9f3-15985698d1dc,Educational,0.9710520264115754,44,16,237,803,566,54.417570754102314,9442
a7a267e6-1756-4bb4-bcb1-56cef8ec17cd,Educational,0.4677355257238439,26,23,390,1358,968,16.46046015379723,4000
e8f42978-30de-4a13-9372-ba222caabcca,Residental,0.7078369737080339,40,30,502,731,229,98.5780666906649,2084
3dc627c9-afea-47c5-ae9a-31df692e4ffd,Residental,0.7244862918057231,23,12,548,683,135,91.30817220381188,5912
ed3e1847-4318-478f-8b7a-3eee92cbea14,Healthcare,0.3655855641781419,20,35,545,1127,582,48.83051576821603,3679
358466e0-363b-441c-b9b3-96c2dd42a278,Educational,0.8749464331164545,18,20,670,1029,359,60.942337101432116,2547
05357745-f8d6-4234-8262-1d1174dcb945,Healthcare,0.045735726904965635,30,48,666,1202,536,19.31260240232043,1397
3456c5f5-45ea-4a88-bfef-732135121b48,Educational,0.6176319616830402,33,4,130,479,349,81.51384181421757,4223
c5aaa1d6-786c-4a74-9d75-685344ad84d4,Healthcare,0.02628257670100187,36,5,404,907,503,53.934186268764904,9322
b90c2249-c3ac-461b-b7be-39d6d7b2051d,Healthcare,0.5378039402490591,30,50,27,981,954,39.15492355443021,9642
19c1007b-6c58-4ab9-a5d6-5d126b9222e8,Educational,0.7751985861009688,4,12,571,759,188,73.88937297935294,4986
e63ffb18-6d0b-4abf-a5e1-997ee05da942,Commercial,0.8846433891988051,5,42,142,1407,1265,56.468065822711516,1975
00f8c6ce-2f9f-43ce-a710-07d0a177a72f,Educational,0.3244898302260929,8,6,329,504,175,13.461320683039995,5888
332dabab-e615-42ec-8493-e37cc4e64b5c,Healthcare,0.5487552633377978,24,37,101,681,580,88.7485018705718,8035
04794ac6-5091-4cca-9739-62f6363ec82b,Residental,0.2671787531703549,33,40,532,1379,847,94.46706016107191,6946
4c051e83-1e05-45d6-8ac5-e7b533d73734,Healthcare,0.7674874369067543,28,18,498,857,359,29.868057721396404,2272
e097bf6d-0591-4c75-91a4-4b6af8d0676d,Residental,0.48030391403546124,36,19,493,1209,716,81.2811901444823,1091
8bef4605-2b96-42b7-b184-97c00e727b52,Educational,0.5420292262211698,15,9,258,655,397,36.30818602661374,6575
0024772c-f796-44b8-beed-441b99d476d5,Residental,0.9841176890017816,5,5,393,1355,962,56.48962385097735,3742
15e3ead1-7b9d-46f2-806a-e83509745b85,Commercial,0.25150521712750407,39,12,353,1087,734,18.97377552094785,8544
825568b5-2c15-4218-b7f4-fb056848c442,Healthcare,0.10765117985584771,40,28,596,918,322,62.07126145638692,9349
2a071877-75c2-412f-a4f2-03906050a6c3,Educational,0.1686636730882527,37,43,160,432,272,71.63228905006432,7298
b94e12ca-dd3f-4df1-9e83-9dcbb51f05b7,Educational,0.7783508586299216,50,43,417,954,537,88.09377021540672,6087
b531095e-c35a-4da5-8d24-6e6ec16a7674,Educational,0.2776336162281775,5,9,511,567,56,78.6340737532531,4897
f458b0cf-d005-459f-b5cd-27e237c08a4f,Residental,0.5121154089555376,47,44,500,1398,898,71.16552043829356,9887
6fc40786-f7e6-40e1-bba5-d5dcb3f633bd,Healthcare,0.2691149221995256,37,36,90,1183,1093,26.298114107599638,2260
548a8299-6208-45a8-ad39-43f44be9158b,Commercial,0.5403277912153924,24,39,432,1021,589,89.45827639652354,2694
6cdadb4f-306a-4b90-bc93-8c8d12d93531,Residental,0.9463725677970174,29,42,376,1021,645,69.90429619032125,4890
5cd8cc78-7333-4574-a607-d98523136a72,Residental,0.64035007570883,34,28,132,606,474,59.288871169725574,3348
fa6c9497-577e-4f0c-9c30-2fcc7d0b112a,Healthcare,0.7012532254243895,3,14,406,592,186,91.0379582369599,8982
66db7463-4248-40ff-8984-a9ebe88df42a,Healthcare,0.43958500445896354,50,50,147,1139,992,68.92214338787224,5136
8886a1d9-584d-490e-80c6-570dc4034177,Commercial,0.10566775613493606,22,16,423,602,179,48.50796467051188,4456
f5a52190-60b8-4a54-86b5-91b2474c056a,Commercial,0.5738628441287971,41,46,615,1086,471,74.20758621936365,2220
b896bed8-5e07-4a89-8104-b75c530e8d24,Residental,0.8710366062736861,44,19,503,902,399,54.96419216330374,3698
8445be81-0c76-494d-b3ca-e1dbf1ea412b,Healthcare,0.3812269228804088,12,4,638,1167,529,19.357523129589975,4415
eada8dd2-fcc7-4c06-ad2e-0406c74fedf5,Commercial,0.4661974069538467,15,41,491,521,30,54.449846262296056,1932
877c4fa4-451d-4937-a1c0-cde3e251fe2b,Commercial,0.9175495135573821,5,48,449,578,129,34.7243751471742,3400
84a875b3-ee55-4f7e-b26d-9bd62ce25c74,Educational,0.4904285268955232,33,50,289,447,158,33.78578874215424,2120
cd4b80a8-fa4c-4813-9e5a-51ae15b2070d,Healthcare,0.37751117004534973,20,14,375,1217,842,44.973878460017076,5419
2e0c894d-e45d-48dc-851e-120c94f3bbaf,Educational,0.5790120924471537,46,25,550,590,40,11.309185797199508,6281
c3cb5953-c064-47c3-b73c-abf6b11a4af4,Healthcare,0.030077595714250838,22,33,290,806,516,78.28192501253517,6969
893fb6cf-09d2-4f4b-a6f0-ef33f5f86e8e,Residental,0.20866798199768455,23,12,154,468,314,75.17852142891252,8520
2bf13a16-8a35-4cfe-842a-e73aad47fcc1,Residental,0.44940428956736556,9,48,427,1290,863,56.65194022584057,7374
c3471bf4-ea32-48e7-a453-183062d46533,Healthcare,0.24702204218694512,36,44,42,1271,1229,87.6507879240292,9756
31d9276f-795b-496b-8342-df50276bbb91,Educational,0.13014684202623705,3,40,281,879,598,20.03374988229463,2305
234f4025-c880-46a9-9be1-53f0955c3f84,Residental,0.6000160177574546,46,8,387,593,206,84.84297590323862,5705
dce40af8-ccdf-4587-82f8-b9c13b88eed5,Commercial,0.7796282451109074,5,31,689,1250,561,88.83028660682568,5587
54363664-a37c-46de-bed0-778728e87910,Healthcare,0.2635524940428746,31,41,699,849,150,98.88358063141281,2665
cec19f9b-3f98-4101-8c09-8e0f56ac322e,Educational,0.17396021607893242,7,22,105,1251,1146,19.907123556676297,7684
61c15fd5-6a2c-44a9-a057-c11bfd4704c6,Commercial,0.4563644989808331,38,2,306,334,28,79.48949143165026,5785
8c1d7014-d725-4047-b6cf-7f677d4eea72,Healthcare,0.10873653581070619,44,40,337,849,512,93.24051168626626,3005
d9631220-514b-413a-b5a2-02e0c0321224,Educational,0.14255171133494415,16,36,50,746,696,80.142759946908,7995
0bc673db-f0b3-4ba6-8710-cf069c11aeee,Commercial,0.3150389228894577,29,25,517,872,355,47.52848904049983,1692
041bfd09-9a6d-46f7-a10d-0654dcca5315,Commercial,0.5282317707256968,7,43,479,1199,720,10.155207577814902,9277
6a5cbbf6-5eee-45c1-a2e3-505c088559a9,Healthcare,0.3908102216601579,42,50,71,1408,1337,46.63966135184435,2892
a45d7591-ff6e-43ba-9370-a8ea8ffaeaf0,Educational,0.39857826664998086,30,24,262,437,175,43.6203834780452,7413
37c713f0-43c5-45b1-930c-112a4fe4d580,Commercial,0.06514382638838612,40,3,695,1092,397,43.138373599120456,6387
3a87c6f1-8574-4d3a-aa72-e0f7983f66c1,Commercial,0.5791638253608561,29,22,455,1358,903,10.275898457490419,2547
64b7758e-21ee-4ae4-b5ca-e54dfbad7d44,Residental,0.08149385601936454,32,37,573,841,268,52.773437631859004,2379
6f2eae28-0d70-4afd-ab70-0115a3190efb,Residental,0.8455734422370439,1,45,250,315,65,50.23413988302455,6690
6ee767a4-0cb8-4390-8a30-2c6f7daa505f,Healthcare,0.671751044659348,43,12,481,1169,688,33.88474515211583,9834
40b606d5-3f80-47f0-adc2-dff14bdd8d2c,Commercial,0.4066141733911167,20,13,553,1298,745,88.86908948230706,7960
a7dd5e21-d161-479c-a00c-7646baa4dfbe,Educational,0.4686913896692946,10,46,499,1351,852,35.37777898086096,1038
44bc129a-f8b5-42fd-aaa6-ea2b1fd87a5f,Commercial,0.7702219422147734,20,2,708,933,225,99.91611849615697,8905
dccdac27-55e1-438d-a0d6-de8d78199feb,Educational,0.37627489474228515,46,3,339,507,168,39.10953791713016,9468
945d5be1-0a6a-493a-a057-f90e41f32a36,Commercial,0.8204947947573734,35,30,223,376,153,41.42062083911071,7448
4f0ea9aa-005e-400b-8fb5-b6a9b9486510,Residental,0.48569089753093664,50,48,229,1278,1049,30.391527590568057,1580
f039da28-0b90-40a7-b5b4-fa5dc8655d4c,Residental,0.7121294403771594,12,2,107,1335,1228,11.317604382643347,2102
cb5c1bd6-4c14-4827-b471-6959b69b5820,Commercial,0.7371417053853796,27,5,480,784,304,99.63378395384478,6113
440f4bfe-0ac3-4a6d-bfb2-c1952743bc59,Educational,0.16488440956831873,17,24,512,797,285,52.527351535251626,3381
1c53d780-4c8e-42ae-9540-9c71976ae3da,Healthcare,0.9405836504239943,14,10,540,833,293,42.60409328911072,2251
9efed148-ee8a-43ae-bc8f-281dd5a837d0,Educational,0.04430526933924661,31,9,512,1180,668,68.10762265631774,2526
e3784e56-6b6e-4993-ae06-3bbc4b007d81,Residental,0.05511229479679247,12,4,215,1154,939,72.25192175368115,5146
b7513e62-ffdd-43a8-8146-8dc84c7bdc1f,Commercial,0.5841731189880011,29,25,611,948,337,94.89480014773774,4609
459b927c-07cd-4be2-b3e6-f8ca3c985ae0,Healthcare,0.9846775289928349,28,24,451,1151,700,24.385649670406547,2851
9070a83c-e1ea-4c0e-91e1-48d358706c89,Commercial,0.74632473551334,1,34,110,1267,1157,33.17950156997897,2520
b6e76c5e-946e-44f7-8e5e-0d4b00e60658,Commercial,0.8885825807740667,40,18,397,876,479,94.93313524880882,5697
2038143f-0228-4b2c-af53-f437adca6eb3,Educational,0.003384556159206631,42,45,139,527,388,17.10230047306389,9926
66d3bbe1-7d4d-4cc0-b04d-88dda8d3e508,Healthcare,0.4053543098904171,3,13,498,869,371,48.3765653737631,7597
a58adc74-61a1-42aa-a6ea-854d1b6ece8b,Healthcare,0.8384231297865921,5,2,594,1370,776,62.64100551120862,3800
b9d3779a-be17-45ca-88e8-1add76c574ac,Residental,0.9833062924650916,42,50,641,1385,744,79.68762714848755,1387
4cd0bbfa-4b71-4f3f-be6b-54f0934ffa13,Healthcare,0.7631415871926515,4,24,662,779,117,20.041365078011573,1652
5f91f9b7-e65d-4ee9-8a0e-6f7a24466bea,Healthcare,0.37769075940186636,33,46,246,408,162,65.83572658876969,7025
262dcfc6-2782-448f-8323-d4bf477de4db,Residental,0.283353532704292,3,8,515,913,398,56.927211129678255,4277
9bd18443-08b5-4e80-a249-89e06e0bd48a,Healthcare,0.44797737148991845,18,1,545,1075,530,99.6878396722862,9514
208ce076-be28-43d3-a6a8-241aa5d7ee1d,Commercial,0.2806128603093889,49,15,696,1411,715,81.92088329083505,1396
c5c3b52d-c2b0-4a06-a23f-3bb3611afbc0,Residental,0.6885381596959477,29,31,668,1338,670,68.10569236901515,9039
116e5bb5-8bc4-4231-8ef8-8cb5e80a78be,Commercial,0.31559075646111,35,12,388,1075,687,37.775464334561285,3630
f807a631-99d6-44c0-a765-8e4504d01ec2,Healthcare,0.10880554857097613,5,21,673,1066,393,24.46351324203537,9015
d5df46a0-a1be-47b0-bd99-e0e767471bb8,Educational,0.6063317160360812,30,50,573,985,412,19.643773986890082,5210
6084818f-3316-4f9a-a4d9-040449c6eb03,Commercial,0.17648090532251848,7,37,149,628,479,93.41517222737626,1450
7ae4717c-36a4-4203-b0f1-8a71c891b59d,Educational,0.7160019544970535,24,11,706,967,261,21.77515156104042,3693
d9f3b1d7-5af1-4a74-a110-983fd33fa93f,Commercial,0.6771545865120905,5,35,382,539,157,28.27789511424309,7254
2acce42a-86c7-46e7-9ae4-b193d765241a,Educational,0.6227331091006951,30,34,288,1095,807,46.6387407810739,4722
ec731b7a-a887-4fc8-9ce6-747efd361027,Residental,0.916863774346125,36,2,349,1178,829,73.3557663012892,9754
651c4cda-ef2a-41bf-a3b7-53eac018d9a3,Commercial,0.8903599854797627,32,14,200,207,7,84.06193615337682,6550
e21515fb-2ce5-4aee-9d8a-af8763dec1be,Healthcare,0.6176279786527384,9,11,17,776,759,68.76172058835736,8016
310aaa0f-3e44-4943-ac1b-f42fa7b576ba,Commercial,0.8586951316098741,20,18,122,1296,1174,78.1090944056273,3427
618e2a93-579d-4449-bdf3-6e642a2747f8,Healthcare,0.888157622082487,6,22,161,789,628,25.43666730701389,5803
029b8d1b-5e1c-439f-a738-0c6cc20d4cfe,Residental,0.4161138804267501,21,49,122,1009,887,43.29371388929862,5935
19a71953-788a-449c-b537-c424e062318d,Commercial,0.34931966704217643,29,8,592,1022,430,10.15028207660188,9740
6c098a35-27a0-45d2-895d-0c3297d302d1,Residental,0.6351587829539757,31,22,351,1398,1047,80.52876505814518,7153
1e13d208-f1ee-4c1b-9d5f-d340d65d67a7,Healthcare,0.6593340327672763,12,30,350,1294,944,61.99126438716767,1210
d995bba2-8a3c-4407-bcf6-22befc954b09,Commercial,0.4121513390558742,47,24,409,779,370,40.33721254326949,4846
66cf59a9-de8d-4df1-b33b-cbcc78c20426,Residental,0.10731256769993491,27,5,511,1185,674,75.98086512925812,9149
96d23841-1051-41f3-8b84-5cb6bc36189e,Residental,0.08993323479874304,28,47,657,1251,594,92.97410301703691,8964
79beb61b-53d9-45b5-9fd3-64c0f428f662,Healthcare,0.8106576770087722,48,45,619,1114,495,50.8061408246799,7819
ff8af817-b48f-4122-9525-cf0eaea7b672,Healthcare,0.3963446839446997,5,9,619,1251,632,79.15613008182528,3444
a17487ee-664d-4da2-9c43-15db5bfeb385,Educational,0.0571751762620899,29,50,281,859,578,28.69947815312909,3182
10000d64-ab9d-48a1-bbe8-45b6e70a117d,Educational,0.04744671664564437,6,45,704,1174,470,75.73117800063544,8898
62c59dad-72ee-4c41-8ca2-d64fa6310703,Educational,0.34813060991389555,44,46,459,996,537,15.133765427400236,1413
e941d47d-7796-41d2-b391-fd0e244b8363,Residental,0.24958189476219284,9,47,426,1032,606,38.05558106659204,7157
5cc1b052-cb6e-4a5b-92af-6be2baf1c7fe,Educational,0.6975299606214155,10,27,613,1306,693,14.78116891819208,5758
d06edf94-b95b-45df-b743-7e996cff0fd2,Educational,0.9442468327348057,49,31,442,1421,979,54.950414948742626,5880
e360c72b-37e5-4b63-babb-6b83fe74a367,Educational,0.9193281430418855,30,29,462,1228,766,99.81919726435868,2506
9f1a2811-1a01-4b47-9215-b30dad43c16d,Educational,0.6590577424649235,42,29,142,1130,988,53.905864252479915,6691
27715c88-2730-4286-b6ed-4103d3999ff0,Healthcare,0.5202267588278227,30,13,67,731,664,80.03810385653252,8795
72ec814f-0480-4cb5-b8a8-2d7a5d736eb9,Educational,0.5688242930900549,31,15,419,1138,719,30.21838916145487,7932
034778f7-c017-4d06-96c4-1f442d9a4212,Residental,0.6612847520961126,26,41,586,762,176,58.646322352267774,9556
b3ec6c38-cfe7-4a95-afe5-c5ab10f45d78,Commercial,0.36206985256960766,41,7,37,81,44,92.14100809368547,8462
70771378-0f6f-47c6-8fd5-4577bc93928f,Residental,0.17615498892142012,35,24,95,1198,1103,78.5556491942843,4474
0a604b60-9a29-4f64-867f-bcf1710c6329,Commercial,0.9256807402976538,17,7,407,1262,855,68.14428239022241,9242
276ac0c1-a5e1-43bb-9866-3ad555a3fff7,Residental,0.10045010556795719,50,11,505,775,270,78.57493544748549,2934
e7ad1440-a32f-4e62-a0d5-495b3c68d457,Healthcare,0.9546491176932153,50,49,39,65,26,34.218652853416586,2054
31bf3aaa-1529-421c-bb75-85a5e782c872,Commercial,0.3841236173305057,14,23,316,1055,739,73.61009442863872,5252
a819da4f-ebfc-4529-8b11-2b6caecac8d6,Commercial,0.8210622695376847,50,31,344,644,300,56.049395996197,4362
a303f727-36ac-4cc1-a9d3-8bd1df887434,Educational,0.10356252690520096,43,30,302,352,50,10.150549050028996,4000
88c57b77-d685-4b1f-b8c3-1f1f31c3161d,Commercial,0.9206464035162486,40,3,571,904,333,16.316409536133825,9031
813b728a-5e6d-48ae-b7dc-916ef88da85f,Residental,0.2924385519031881,14,21,231,694,463,50.2158485021888,3217
03a9be5b-f36f-48de-9b61-75c6862a7350,Educational,0.03358884534072404,30,36,448,488,40,58.93943387819733,2513
6cb8b2ce-cfa6-4858-ad33-6367a68e9bc9,Residental,0.6343613851314266,3,16,129,180,51,52.428916238450824,5192
e45d4214-15d9-447a-9d59-e45101a3e363,Commercial,0.5777588500204816,27,18,57,519,462,33.717816851093254,3770
686e5edc-4102-4e08-9397-45e3fdf19a53,Residental,0.18968624963674108,40,8,287,633,346,63.328571180193116,7614
f7f5d933-bc71-4cd0-b1f9-a0092e392960,Residental,0.8228683740114702,9,50,298,344,46,52.725568120364464,2966
89308d32-2786-4a2c-9526-f3ec8058bf8e,Residental,0.7725535226677184,33,8,571,673,102,93.32410567826683,4188
7f64b2a5-337b-4bf9-bf16-dc33bf5c5dcc,Commercial,0.48179841177886007,17,4,281,962,681,64.78750925678983,8632
121c7633-ea06-4ac5-8c5f-4a1801b05d0f,Commercial,0.7072639942516377,13,35,38,204,166,86.99937872375764,7538
a5631ac8-1258-4f22-a9cf-816aed203775,Commercial,0.8206895353506946,12,49,402,1167,765,31.83772413211853,3201
882fb3c0-0c60-48e2-a3a6-17941cbeaf9f,Educational,0.7298610810147218,35,2,79,878,799,26.295908345375143,1657
976ffc3b-abea-428c-a4cf-4d188bb3c2ca,Commercial,0.15346957995722987,25,46,102,959,857,95.12023654087766,7135
8f62055a-b03c-4d0b-84da-c35aa8e5c212,Healthcare,0.8767808459703609,23,24,495,531,36,16.44277898457807,7305
45c4c8b3-81c9-46e4-b2b2-9c3c0d2517a7,Residental,0.2766527023195543,33,47,303,976,673,15.68957090734239,8344
145f102b-ebba-4b8b-a4be-ed6be788b36b,Educational,0.5413804416479943,38,25,1,951,950,78.7297161838481,8677
759ef58f-7eb5-402c-ad1e-fe6185194c6c,Healthcare,0.38783104620084685,41,17,699,1343,644,64.7191382957275,3665
1966609c-7196-40c9-8af6-6aa52dc9652d,Commercial,0.037612266932737226,36,8,134,1392,1258,16.261644610951297,9683
07a8ab25-e858-406d-aa01-e3baf6818cb6,Commercial,0.8398023928212892,23,49,683,1411,728,62.1988852119577,1463
cdec2cdd-186b-4f86-ae4d-f535cc04c1c1,Educational,0.1563691133830828,2,28,555,1111,556,45.716113753804706,6443
992f99bc-0003-4752-be46-374ae6cd7711,Residental,0.5114544262551378,44,1,612,836,224,56.867133971738824,7704
ceae38bb-d53a-4aa6-9da9-5d801f8b1b2e,Healthcare,0.4733768564332883,45,16,114,253,139,94.09574258350334,1014
25ccfc92-9937-4dd0-882e-45b0fba16657,Commercial,0.20249628218674154,16,38,243,595,352,37.51386364741792,5338
e85883e9-4f27-4c2f-8916-858b609d4667,Residental,0.8047213594781376,45,45,296,474,178,90.32552363731003,7485
5366a15c-639e-4e01-bb86-9559b835bd38,Healthcare,0.7867179581390575,41,6,319,1180,861,51.998260522885055,9712
a5f82cc1-8ce3-4c27-a9e0-70d550c8e636,Commercial,0.8579938600206799,15,5,289,1339,1050,48.020577019876484,8041
5b4ed5f8-f526-4882-8242-348b408d6e77,Educational,0.17416680054264755,40,14,607,1042,435,14.13933612343734,1572
c1bc48ab-799c-4edb-aff2-28d6eccbcb9d,Residental,0.060887810121421304,20,7,258,527,269,35.606396106765594,4746
91be5b04-4fe5-4d67-86d9-3028f8816817,Residental,0.27449913690993355,28,29,82,463,381,47.54500330131857,7579
3267f219-5a82-4f15-af3f-a8e8b7f30830,Healthcare,0.9134337032284009,33,11,640,1326,686,39.229434284406246,6937
5ad8613d-e686-49a9-80d1-28992f2a88a2,Educational,0.45905617857126424,10,37,251,565,314,13.807947121315236,1900
97845aa8-d148-4b8c-a98f-fb751f3bbc70,Educational,0.9238866503439723,28,19,602,863,261,25.979164206124214,2979
111ff666-c677-4c36-9faf-e88c3e19e905,Commercial,0.20553786983351185,38,15,220,734,514,83.88546575925231,4902
d3e114a4-c92f-4f2f-b8b1-e51af9a3e80a,Residental,0.8009248095806935,48,25,690,1434,744,55.61919282654189,5481
f197f73f-0d5c-4ecb-97a8-86ca4afac96f,Residental,0.22818559339246125,3,36,190,1060,870,95.43302845216658,1649
5cdb0c9e-bd9a-43e2-8f9d-eed0389b1dfb,Educational,0.64304847913414,4,39,273,524,251,24.42960127560176,7836
7a0fe643-1a77-4d94-a00a-809154ec0259,Educational,0.21916662685336252,11,13,626,1240,614,89.93441658448629,1100
363a6ef0-b926-45a6-a85f-f1abecd34226,Healthcare,0.8084740647680253,36,13,428,1027,599,44.20519409204489,9877
fe08e744-9d45-42b8-b409-066e3ee54325,Educational,0.31612879415697503,44,29,28,822,794,48.424047096847694,4394
5c752e9b-a2ee-4a86-9932-4e08974564ca,Educational,0.46829405156406334,25,8,327,1409,1082,47.94261030279968,9290
0e3d3b81-fcf0-42f2-9a1d-e1f7d3737ed4,Residental,0.7536972484113753,39,49,286,682,396,14.132355619370792,7182
bd1ba11b-3267-4a91-9bcb-a23276db7d2d,Educational,0.12022511658763457,45,35,150,362,212,24.025155996735386,6298
649f42fe-eab4-4b39-9226-8735dd9de575,Commercial,0.6959764333162153,15,27,119,277,158,31.069054777194967,6342
cae01832-c3da-4e64-8cd5-6284957bbd56,Residental,0.687192697498868,49,10,172,1118,946,58.141194439096076,5026
443e6aad-7cfc-46b8-a904-1cb8adfd8a82,Residental,0.616259222687949,30,11,245,759,514,11.129588822867746,5869
23c8825a-d479-4812-a40b-d237693b6e47,Commercial,0.5722591937359415,38,10,160,553,393,73.83022705898617,1521
84878a25-3c7a-455a-9b06-c00498a39db4,Residental,0.22758730338487976,46,36,22,110,88,15.846356206790693,4633
dcb517db-4225-4974-9335-23bf83fabf42,Educational,0.054027367559503325,27,37,206,640,434,27.285204017221226,5967
f3ae5238-f46a-4516-aa33-61d913de6466,Commercial,0.39809232857547294,36,45,636,1171,535,65.8647525210736,9461
deaec08f-2029-479d-aa74-0614e87dbb76,Residental,0.4372818862418263,24,5,221,1001,780,61.178054584122854,2575
85958198-a1f6-4912-af27-b82be5a38453,Commercial,0.3334990890343218,22,2,613,1067,454,61.48202215027126,5999
bc894425-d8b1-4705-ae95-3f985a036abd,Commercial,0.30960307971806567,10,26,263,1162,899,74.55289267525404,4731
2398a9e3-0e6c-4e6f-97b0-ae9162fb2329,Educational,0.7683255710744161,39,26,623,1390,767,11.075047908823976,4026
53bed382-d680-4203-812a-bcb4c535185e,Educational,0.08786163743451503,32,30,604,1135,531,51.32053539554164,5457
f8ad8c53-e62a-462b-9d7e-8ebc3d128a6f,Residental,0.3581715244301904,14,18,490,802,312,18.178224201125484,5706
a1b626fd-b267-4671-8a1b-2e14e2c9901d,Commercial,0.9160600475618377,47,7,605,1191,586,70.69472271329633,3769
7f5492aa-0c96-43cc-8e8f-2c27fd031422,Healthcare,0.41264476548838236,15,12,358,867,509,21.309952059425214,6983
174b5088-3189-4712-bd40-74bfc731bff2,Residental,0.88528077286417,1,10,154,297,143,56.66219176167766,1584
24763263-ffdb-40c9-a4b1-348db5f0f58d,Educational,0.8541385001504814,15,16,388,994,606,14.935885101336499,7822
34fc6789-5f8b-42ed-9376-0c1bc365c6d7,Healthcare,0.03897730214140005,24,26,385,1000,615,27.031938817059885,9523
ec60041e-55a0-42e8-b210-88eaeb018b77,Educational,0.26581907770372604,13,18,452,1083,631,47.42123360135128,1044
5c554ffb-ee82-47f3-bf0a-3faa236b9c3a,Residental,0.88738235351163,48,10,380,462,82,81.015149699623,3330
0a477758-f8e1-49c0-8ba2-0f4132b87312,Commercial,0.893964376793016,28,16,557,1107,550,45.97009682956333,2329
47d582ca-e142-4cef-a7b5-d6dc0750b146,Commercial,0.42136775789827197,49,30,179,1049,870,53.69443078352763,1182
8e75dcd2-0286-4bba-a39f-0152ba6f43f6,Educational,0.3439028794942762,38,31,480,812,332,40.896381268702385,3404
f9969f16-a94e-46da-9d25-9cd8e9014178,Educational,0.11912107170367026,45,27,293,1397,1104,62.91376885299032,5236
23e7727c-c69f-4769-942d-149d2ab9eb88,Educational,0.8773258065450946,10,37,237,695,458,88.6175894955929,5370
2b22c8f8-6b97-4b45-96f6-a2b3bc560e23,Educational,0.8140357708661469,48,1,705,1076,371,22.881995321671624,2871
c489491a-b8df-456c-8582-98a5ce5a8681,Commercial,0.06397851274239941,37,41,510,1322,812,14.032893565441656,3715
ab4bdd60-f89f-4a38-bb8c-20ec04a3c1f8,Healthcare,0.6045061807690782,4,41,58,1311,1253,11.737673921799054,9780
8e9e0478-cd37-4a3d-b2fe-e3890313548b,Educational,0.06137242213164906,15,10,62,398,336,43.93451961902062,8048
146ee7c0-f464-4800-b0c5-eb6f143517d4,Educational,0.5614345195996919,9,27,557,805,248,42.22024487657093,6988
6460d9a8-b844-4983-b1ae-1323b8ac5bcd,Commercial,0.1810484283518332,24,11,331,1275,944,66.26299678646262,7161
69a0f992-545f-432c-b400-4649ad5be0f1,Educational,0.32641627436527343,28,11,254,1335,1081,31.035751712608104,1488
8d47c4cc-a86f-4149-8cc8-e544b1e021da,Healthcare,0.6675666187589857,33,43,47,938,891,16.708864149224517,1029
e623d93a-401c-4b58-9d10-c314d479cfe6,Residental,0.9918367326700224,12,25,618,1340,722,89.51880025597004,7881
83fb7301-616c-4db8-b0e1-8c3d967b6c8e,Residental,0.21817664357985833,37,48,497,1130,633,51.746405227578755,8998
2ad7d4cb-0c1a-4b5d-a56a-001333546e24,Educational,0.32460143617149906,48,42,632,1425,793,71.3128658743672,4704
222d5e0f-8287-419e-afef-d9919d2271b4,Commercial,0.49406167152224956,47,35,151,1430,1279,25.526855426215327,5484
3c70a8d9-afdd-4cfa-af53-727b3b05c1d1,Educational,0.1079424371547466,40,35,170,1204,1034,92.39423364624969,1948
cb18ccaa-d048-43c3-ac07-b8f61371e81d,Residental,0.6148244175048043,18,30,228,1223,995,59.02107923478242,9554
d8d336ad-2c36-4408-9d09-c38abb2f322f,Residental,0.30276893159487983,37,31,531,1224,693,41.46196135327489,4454
922aaa84-eebb-4cae-aebe-a1f2c21fbbdc,Residental,0.08741664052934206,24,35,308,612,304,50.57715020317115,1068
b5fd026e-a418-4293-990a-ba268b2b56a5,Healthcare,0.1597697226536784,4,4,356,1374,1018,53.20909892909519,4968
b0b5f9f5-0dc4-479c-8002-17d471f10663,Healthcare,0.46043518058996724,39,33,255,922,667,58.75296007667319,5790
1151fa86-8701-4522-abec-d2e345040d22,Commercial,0.16379679314854367,21,16,718,1401,683,54.959548563828484,5105
a346ad9f-c3a1-487c-9a1c-aac30d73c5d2,Healthcare,0.30875010126028113,12,27,670,860,190,18.476781882041255,8873
075c030b-91e6-47c9-b409-16f277990afc,Commercial,0.49699871339830237,5,49,355,830,475,23.20989074591907,1539
598fd192-e0ad-4557-8263-981bf33be4ad,Healthcare,0.6113235454876659,9,40,48,660,612,75.17565626820708,2688
29852987-cb19-49dc-9e37-a19bf802b262,Educational,0.8030485919564819,37,46,24,705,681,83.11928622348088,5717
b708bbd7-519b-4361-a46f-f27ed98bdf44,Healthcare,0.0770936720637887,27,15,85,799,714,68.15139039138126,8022
27dfbfae-1474-4335-9679-37611b6d637e,Residental,0.6572395511917444,20,5,717,782,65,15.315373861240413,1555
712dfe55-5611-4ebc-b849-296399be6139,Healthcare,0.7161418138371443,25,29,699,1062,363,85.6760141096444,1248
5966becd-7599-4a8a-b12d-7941dd236898,Commercial,0.40976760858801864,39,6,22,754,732,38.9078282154312,5076
a05de9c2-4863-45d9-9622-0d7261c99066,Healthcare,0.07204440819465663,28,49,253,819,566,67.22730505901728,8138
b22952c7-186f-465b-b7b8-08ccf8b1dc07,Healthcare,0.33322253547775726,42,40,331,487,156,27.12694703299563,4400
48547c6c-ae94-4069-b312-ba33ef1c87fe,Healthcare,0.045736467099356304,42,25,315,1291,976,48.47996988545573,4932
3b8012f1-5e4e-4e62-b4bd-e6999fd17c19,Commercial,0.6872270883625434,43,1,261,429,168,26.368989832934094,8537
0391a1d4-4e1f-4f7d-934d-b51ca148f3c9,Residental,0.1857178940812162,4,38,580,987,407,42.64412405922885,2282
b5624551-e2f1-4b40-a83f-a75d220c0a2f,Educational,0.46249652847019496,43,2,7,225,218,24.765755117843888,8394
126f8b12-6cc1-4a00-a700-9681e40dfe32,Healthcare,0.34964139429514274,3,18,274,539,265,16.01044588135668,7255
b4479d83-2b5f-45a3-9f8a-74991eecad46,Educational,0.6442823435299334,15,35,665,1020,355,42.90558085182085,8092
130ea156-89f2-41d9-b24f-4b304489a30d,Commercial,0.8430972386145851,34,43,317,390,73,38.540785879477696,8957
a9c67b09-a030-4cb2-affc-636bd3769185,Educational,0.9119348915632496,40,20,521,898,377,87.10599622768426,8406
f368dc87-5011-458e-86e6-6bc0a4119d67,Healthcare,0.06928005340048382,22,9,666,970,304,11.830682806803756,3857
d703c96c-f15e-4aa4-a610-eb3e15e3dfb9,Educational,0.37311967136537805,43,43,367,636,269,57.629643226660605,4369
2a631860-5341-4484-855b-236dc16b81b9,Healthcare,0.4999560133842914,5,46,426,643,217,76.29539657360534,6666
d7e64a0e-d08d-4fe7-866a-d69a5b84ec95,Commercial,0.4185125586060887,20,7,439,1369,930,67.95359533800283,2641
c85bdac3-343e-46f8-9d89-68e087427b41,Educational,0.2637075670476201,11,39,194,418,224,20.302519222046534,9714
794e9528-2a26-4223-a3f1-99a6884840cd,Healthcare,0.9184670032299634,23,44,481,708,227,23.15764702472701,3580
cae1b8cf-3ca0-40f4-b738-7d14660adab5,Educational,0.546132033242715,15,32,519,974,455,76.35679243828217,7975
f4a34b81-d9ad-458e-af26-bbd02dea3a77,Residental,0.8080746265043831,23,19,495,700,205,81.00540142143416,2334
ffae4909-0e3a-4402-8c00-8bd99fa0edfd,Commercial,0.5910112268356956,16,1,570,1134,564,74.88114220798539,4657
222b8197-4d50-4372-9333-037aaa801d6a,Educational,0.9916002799139321,12,35,1,1019,1018,91.37947683834062,5329
d6acfd29-3d84-4400-9995-6a0cabeb0a50,Healthcare,0.8059480077550231,28,36,104,1281,1177,58.461927322318196,4900
a104378e-3a75-40dd-b890-3ba6bebfdd05,Commercial,0.4334533247999266,46,22,659,1226,567,30.561253659197842,7065
a0c8ff4f-c2d3-41e5-9819-d5949c91b1ac,Healthcare,0.024855964538830544,23,7,651,1232,581,68.67063267357862,8202
558d65c5-101b-46cd-a28b-8ea4ed5d0df6,Commercial,0.0520881856716896,3,12,629,946,317,16.673996360668824,9778
547d509a-deca-4996-bb0b-79e26c4bd4d1,Commercial,0.7076086144926282,47,42,487,733,246,13.113962547927084,1604
f5382f37-24b2-46e1-806a-72bc2152af3c,Educational,0.16888696327490638,22,44,308,690,382,78.7123930968791,6550
89d94910-6090-4a60-aaff-db546f1511b2,Healthcare,0.2634852519665192,43,24,39,137,98,21.506495680725653,5954
c3199823-c790-4db0-9c18-567ddf782096,Educational,0.7457697013335679,27,48,520,578,58,44.51540447568014,5241
709457c7-b707-408d-9a5d-d3856132a826,Residental,0.6023930789876477,47,19,567,585,18,67.57753571735756,4159
1225d325-a256-472a-9038-8d776474029c,Residental,0.40797064298857866,35,38,473,1145,672,16.979125272972972,8691
4343367d-45ee-4a9f-9561-99eaf3aad727,Healthcare,0.32583123384015433,10,45,593,1199,606,79.22704109290748,1836
05c979cd-5fdf-4fae-817a-377924dfa205,Healthcare,0.3599875960684057,20,11,414,874,460,93.19350060678028,1311
d657dd9b-c920-4217-8beb-f04d1a412c8b,Healthcare,0.12267208752766057,18,45,712,993,281,91.54798151109625,7154
ca337e15-c5a8-4c7e-88e6-e1b4f5c0ff28,Educational,0.6638762918724771,38,3,273,1275,1002,19.84447097874194,4190
5c16b709-603a-4590-b599-f6267a9cb36c,Healthcare,0.3665058082553766,23,8,330,1358,1028,50.83957359577282,7318
e545e133-a27a-4857-abe0-c8428db36e60,Residental,0.8802044181406149,46,4,56,358,302,40.57296142486875,6913
49e25d79-a8d9-440a-87e0-c4da9fc676d9,Educational,0.580134246744674,1,34,686,844,158,64.07525553178266,7666
0f474118-4513-4693-ba82-26922ad85526,Commercial,0.6692166764509525,11,40,258,1014,756,49.7781482881103,8757
af7755fc-2791-47f0-ad6a-84449167e41f,Healthcare,0.841093782071136,25,40,670,825,155,56.514300579061455,2414
6a298eb2-ee96-4b3d-bafb-c46e1ce761ed,Commercial,0.010309733297039325,17,31,237,868,631,36.80931278430616,2365
81583dd0-6f85-4318-b585-cdd0a1d0d918,Educational,0.8784326873751575,36,39,127,398,271,49.44052522493397,7752
f429e09c-722d-402b-86f7-435e457e018b,Educational,0.69068521384061,45,41,227,1243,1016,36.91738345099243,1108
c55fb0cb-47b1-4a06-ae56-53b9206bcfec,Healthcare,0.49424635124081273,26,23,46,120,74,62.419652308515154,3166
18ffc823-c274-489d-97e8-cbabcb82870c,Educational,0.3917527432708464,30,18,88,753,665,49.77834727259876,6138
a09406f9-efaa-4132-b40c-74136579624e,Residental,0.1798780102895038,25,10,413,1269,856,60.51522827855855,7558
4cee1814-3479-4f02-93cf-e95514b6282f,Educational,0.5740973956037272,6,48,419,1211,792,60.07819057464008,1089
5e88a776-f913-4514-8c7d-c446d3a84227,Commercial,0.01477188740260682,22,18,386,477,91,79.06810539897357,9449
a3c948f0-6088-41f8-ab25-21b9691da6d8,Residental,0.03419677544967081,49,11,470,486,16,37.4648129847767,1788
3c0721e7-550f-452d-ab11-1b23a163129d,Commercial,0.6977040265896604,39,10,707,846,139,42.971075488747836,3084
3626d180-064b-4470-8f3e-4a8c9e8a015b,Commercial,0.6206736702206435,15,35,329,1324,995,87.30253350094239,4225
d11c8fce-06cb-4a83-a6c4-99888abe8e3b,Residental,0.3874836928919354,49,33,257,1183,926,96.9158940309642,6210
d8f6b903-4a8f-4e45-a00e-7ff85e94ce16,Educational,0.16164813903938358,35,11,443,1218,775,38.261767380552826,4230
00fd755b-1fce-4c15-a9be-529e6f346fa6,Healthcare,0.7008008236792245,9,26,9,930,921,53.34534777038088,9261
61f858a0-1d2c-4363-b535-b72fbf498bf3,Commercial,0.5162734817658856,10,45,28,568,540,16.976218056597887,8255
d0d15da0-ed8a-4955-9407-6f6d25a33c4a,Healthcare,0.5245371009921922,25,30,604,1325,721,16.593281618053283,1959
dfea7f52-a669-49a4-9678-eeaf8367554d,Educational,0.09742187087288989,3,14,670,1141,471,70.49466020138198,3916
94093df0-49e0-483b-97b0-721f3eb5a377,Educational,0.4632511566983857,20,24,279,1307,1028,53.57460997554765,8923
0bc4fc42-7500-47bd-81ad-9911a2b320b2,Educational,0.12735045838392456,6,27,42,843,801,36.366302443607026,1269
cde9bfe2-08da-40f6-95a9-29e9c68bc1df,Healthcare,0.6653457941894833,32,23,552,1039,487,74.04376151365007,6473
19b48691-7665-4dd7-a11b-aed4c349dd5d,Healthcare,0.5066624791688817,15,49,489,942,453,77.93604323085843,4355
f6de3b59-104c-4c85-adf6-9d5be949740e,Healthcare,0.3025343951733378,49,10,72,957,885,86.21571584696777,9208
0253d97e-1381-4359-b60c-1dcf2d950544,Commercial,0.9002300068077554,29,29,87,1145,1058,71.98579052730513,6124
29c583b5-6599-4b67-8aca-747120fb04ff,Educational,0.9829610244329692,13,21,361,481,120,23.952287063362128,8234
77b95508-0017-4a63-bb51-a0a155cc1296,Educational,0.03307430609555384,4,32,654,1245,591,79.5355680576923,1893
ac8ae409-a4d7-40fc-a634-373d47c523b2,Residental,0.17970649608867595,1,7,548,1279,731,24.199082680988212,9936
9681e82c-3575-438d-8ba6-d52944c2f5b9,Commercial,0.09271035073609601,1,17,91,1269,1178,17.05997987672429,5726
c0ba7ca9-113b-439d-84e2-bbd44b165888,Residental,0.5198655405375799,14,3,491,622,131,92.21264107298084,9541
834b7b9e-f88a-4514-a893-e9a6f4863286,Commercial,0.5769220048584194,11,8,235,1314,1079,40.89682685710949,6572
4d66da1a-2ecb-4977-9985-c8950b4ec591,Educational,0.6937499076665129,14,31,488,1338,850,23.367930389298373,2398
5d691943-5569-4ca7-b58f-a328544521e7,Educational,0.4439130463934339,44,20,140,420,280,25.673751115629493,5577
0d58b78c-a369-4f30-a30e-00619323db75,Residental,0.14085353405881873,35,39,619,1155,536,10.488581005848172,1519
09c17759-25e0-431e-b2dc-b51e150bc9e0,Healthcare,0.17085673528827394,34,16,382,422,40,41.38436278803101,2655
cec731e8-d160-4bcb-8be6-ea379d4252a9,Residental,0.6239020871464653,24,23,101,566,465,16.657923062523523,6908
fcc4f009-0edc-4d85-ba6e-4cfd7afeb3b7,Residental,0.9969301873920209,23,22,23,1262,1239,89.32123508536262,6685
51163a9d-f8c3-4a11-8db0-c29b81567f42,Educational,0.583953679723687,29,26,190,1149,959,35.23752270759263,2813
fe52c02e-35f5-4178-8662-ff6b37ccd129,Healthcare,0.6093229285678596,6,21,98,939,841,89.21337107262005,7070
a324455a-eec8-4b16-9995-d9d8c9ba27b9,Educational,0.3651733896331749,22,26,579,1203,624,90.15989055829594,8931
34a516e8-86d1-466d-ab24-4e793a86eae3,Residental,0.04443990266402609,9,46,446,1393,947,64.63377483558183,7723
5c73513a-b47f-45bb-ab52-4038b2a6106d,Residental,0.6329390640373409,16,13,129,131,2,40.60406719683667,7859
eb04bced-7ef5-4963-9556-0c97ae4d321a,Commercial,0.5230327968441275,13,13,129,633,504,13.090910113567489,7548
1d1d54d3-ec16-4f73-ac69-7b8d6fa63e29,Healthcare,0.5164920964812738,9,7,467,717,250,39.87434358623365,6901
c740a3f0-ad2e-4fb7-9291-ae62c3f0f6eb,Residental,0.03795206804814666,11,31,641,1236,595,21.13385821145838,2156
cc91ea6c-5d7c-42e6-a2e1-96caeb2fc5de,Commercial,0.2757362635060694,28,13,38,1209,1171,51.06204794200314,5915
c679a816-44a1-4601-8576-fd34f99e7942,Healthcare,0.2299898891955644,12,2,195,239,44,68.30860471433087,6123
6cfa2df4-02ed-4ffa-aa92-6d68adfa4cd2,Educational,0.6141712506417466,20,22,61,687,626,17.385987952468174,8398
52258a6a-a94b-494a-9638-e10664116147,Healthcare,0.8822604939958691,21,33,477,1092,615,18.754609786302765,1294
d5f3d670-0e96-4ee6-81dc-ecec68a9c6be,Residental,0.2547718597656897,12,40,50,1159,1109,21.00214970327609,7683
5c0e4f76-fc61-43ee-b975-eb57e6168bf2,Commercial,0.5771999241917964,47,44,515,853,338,91.94371143006921,9512
e1f9e58e-0801-415c-8526-5f25c6f9dce5,Commercial,0.16940169958922424,36,36,229,577,348,65.40637574231746,5998
66b9f3fb-6a64-42fb-9685-5a2dd5f9b869,Healthcare,0.6818891215225742,41,40,417,1100,683,26.962335216839826,9418
fb77649d-ff27-450e-8e9b-61540c79e222,Commercial,0.7961188735579977,32,17,700,768,68,46.212278150967,2234
6c688a02-beda-439f-87c2-8dc6fc52b30b,Educational,0.0509304073621516,9,3,157,556,399,92.76461053623922,8005
11fc715c-0ab8-4f79-b7c3-38c807c4e59d,Educational,0.5836044247795769,33,33,242,1351,1109,84.21072443445067,6418
4be89829-7544-49d6-805e-649e8e84f6f8,Educational,0.8156678232262683,41,50,212,1266,1054,69.93879890470343,9009
667fda06-04a7-46d1-ae34-147823b31be5,Residental,0.40982947155804406,19,28,366,421,55,43.40468987349107,9558
9d0437f9-4b4e-4c85-a54a-9d8005ce074c,Commercial,0.12665260831631664,17,3,708,1247,539,13.102947395881664,7004
e713e7b1-dd03-42b0-af7c-8c37f54cfa1f,Commercial,0.10266588174896685,35,21,160,996,836,52.01818698804457,6861
35ff18e0-3f6b-4b44-8c59-f1088f148e81,Commercial,0.42552911865355425,41,22,79,121,42,31.745815723000995,9750
fbc26285-378f-4e3a-9650-6d2dad0c3cb9,Educational,0.6326310652287144,11,45,336,1277,941,27.904954393227825,1447
410bd7e3-bc24-47dc-b5b2-417c396abd8c,Commercial,0.8509625838874181,50,24,632,823,191,11.90403999515621,3176
d6e812fe-69d0-40a3-919b-c63c059603f2,Commercial,0.8661723550645355,22,48,658,1290,632,58.81977529467662,4422
8316ea42-7757-43ab-81ab-db3bd84c25c2,Educational,0.23471843842581963,26,30,678,761,83,33.70597816719093,8127
6dc3a101-6eaf-4568-81f2-c3a6eeb17153,Residental,0.6301800234738855,49,29,371,649,278,85.75156696091015,7212
7cf00046-7fc7-4f29-a728-53f6d47039e3,Commercial,0.17124770197945516,38,34,179,204,25,99.43033868234545,8332
86e0e06f-d78a-4dee-b6b1-ae72a00b584b,Educational,0.2286473958017381,32,24,708,772,64,53.87276190709197,3384
4e99f59e-8f17-4344-85bd-68777ca7cf86,Residental,0.44340994593173044,16,36,438,541,103,66.33757354248209,1941
8258c8d0-42ae-457f-955c-5bf2a3d91531,Commercial,0.9275234757503201,50,41,627,853,226,53.85152334200521,1760
bf300802-c8b1-410b-9d43-c3dfb23c8b67,Educational,0.5428634858437429,48,18,250,1352,1102,77.34507449256745,5812
20893c62-8376-418b-a006-0ce5146f8270,Educational,0.4438803993564615,38,39,495,1327,832,46.24715440549048,8886
b9f3677d-3810-4151-9088-f11583479bbd,Educational,0.1253645324597813,30,16,112,1123,1011,81.4684396707372,6742
ffd7f22e-a8ae-4f6c-aecd-21c1dfe8f284,Residental,0.9781859833773154,30,47,636,1097,461,24.147676559671233,3509
082cef48-97dc-4b66-879a-fdaf018e9eb4,Educational,0.2857476451883757,4,2,150,1230,1080,11.716066244617233,9650
2a6e4f08-cbad-4bb9-962c-fea6f5aac114,Commercial,0.2903373208750363,36,29,652,824,172,64.15048331760481,1100
adce293f-c160-489e-8458-fc2e83af799b,Healthcare,0.29315786320765214,43,14,617,815,198,51.094663679965045,5305
1cf8817b-4380-4942-81e4-c187e4c36b49,Residental,0.05882729907183204,20,4,596,615,19,51.55466580125255,1795
1bad463b-8edd-4e7c-8912-95fc914a7168,Residental,0.31287733318975075,26,39,314,1120,806,43.93684959805805,9747
40bd0510-a779-4193-b6c8-c44eccb6bd3d,Healthcare,0.8119285711864819,4,25,49,1014,965,88.82226608270732,2196
426af294-e804-4b29-a0e5-4b085ad74c3c,Educational,0.8214429433973541,35,25,519,1323,804,49.60041805670143,6157
45dab842-7909-44af-8a47-e6fa08a9cc65,Healthcare,0.9254749332396494,47,5,282,489,207,64.73950891436023,3960
013da7ee-a088-40e6-9103-e42305f4bca8,Healthcare,0.5554186458941563,16,49,264,873,609,30.215638396605858,5145
6d65edf4-446b-4ef5-9ff1-1d830da1b503,Educational,0.3913679763612342,27,36,165,802,637,99.16700419590443,4363
1d7bb593-4863-49b4-bc54-d9c82ebb6892,Healthcare,0.8471218104229552,12,6,535,1146,611,52.910085622726385,5312
cbb199a5-3f5d-4bb4-9edf-670a31230938,Healthcare,0.5853612281073053,26,18,248,319,71,17.17356369983694,4471
1ea697c7-75e8-4d5a-a013-ba9f4f7fa4d0,Residental,0.06456102482813242,44,33,476,1035,559,92.6950179204469,9075
31a4b0f7-53f5-4d24-ba58-24dec1412cb9,Commercial,0.6400071132809334,28,16,647,1168,521,49.10465997201999,2917
2ba99d70-49a8-4c68-ac8d-398df2aa3986,Educational,0.994344019276529,18,9,563,1177,614,68.36565434987433,3230
b2f236af-3ea5-4bea-88ad-e89b87751a50,Residental,0.11065739861858281,50,27,672,1056,384,94.64712121949626,2548
05e21c7a-046b-4e3e-b243-1134b985e7a0,Commercial,0.08243308357235313,22,1,268,773,505,28.00859279087164,2617
ba05ba7d-e6c8-4975-924e-556497033e37,Residental,0.5877885598659808,19,8,565,580,15,45.49134004638323,8228
ff97defb-98b4-4979-8638-83a086ea4c0b,Healthcare,0.29315832664262054,29,48,312,1230,918,89.49532411117774,3428
1a41d7a1-2b1e-480d-bc16-1974b78e0d72,Commercial,0.8157595967287135,36,20,542,752,210,50.92191696092337,3169
7f6fbc97-0f90-437e-aebf-a89b4d6455ce,Residental,0.5913189648366847,47,48,51,437,386,97.95069610623125,7333
87550a0b-88e0-4684-a149-0b27ca30d717,Residental,0.12638726787836485,6,34,59,699,640,95.85699290084871,4451
4ec56d30-128d-4bbb-a6bc-932a80e3f447,Healthcare,0.7228656870185544,14,46,47,1142,1095,40.309441647143345,8574
1aa7a116-73b8-4d71-b7e4-a04ec4a09132,Educational,0.017865122030835234,1,23,300,1423,1123,83.61260390819093,8729
8de769f8-7905-424b-9649-f9e37ff39b48,Commercial,0.6345847841699048,35,29,251,398,147,69.42348829552893,4453
afe02e2f-2e21-412f-8f06-580ab0beaf92,Commercial,0.2167268344467006,50,45,105,480,375,16.411967869943794,8687
94d4cb51-d43a-4db9-964c-cf32c75a11d2,Educational,0.8377790111492338,7,31,659,1023,364,29.33624934743126,5691
3bd85036-b281-4a4c-b027-7f1abb76b21c,Educational,0.9588367085131309,33,12,281,1277,996,32.00566099568871,7408
5442490b-ffea-4dc5-93c4-45eeeb612f88,Residental,0.7477663974798734,10,40,194,1359,1165,10.831735888830131,6597
d25388f5-8814-4c78-b5cb-06d57f31558f,Residental,0.4605501177370904,35,2,448,450,2,99.38219643074868,4291
2beb7f5c-d1ee-4784-ad8d-70461dd2e598,Educational,0.9807769913851196,30,9,359,1422,1063,35.93998311243203,6260
9a074f3f-2236-48be-803b-e2f214ba7a6c,Commercial,0.2038065090488772,22,23,107,226,119,11.586057689665243,5055
5a5e8bf6-a436-435a-8717-8114c2836f7e,Healthcare,0.16924051570343068,16,34,519,522,3,10.769468204922344,4700
7bf083c6-2a92-4cc9-b65f-4ef2c09ddea3,Residental,0.3768007351460181,25,3,283,1251,968,72.15748483723846,8824
9513606e-6805-4503-80af-ba52f079c78a,Commercial,0.3536391078596688,40,19,567,1247,680,79.47079844071212,3754
09d51dc1-702a-4f30-a521-d2ee58c0f140,Educational,0.1037896352545773,49,9,106,1408,1302,36.002734969874936,1470
88485cfa-dda7-45b0-a0a8-c74dd0687d20,Healthcare,0.6132064876746014,15,47,112,426,314,29.223146089175913,7134
07c4f416-a546-4268-b2b7-771a344f3609,Educational,0.7060965410041272,47,6,618,1075,457,65.62358802582125,7047
85e1cab1-f7d5-45fb-b2cc-d1956af06811,Educational,0.5690067308074478,49,26,75,202,127,95.65126226651616,2947
db54ad2e-1240-4838-ba1e-8513de60dbc4,Educational,0.9543460008844211,25,20,361,755,394,26.49396069294895,3900
ce9e34bf-18b2-46b9-918d-823ed5e36b74,Residental,0.2072471344373178,44,29,564,1012,448,90.71604448490129,7444
1cf3c627-026f-4be7-9879-068bc7dd3525,Commercial,0.6591481508255883,18,15,516,1244,728,60.89730574851493,1223
40e8d34d-d041-4152-83ad-63509e00d8d6,Healthcare,0.8893977542841919,25,24,482,1209,727,63.48781540307655,7683
ef7dccf4-3efd-4a79-9960-7a15a38a2faf,Residental,0.26912855189419693,27,42,375,874,499,67.32391702282169,6447
92beb159-674e-4bfc-b7a9-600dce0ca180,Residental,0.1538589159562448,36,41,49,713,664,12.642325355158157,2274
21c97f6b-20a2-48f8-87f5-acbb166435d3,Healthcare,0.8250692628189722,6,6,402,1170,768,74.05874993726181,5731
95a904f4-33a3-483c-8b43-17248018e053,Residental,0.08169717902536244,8,19,78,559,481,64.50658318663994,5268
8217169f-dc63-4d0b-a2de-0e31c1851de5,Healthcare,0.05809367962732315,15,2,636,775,139,86.2979849670353,4635
a6724d5f-355b-4c4a-b857-48fe51bb17d5,Educational,0.8395102739999288,43,17,261,1336,1075,70.19174376423186,5155
2e800a8f-bd56-4b0a-ad77-75c6b19864d3,Residental,0.9043993903148259,1,32,661,1350,689,83.03797485333804,3968
120dec74-80f9-4fd0-b0a9-4593311fdfa6,Commercial,0.5176765854403501,34,3,475,940,465,55.82788892006803,8903
3ca9a0e8-2d2c-4345-ba8c-9835d8cef28f,Healthcare,0.2850797295658064,18,47,292,313,21,56.85480831607837,8854
e36f2703-7beb-4e57-afb2-240efd84a6ae,Residental,0.19605759749390994,32,47,711,1361,650,65.72795869561014,5370
73ae20c2-b4e3-4038-ab61-417682932902,Healthcare,0.21255566676185778,30,4,430,810,380,89.6169401505635,3789
db50e292-6ff4-4bc9-983f-261b1740d3e1,Educational,0.8367488244463667,15,42,270,592,322,29.209547666841,1977
0eb8ee4e-762d-4d74-b168-89996457cd33,Commercial,0.20380045100862898,43,33,112,435,323,50.18973855336108,6660
5ccc18dd-d869-4090-a2bf-daa3e2c1cbe9,Healthcare,0.34041173725859386,36,1,27,626,599,86.59842549964763,9293
f2b32651-2eb7-4726-b9d4-0548e06c0ff6,Educational,0.7561307093308939,28,1,557,1354,797,41.46812674070726,3220
af5cd2d8-1883-49cc-8266-1163c90bcc26,Healthcare,0.5867048116677849,7,42,219,1414,1195,74.44687359416363,7613
a62bb279-e9a7-4861-89e0-beee3cf1d7b5,Healthcare,0.2317745216295266,15,36,465,1351,886,80.73220002999656,1340
7b192fe3-d6f7-447f-afbf-673a8b455e06,Educational,0.06544042622071389,40,47,104,1357,1253,80.17367790890525,3048
d9d3f496-3b4c-4e2f-9921-c4743b6e60bd,Residental,0.5945391748339935,31,13,428,543,115,27.61406909573333,7819
4a9f9755-fd28-4d07-b414-d770f6161aec,Healthcare,0.8142206603222738,30,9,688,808,120,25.17232869456598,6491
68f02fd9-96dd-4be8-9997-4cd3db490493,Educational,0.7653436180135509,11,12,290,437,147,94.15620590342434,7230
83b838b5-686b-4c20-a773-6c68956621dc,Residental,0.7687334058766115,17,20,445,1147,702,58.942605935621415,4207
83927e8e-cc7c-4aaa-a987-100b95918748,Commercial,0.29960643227809913,10,44,622,977,355,51.029423594045824,9771
65f39349-f35b-45f6-b5b8-7df3ed7f663f,Educational,0.6627360963830651,48,25,374,377,3,93.75685613463268,9185
49f4d39d-9315-460d-b275-e3c5dcc44d71,Educational,0.3512813770313783,4,41,70,1421,1351,53.135252862665965,4175
829d603d-f73c-4a8a-927a-1d1dfa17abfe,Healthcare,0.014128397392711656,12,29,321,697,376,58.5012688976135,6024
1d8c0848-d76b-4245-8660-76ad15b6c29f,Educational,0.6291132629201556,18,12,470,828,358,25.91297333602965,5111
775df895-e30a-4fca-a6b1-4802757bb316,Healthcare,0.028539307334695008,5,1,256,531,275,83.0816539898745,8102
a4cfcedc-558c-42d7-a45a-47f289bb744b,Residental,0.9934805629043988,48,3,211,673,462,68.0526449096895,5305
a293619c-5a30-4d34-9475-b82cabba6e64,Residental,0.324461493564553,12,46,147,925,778,62.844707800914804,6274
56de695c-d280-407b-a14a-2a6f6f33a6f1,Commercial,0.598889024934828,26,14,125,1335,1210,74.99995665912564,4362
9f5f98b0-126a-4199-83e2-ae4e0d63830a,Commercial,0.30997642365740496,38,24,496,969,473,71.57155501162862,2392
16791b6f-a470-47ac-aa7a-82226dc5ffb4,Healthcare,0.384564288095972,13,19,236,770,534,52.89007799473614,9402
50ea238e-b696-437e-a27e-719caae325a7,Educational,0.6408308095734612,37,8,118,359,241,86.76436720022434,7782
4251f564-9574-44a3-ad08-3f6455422020,Residental,0.1261731270095967,1,24,113,1290,1177,55.08794676596801,3896
91b276bd-e14c-4f39-93f9-ee36ec1eb8ae,Commercial,0.18726135278981182,5,27,361,948,587,47.79158460487928,4337
3ac63db5-cdf8-4881-b64b-a0b2957758a3,Commercial,0.5801911779072987,22,12,449,1247,798,47.12573632129762,6343
e08d32e4-11b2-45b2-bd73-5d7ef6a0ba9a,Educational,0.8328747291490967,16,31,446,1106,660,61.95513121216809,1747
6496732a-1760-468c-a763-e1ec2204103e,Commercial,0.03778865024292344,17,38,74,1384,1310,78.2453621674282,3936
3082fc12-3711-4f1d-947d-6cc85737d284,Residental,0.22662354517983596,23,23,370,1046,676,97.26817470260441,3532
6b346dc2-97b6-4734-9b2e-418041631e5a,Healthcare,0.5126041771276044,22,46,600,1254,654,85.33789754958403,3450
f1e50c90-633b-47bc-8425-5910d20384b9,Healthcare,0.6299705797254902,21,33,36,686,650,76.90771645921406,7018
e7e35363-4d17-4c3d-929d-ea0e5f20ab5d,Healthcare,0.09976623612710256,31,34,293,364,71,78.72474234654042,9951
e61d5f8b-4f21-45a4-b2ac-f2c6613ddfa5,Residental,0.5186084133208758,17,16,685,966,281,35.94650960306558,2616
3ee69323-75d0-4fe3-b6c1-efe6e7e8a587,Healthcare,0.1422862465623277,10,42,400,555,155,23.57044706133476,4128
43b7d9a1-7a08-4943-b886-ad5ce40ac08f,Healthcare,0.14316433733146106,11,5,332,378,46,20.85582855627526,6828
11c7f9e4-f9f1-4b71-835d-cac951f82302,Educational,0.06068580781242083,31,19,635,1220,585,92.53788539268976,2325
b1f0bfd3-a4c5-40b2-9a0f-1b0c28e879e3,Residental,0.29942261140947934,15,22,546,626,80,99.97947418056782,5017
763d749d-0c2d-4497-b6f0-0f3b430c196f,Commercial,0.28355798286161826,25,7,337,365,28,66.75906583992887,8243
1a176737-cb8a-4f0c-8e0c-475215542df5,Residental,0.9313799144691661,1,35,569,1071,502,93.65405975701593,3767
4b546c2d-2718-41e7-8c12-e8a0afafcd19,Healthcare,0.19051216916620606,2,35,327,517,190,39.03685164849365,3337
322e1715-5770-4014-bc20-363ce18690aa,Educational,0.15541332374862749,15,17,667,751,84,39.780896863528326,1989
5c2bd214-3b0f-4878-9fb5-70c974913c38,Healthcare,0.21259078059113068,10,41,495,742,247,26.782958647935345,5837
be47e5e7-8c12-4c0c-b979-bfd34d959a95,Commercial,0.9078235080606629,48,37,144,1314,1170,90.59526965334567,8601
8835f091-62c4-4760-9cb1-d49edddd3c52,Commercial,0.5719697719789352,22,24,711,1149,438,25.06635288895208,4471
359a5c69-408d-4246-90bd-2c774421f6b0,Healthcare,0.052413262876978006,11,30,69,1083,1014,77.91156360349031,6353
aff09ac3-d5d4-46fd-8b47-a13f198e72cc,Commercial,0.6772724932942205,45,23,623,891,268,39.125527546448566,4897
21ebdc3e-966d-4b81-9a0e-989365c61d58,Residental,0.592237432030012,1,33,691,1222,531,59.96830512359829,8443
077f2b0e-ec1e-4ab8-8580-bef3bbd83780,Healthcare,0.04591621410670821,11,39,608,976,368,11.682147764651253,5924
24359985-08d6-49c6-b268-7fff2d1f29da,Educational,0.9787508877278188,5,27,461,1394,933,98.76496665804201,7730
44c06800-444f-4baf-8866-774c65c4204d,Residental,0.6787370088439129,37,32,290,603,313,64.75852620844117,6132
6733ecb7-485e-4e06-8804-b19c34a6b1b7,Educational,0.35044451072295557,49,22,52,438,386,34.59121790844638,7057
dc73066c-981d-4558-bdfc-7c933d348c5d,Residental,0.06771946604376655,38,19,226,385,159,92.54730710773582,8521
4a6e4503-1b39-41a1-817a-c39971824046,Educational,0.7518430512660814,44,22,705,1271,566,16.602369615749613,7377
acadad9f-9e5a-4c8e-9639-fb89eeb783d5,Commercial,0.8701644721803188,31,32,437,922,485,41.994160838274425,8335
d1520346-9720-4007-b087-7f2bc04f14e9,Healthcare,0.014837286639910463,9,35,668,1321,653,33.17001010722327,4833
371f13d4-b648-400f-9c90-ac3e06ce0f4b,Commercial,0.30528211373875624,48,43,221,1082,861,41.05075386829069,7793
eb061c49-cfce-40f7-befd-0e7058d15611,Residental,0.24012284130671246,5,38,127,327,200,82.70628475681399,7238
8095bdc7-c4a8-4ff7-bb2c-3db8e525943e,Residental,0.3560916820297534,39,4,35,1402,1367,95.28152960753694,2116
c59c137f-2d49-4412-99b3-f6f5416b5a38,Educational,0.25291612782078265,24,17,118,1408,1290,13.873163468443195,9646
619ebde7-c853-4792-b679-32f8cb294d4d,Commercial,0.7849262114406628,25,25,407,1352,945,38.375639094457334,9729
52a4f3e8-6ce7-4825-91fd-6543377a30d5,Educational,0.42107675896576935,49,32,518,589,71,62.467225505619794,6157
2dd0fa98-8303-4517-a972-bc3c7b857ea1,Commercial,0.5565166801270747,32,22,545,1287,742,41.860354502369006,2639
075551f1-af96-4173-b44b-6d9c9ee70662,Healthcare,0.7706508271239767,11,6,637,1069,432,78.67947335111906,7496
8d298e8e-c05f-47c2-ae29-7e61a4b7f2d4,Educational,0.27358843445286807,12,27,587,885,298,17.293313418842136,5605
99ece301-83ef-44cc-b0aa-d805b4b884a2,Residental,0.23518780720247479,1,39,246,255,9,70.32988478137858,5473
71892563-bbf2-4b3c-91d6-75dc72e32da0,Healthcare,0.788778282501948,12,6,716,935,219,73.0876039172116,1567
b41478e2-c8ad-4b08-b9be-6672d7e62693,Educational,0.07974285139030146,13,28,6,904,898,82.9248779598716,4150
150c28f7-e34f-4cbc-aaaf-560fba873ae7,Commercial,0.6468181460764005,20,25,459,1084,625,35.050635788110476,4127
9289899b-2272-4f63-ae87-c28d59f19fa0,Healthcare,0.3444327686848764,11,40,305,804,499,26.324357944406643,4534
6a2522b6-8e4f-43b1-a808-c61c303d68db,Educational,0.5428340140021958,29,4,553,1393,840,67.973566135809,4635
11c7ba6c-10b6-4f40-9686-1c176f107765,Commercial,0.02373146791313896,24,43,436,1122,686,29.426052945019304,5890
22f5cb6b-7bc0-48f7-bb69-647f969dfded,Commercial,0.9601091331005481,2,22,609,747,138,51.242854423285515,2496
dd33feee-bccd-43a7-8d4d-06b6557f2b41,Healthcare,0.8228067188958291,18,48,396,1439,1043,71.38858728825089,7359
cddaeb78-9d7b-44e8-8904-9ad7473a4d76,Residental,0.5792718227267916,43,26,196,1429,1233,15.73639103097086,2428
099f02a6-e2cb-4edd-8799-d1b88a364fa0,Healthcare,0.9825615663456804,49,27,155,522,367,79.45939254226357,6435
51acc2ee-310b-4196-9b57-d38fac34b060,Educational,0.5783403997039197,2,17,367,1040,673,54.27453379474921,5063
425a07e7-41cc-4146-9b08-a57043e5b1f9,Commercial,0.4149956957101808,11,45,193,749,556,94.68191465798023,5987
84574dea-1897-4e98-a49a-8696115a695d,Educational,0.25955973261574616,11,10,279,1366,1087,52.89712155301907,3393
db44a2b6-20cd-43a4-b1de-7ed0b802399e,Commercial,0.369253802988761,20,20,28,1180,1152,26.293037546511286,5812
e49aa3df-0753-4aa4-8965-61321c003416,Educational,0.4348699701395554,11,13,553,707,154,93.42237393036078,2261
ca522134-cf28-4bdb-ba9b-d3164f8ba902,Healthcare,0.2501669518973396,17,33,220,1281,1061,14.918751688479785,4220
aff78f27-0e7c-4c80-8ac1-2fc4b189b895,Residental,0.26348780603092326,1,30,498,1041,543,11.86954053292974,3897
d7ed46d3-02cb-4709-9d8a-4c078ecf832e,Residental,0.9685998795241357,32,26,405,1133,728,98.56574208536804,9778
5bbefc0d-f6f0-4347-ae16-bac767f82526,Residental,0.8971267468437577,9,38,337,1245,908,49.9754535864814,7213
a3d77cff-1d9f-40fc-bb30-33505efce542,Residental,0.4937728253345668,41,42,484,582,98,78.79490978991271,7695
2ec3e3ea-c891-4001-808f-7dd373f966c6,Healthcare,0.6113432749101857,26,25,304,688,384,15.399985472391108,9924
90ee4ae8-6844-4218-be1e-5dc77d94d2f7,Commercial,0.674631729134983,14,25,542,659,117,52.36795103366007,7913
8499a3ca-990c-488c-800b-af46ad5c66c4,Residental,0.4247496852614089,38,44,170,537,367,24.92785323305164,8678
6fefbe94-20bb-4928-82ec-61954bc0972e,Residental,0.2931524489169699,29,14,678,747,69,16.056060422953117,8289
1fe0f1f3-cb38-45c4-a1f8-8ab58c8fe74b,Healthcare,0.963658314210894,24,32,444,802,358,97.92224935255828,9372
ae71bfe7-75cd-4fb6-b308-ada6781126ea,Healthcare,0.14929255547780895,39,43,637,1370,733,67.10828152431165,6409
c2a9e6f2-9ca3-454a-b49c-1c8f0e3831a4,Commercial,0.9023386818833595,50,24,436,828,392,10.511714938532236,3913
a5810a69-6f56-4adc-8f91-5f4857a593eb,Residental,0.3741171661768362,31,45,228,497,269,39.40786181536044,9826
9b3d8d3c-8981-4cfb-aa42-5f960a1af385,Healthcare,0.6892304818349346,4,9,495,735,240,56.34115472535095,9843
d462361a-7fb5-4336-ad78-8da906e7fe22,Commercial,0.6193086721653228,27,33,558,1249,691,20.260404681857494,7230
5223acf2-eb3a-4d1f-b271-f23be0b54e98,Educational,0.34342277377057573,50,28,375,1012,637,69.52279725235363,4262
e6b70f9b-739c-4530-978b-b7b094d6439c,Educational,0.14914481716637018,46,15,695,1386,691,12.107297215685378,6336
10255db3-de91-42bf-b0f1-3d0044ec2c66,Residental,0.12145923118651514,25,37,329,1432,1103,98.63757719301033,5026
2f7de469-d915-497e-a710-22c488dc2519,Educational,0.8658780780219547,37,19,254,1213,959,61.866062226768925,7709
ab3cec6c-11eb-49ca-9c1c-81e3ca51da8f,Healthcare,0.659235489251886,14,47,268,1379,1111,35.73619354941927,4921
628086c5-f70e-4ddf-9847-dcfdd4ade772,Commercial,0.37339964182322805,45,33,653,931,278,14.990198028694978,2127
29f96284-1a26-443a-a993-c115b6236a25,Residental,0.3596376253266008,38,8,234,456,222,47.8760122772861,9296
1b1e350b-37ad-491f-a9ad-2c54f1921cf6,Healthcare,0.09407601501010887,2,46,544,586,42,49.02893067811182,2204
f0f95b70-94b6-40b7-8213-6dc17a6b8dfa,Commercial,0.975149567320243,33,27,516,1052,536,23.294384563562666,6216
357da6f9-fa6a-471e-b19e-1204888ee356,Commercial,0.0804032302753005,9,4,295,1219,924,48.978590611021424,4336
01506329-b352-4eab-9389-6aa81f99a0f3,Educational,0.2189291971334415,3,5,637,1393,756,62.85926881090017,8327
c35bf829-909c-4d9e-bbdb-6412b6879273,Healthcare,0.5690737757911569,44,20,624,1294,670,11.762367151720937,5971
f3cefc05-cf63-46cb-a69d-254f30f2846b,Educational,0.9941246383353759,30,8,632,1339,707,63.8892673392631,5191
5e8d5b86-ba83-4c4e-9c10-2ca3f41a66c2,Residental,0.7677023522576034,4,2,376,493,117,78.5211366462495,5822
df2445ce-0749-4120-af38-5f2626f7fe62,Residental,0.3305842890638362,46,4,376,1124,748,57.044687145910295,5949
ac84f1bc-1cb6-41bb-9750-3d1aec0de69b,Educational,0.5442744393756153,36,48,223,1031,808,23.311515642748653,5315
6531bf0c-b3d8-4557-909b-f9dff1b7f4b5,Residental,0.23590621585135851,7,34,509,1210,701,94.96154200607275,3385
6675cd5e-2b7a-430d-9cac-e795a465244c,Residental,0.41211249244706694,49,19,126,170,44,54.64514606162859,6860
60a90270-3e26-4e32-b8dc-73539e8ca477,Healthcare,0.11226157052300934,2,43,306,1179,873,93.44144063569387,6939
26997ef1-9572-4a8c-ad8b-d947075b1922,Healthcare,0.4361308500225691,22,17,606,1331,725,42.24311277345584,8186
09e3b2f9-c4bf-4749-9480-b9551062052a,Educational,0.17502390946157376,2,35,224,675,451,47.06756846463291,9206
144a5dcc-f7b9-44cf-a744-386e09df9ccb,Commercial,0.22612696410130284,48,42,223,792,569,48.527989847518555,8640
d4d31819-1b96-4ef7-81d1-dddf45af3533,Healthcare,0.4688696001673679,1,37,468,949,481,49.96766364377089,8503
9d504c57-1aec-4c6b-880e-8d3949c8a528,Residental,0.06815075374146562,22,22,381,918,537,59.30528284657711,7043
2950704e-6986-48fd-a088-8adfaa451e28,Educational,0.7831182218417057,25,45,621,728,107,51.86971985253807,2261
9a38e415-1483-4237-9bb1-23f9f3e90cf1,Educational,0.8141450846150232,42,16,616,1169,553,77.30937099165837,4233
9283d15f-fe44-4db4-95f5-b97ff7b25836,Commercial,0.7063900801452961,28,1,443,715,272,76.33030844964189,4092
b251fac0-09fb-43c4-9d5b-c60a86bbd90d,Commercial,0.9633519913480512,9,33,380,423,43,74.92177760384138,7334
0edb9dcd-20db-4654-9d41-d557889a41d4,Residental,0.8795043873784155,20,37,689,1251,562,40.04795174651056,2552
3253cc77-3d4a-4c92-bc5e-75b71cc51b0a,Commercial,0.6190367491114956,49,25,19,1099,1080,84.70332911336774,3822
3b8fa79d-3347-4c5c-9480-5dfcde10e1dc,Commercial,0.5673876528344233,40,30,427,688,261,23.27596931393991,4847
158ec19a-a04b-48b6-a048-02eac55c3f39,Healthcare,0.9867310257141462,34,11,683,1028,345,42.854736101442455,7551
81452e1c-2dae-4482-87aa-e60826da4d67,Healthcare,0.10180625823689093,2,46,635,811,176,99.68141960557156,1058
596ca260-995c-41e5-9973-e1ae571e01c1,Residental,0.5407512124162092,3,27,461,748,287,70.36216453790527,1638
7a3c5bd9-f153-4b86-9cfe-2174692832d9,Healthcare,0.29010774012913887,16,11,85,460,375,47.71456784539124,8108
9b6b17bc-b9fd-4ca6-89d7-26d61a7ec92c,Residental,0.7170886413348634,36,18,208,1340,1132,49.38131488420395,5542
7273a63a-b3a3-4539-86b1-e33e00369e75,Commercial,0.9205686924917745,11,19,433,843,410,62.40457010090297,6851
6d4a8bf0-c096-445f-ab32-fea57b26a128,Commercial,0.2708458691989054,2,43,71,1225,1154,36.87241424164878,7147
a483928f-38cf-4892-96ad-73c1f6f5c752,Healthcare,0.025647754662382893,30,39,611,1402,791,23.857987932567475,8459
99976cc5-92fb-47c2-a246-f50d39bb73bc,Residental,0.36875378266997716,27,15,531,592,61,26.627483801189136,9506
f11afbf9-d238-4bbe-b72f-78c8aab58c69,Healthcare,0.1915653631407841,41,20,553,764,211,14.875256285571657,7849
49cb9b34-7e03-4186-85aa-8b1c16e1a39a,Educational,0.7622493269151266,16,30,626,819,193,82.69869331285553,2228
f3df207a-f1cd-4373-ae6f-7f21622b1d90,Healthcare,0.8987840992998448,49,41,438,1092,654,51.37060690768292,8493
16d0a954-a66e-4e71-bc28-a5da6853c08f,Educational,0.1942875289044762,50,24,267,1000,733,11.189269786398727,7082
ead62a8a-cece-4e45-804b-cd3182a5cb2c,Commercial,0.39040004323462874,17,7,360,743,383,59.331076697930094,3906
304ce189-5f9e-4d57-8bda-33fa3acaaadd,Healthcare,0.6201166835335401,48,8,103,520,417,67.18670344272059,8629
affc7aad-7992-4365-a61e-e4e05230d2cc,Healthcare,0.14685753144370617,10,15,288,416,128,68.79989085539864,1964
c246ad14-1064-430d-8363-49093dc0eb69,Commercial,0.29652838057521347,38,38,653,824,171,51.45828709256823,9781
f77466e0-ae0d-48b1-a5a6-4da5612d32db,Healthcare,0.3340609909712501,38,49,232,1076,844,62.94938097737553,2529
3423789f-8f7d-4a40-9c92-942e44f47b72,Healthcare,0.3418327950890575,27,2,261,357,96,36.95231696676461,2613
529bcd2a-91a1-4812-a43b-f88bf23a4d3b,Commercial,0.8538487766323986,32,24,28,51,23,79.89197886194093,7528
ed501ae2-f320-48cd-96ca-73d219b0468c,Commercial,0.7425809146051007,28,25,136,1389,1253,90.56339352784377,6252
7357face-68e8-451d-bb25-14508a7112b5,Educational,0.7818920168548856,10,22,89,765,676,77.42190319242505,2418
8b3c3639-cbfa-4095-8a59-2caa4487a771,Educational,0.6836506490614591,32,1,332,1373,1041,55.476521350367626,7991
caec376c-6a87-4eb9-b480-2081528a4cfe,Residental,0.6103264387771753,46,17,635,1100,465,43.16664852997962,5928
9f0f3c4a-ec3d-4857-8aef-ec59d18dbc57,Educational,0.9431857074587741,30,18,434,773,339,83.44441658739137,5140
751edd82-eeab-4602-adc8-0170596e46a7,Healthcare,0.270769673976345,13,49,425,669,244,21.02365709252887,2823
c0846a6f-f58e-428b-9f14-2bb86ddf0ee8,Healthcare,0.9497744904512929,8,32,472,1104,632,63.424215801824104,7413
9f62ae0a-e883-477a-bd3c-ac28d30839ba,Residental,0.09988569805385705,44,3,567,903,336,89.71502859215367,3055
456b9b62-f672-4598-984d-4098e3e7c00c,Healthcare,0.2946951324718058,15,49,154,1439,1285,80.14003423764115,3029
2dc1fae2-4d4c-474e-831b-c8b93b68a901,Residental,0.6891470969395778,47,42,237,908,671,74.77755923593013,1166
59e61fa8-bb5b-402e-974d-2f5b666b0fc5,Commercial,0.033264978061403494,5,42,468,753,285,71.58997221302684,5694
2e8540a7-a225-4865-bf65-4a608ed62524,Residental,0.3933208147422421,31,5,524,857,333,19.10900363064205,7405
51304246-956d-43cf-a3ca-67ad2e8033d4,Commercial,0.4540820074514532,11,23,91,1063,972,99.5002450445196,1861
204cf1ec-3255-4f95-b99d-f66ddbcbcf8d,Healthcare,0.8571743612148323,30,28,525,1425,900,26.298442698151565,4412
32a70311-0d36-4e23-a3bd-3a35dad3b932,Residental,0.5601880743189773,40,29,674,1202,528,76.51422595755186,6569
172c6b10-a570-4599-a8e6-2b0a3026dcef,Educational,0.6596864864582426,42,39,454,821,367,66.00675097108554,3449
09c1fcfe-8c24-4cc2-9091-739be15b7f41,Educational,0.8705514655981859,39,29,328,729,401,89.72506840718988,2832
f6919cd8-3bba-4c23-b4b8-86517ebbb19d,Educational,0.2142291781191037,45,44,636,1111,475,18.932442937694773,4170
b41d9433-c260-4003-aedc-b9b89b8701a6,Educational,0.5363812495450986,26,10,21,619,598,14.864117040425691,7221
04b412e2-a4c5-4d9b-b261-773f15869eef,Residental,0.56329053995544,40,36,515,1327,812,98.15488265764914,6876
3a0938f3-e3bf-449f-8a1c-f0381734841f,Educational,0.7842702866087203,36,27,628,890,262,23.869013855489527,2548
fa81a7fe-1239-4619-998b-9e6f7e8d68d7,Educational,0.39073410725205604,36,12,162,1126,964,53.500614321484726,7755
8944fac0-c79f-4621-a7da-524ba15cc482,Commercial,0.3710400293710383,28,18,336,938,602,60.52099616606829,5148
331c6b18-905f-495e-af22-55297a672cd7,Residental,0.7708782357536552,19,36,132,1028,896,19.417026143048048,8862
532e6f9c-9661-4295-9be0-499c9e4143ab,Healthcare,0.03068697609878801,9,32,459,1301,842,63.21867136269171,7718
a1423a77-999d-47c4-a4e0-fda897f7972d,Healthcare,0.8807973886059288,5,44,30,878,848,52.6982498592914,8586
4da45781-e05a-4557-bb21-85bf25b3ade2,Healthcare,0.773193247500833,41,6,469,1297,828,43.63176974117109,6122
780b7af8-23f2-48b5-8566-be72fa19dd85,Commercial,0.2210010167720079,42,45,580,759,179,35.27222071132293,9634
397c8760-69bf-4233-a46e-f7055eb61d6b,Commercial,0.2658925208379611,13,19,59,288,229,62.29277910160531,2874
738bc7c6-4ae9-4f30-83dd-b4f0580eb819,Healthcare,0.9153466892979076,47,35,21,147,126,50.478272122624055,8077
20f60ff2-3fc0-47c0-9a1c-a84dc201c992,Educational,0.10953829021678463,10,15,227,1427,1200,15.895944853108324,4543
3bc4b6c5-8143-412f-af9c-ebaeeb60fd8d,Commercial,0.6422452472140113,33,49,509,1102,593,78.19274470996923,8428
19ebdf77-21ae-4bfe-8d8c-075bf3fa121b,Educational,0.40808814662413806,3,30,637,1369,732,32.99559431606549,4388
9212bc05-eed0-44b1-b8a7-1e8b1703d0c8,Commercial,0.3396209662440066,4,15,640,913,273,23.16393031363711,3421
3c39f688-779c-49ed-993f-f7428cae29e5,Healthcare,0.8108357700332793,50,11,438,1170,732,53.83862547875905,1746
1af03b93-93c3-409a-9d28-5b720d7beddf,Residental,0.8562974624445511,30,37,131,213,82,41.02336764937657,4789
740f15b9-d91f-413c-966b-b0d14d984b5e,Residental,0.14163828973297,1,2,278,378,100,89.76195065050146,7631
0e2840e3-cc39-4276-ad10-2fe542b065ae,Residental,0.08661468425170493,14,36,112,522,410,52.875414615227925,3058
ca13b3f8-655d-4231-9a20-a3613b6fd2d0,Educational,0.957797380583789,1,26,31,165,134,84.72715766013422,6847
fd5c558e-883d-44c3-9708-0255abf6de41,Commercial,0.4039072467105761,27,45,381,962,581,62.334634911405296,4060
6a38f9c8-eeef-47f2-bb89-84bc6168ff20,Educational,0.8039866632376665,44,37,423,946,523,61.01169721094456,9804
7a03b072-3898-4ad6-86a9-d4328aeca038,Healthcare,0.2859695184112193,31,12,311,994,683,50.03397730840594,5279
6f980d33-7ce8-4d57-a173-aad217a587cd,Educational,0.9051148518645309,50,29,85,819,734,53.828808879654545,7254
c9cbd436-db2f-4bbe-b6fa-bf9166dfaa7c,Educational,0.10137478267941391,13,48,240,467,227,65.82917216959919,7348
e2b6c0d6-9102-4edd-a94f-7fb1a68e1a6b,Healthcare,0.07533081659052687,24,5,350,1183,833,42.27831174713033,6643
8709984e-f447-4475-a205-998d32016a15,Educational,0.501771507701176,23,7,574,863,289,77.74984669427323,7592
5c427ab0-9214-44df-a648-7e3d23001550,Residental,0.38328314479709336,1,30,575,763,188,58.674991839591854,3214
9683265f-8699-497f-a45a-c4d85bafe1aa,Residental,0.2535013090575885,49,24,162,1384,1222,93.04768346318674,4833
f61436b8-5544-44ba-84ff-e7ded82b7587,Commercial,0.47765495714498807,11,29,633,1030,397,72.98060617014487,1336
b8797509-d51d-4ba6-a665-8b81f0411403,Educational,0.05861427223979754,47,29,458,887,429,52.26377210454931,5193
e2438b60-0b30-4dee-baa3-2ae52cd2b426,Educational,0.8461709752709806,48,25,335,675,340,72.3635347472079,5168
dc4b46fd-4e7f-4448-8c95-303d7888f69b,Healthcare,0.8756163377578274,5,18,505,1308,803,72.95127277161399,8452
8b275d54-3ce6-49be-a306-fe5b5a7cf41e,Educational,0.9272325705177862,7,3,475,578,103,62.51858184305224,4050
521199cb-f2f1-4b6c-862d-5824259990f6,Residental,0.44519061435151475,18,42,385,1249,864,11.169676274882478,7315
8c3622e3-3a67-41a8-baec-72b829f4112b,Residental,0.727391062371435,39,31,75,952,877,53.59473846591582,5721
4a357542-e6a9-45fe-872f-03514796b257,Commercial,0.19731045946356685,35,39,384,1004,620,33.2843246162037,7537
4b7e0269-3d8d-4a30-b583-1f79cb65ec25,Commercial,0.47396744462233065,13,47,455,863,408,94.57989100123596,9576
f6ea3756-dade-40bc-8a6f-286cf69f726e,Educational,0.10832956044074082,47,40,212,214,2,89.75480009724096,8447
7f7f06db-0829-4f82-afb9-080872495d8c,Educational,0.5213560900563283,24,22,336,1340,1004,27.203627833868254,7398
2361fc7f-aaf7-477b-bd12-8dabb74fd5c3,Educational,0.5708800435830972,44,50,309,377,68,14.922059734779705,5402
8d98eeb5-cc1a-4e07-aba0-e9326422c117,Healthcare,0.9908493917850406,5,26,417,1338,921,56.7823041434223,1957
0b489787-5721-46c5-9fe7-a6fc2e3fbb4a,Residental,0.5615599483467016,25,12,625,625,0,99.26112528330606,9436
1333d7a3-223b-46f4-8c03-e02db0acf1e4,Educational,0.8114653096313013,39,40,245,499,254,85.81797990638923,3968
6ddedeae-bd14-490d-9ef0-64d332728731,Educational,0.5529741449791049,26,43,4,849,845,52.61887293057329,8314
5152218c-417e-4543-843c-b0fa1a8fedcd,Residental,0.4130585960438583,46,18,718,1203,485,73.19084841017083,9997
e52b56ad-44e5-42b6-a891-409fae144775,Residental,0.26885024052052153,48,30,337,398,61,93.45565377614808,7643
f0aebf6e-96fb-4e89-acb5-d76127e93b04,Healthcare,0.008076347226476543,48,42,479,591,112,98.82684198869848,2095
64e4b288-910b-42dc-b796-218dc7a57ea1,Commercial,0.00012096557207919023,35,26,17,1280,1263,92.81994956231453,9514
6ef38b78-4dde-4cd1-8fa4-441e92313e6a,Educational,0.09904729867463113,46,13,222,1039,817,39.3929881506141,1891
55e44182-c0f6-45a7-a3bd-dff5d899a3cf,Residental,0.03270531730625137,6,32,673,766,93,81.37401909830244,6925
7ba14655-d81c-4449-a80d-72981b726b0b,Commercial,0.6108592133619315,8,32,479,1009,530,31.753811295168987,2705
06855c10-9710-427a-8e5b-fa71992155cf,Residental,0.6533366032460979,45,27,560,908,348,90.52770452499888,3102
78891f4d-1065-42e2-ba75-1572caa1a54d,Residental,0.2808570303742527,28,15,114,1114,1000,67.79194192251892,1914
d88db7cb-e6eb-4936-8b84-40517c7670da,Healthcare,0.5286013406997663,44,36,25,1295,1270,53.25391246596773,5122
2d572026-2d3c-4440-8b5e-a776bdacb3ac,Healthcare,0.2965272794101198,6,49,399,1016,617,99.57365736415116,6245
381c5ad4-af14-4204-827d-de0dffac8b78,Commercial,0.5077976293359595,33,8,709,1117,408,32.41172301144513,3345
1ca45c46-9521-423c-9fd0-87999cfe6b84,Healthcare,0.42795917470691214,43,15,225,962,737,81.57749545883736,9681
cfdfe525-cc48-4077-8027-cc550e33b01e,Healthcare,0.6361230778638368,9,40,453,931,478,26.07784352790803,1334
a86c7338-5551-419f-89e7-25c94b4bc60c,Residental,0.44532915772550385,6,3,72,1414,1342,66.81924711816936,8468
07da1c77-e080-48e1-9547-e48c34f32ac7,Educational,0.24357472730434182,1,29,17,405,388,94.34250445960069,7969
d6158b73-eba9-4f1f-82f2-9621a4e0d21b,Residental,0.5754071514914765,23,24,41,45,4,80.7092253037902,1782
45ee46c8-44d3-4e3e-beb0-1837f4a69500,Residental,0.2813408570990855,4,23,420,990,570,99.84893117730456,7733
0ab32dea-04e3-4545-a204-c1201635aae7,Healthcare,0.5108430925544477,42,39,350,590,240,59.87567069155337,3202
f4e4702f-ae37-4dd5-bc86-d0b1a5b46b2a,Educational,0.16921811845572998,14,19,184,1336,1152,31.277422248991854,2710
f0ea0916-13b3-46b3-8824-b4c29519221b,Commercial,0.3011121910558595,31,32,385,787,402,91.38049284056227,8211
1dd08e94-f564-45ec-97fb-c7b500caf308,Educational,0.7672462102251864,21,50,230,665,435,86.26201869039129,9289
59b62e32-ceb2-42cf-8283-d7f74b06d9a7,Residental,0.09639366636590041,34,7,2,424,422,25.149770609671158,5018
67c19549-13ff-4b01-aade-daebb5d076d1,Commercial,0.9908816731289865,33,38,656,844,188,56.5984252731844,2261
6017fe5c-56aa-427f-bb9c-d4efeb4b55fe,Educational,0.6519860159381785,6,23,597,987,390,58.041463144662906,4043
2b0f4332-2893-4bfb-84b4-de8645a8aaf2,Educational,0.9025071340988579,21,11,121,270,149,72.24375853408866,3976
88cbce0f-7228-4a38-8f42-f77e399bbdf1,Educational,0.8445144893844981,13,3,387,699,312,84.86115024531883,9404
e0c82261-e1ae-4b12-91c6-0595109eb568,Healthcare,0.8145349916103379,8,42,432,792,360,23.37335095304888,7448
eb760216-e648-4592-9177-9a0f2504b254,Educational,0.24004204257600514,35,46,346,1113,767,36.64955501595703,6786
93969087-114b-4d31-b44a-5665fa9d88a7,Educational,0.48829280285815235,7,41,374,1083,709,53.43880910409947,9601
61cf91dd-740e-4b2d-9592-04863ad9965e,Commercial,0.6418855143275751,23,30,566,1106,540,65.90308273357124,2490
f7418fa3-55d7-4d3f-8211-9044888676df,Residental,0.055167670286756954,32,17,657,1399,742,84.15177314129467,8221
5ee5ac01-e798-4df5-a302-1e552c284c08,Educational,0.9724800676087726,3,45,73,495,422,58.140252096768556,5940
011e32a9-f432-4503-9911-d6dab9655116,Commercial,0.007566730543619227,35,28,133,467,334,70.06779541479779,4931
85821a3f-4319-4527-a756-68731d504b39,Educational,0.4825568397750759,20,49,183,1366,1183,42.78232902226886,2022
7b40aefa-1752-4485-b436-5ec18523e028,Educational,0.2185128912165919,2,44,452,1106,654,35.99698724173122,9425
b4609cf6-272c-4e28-85b2-988dc385db25,Residental,0.25849148113263887,23,33,283,1422,1139,57.86923441019565,6273
b082a60a-8b11-40a2-9265-5b356be0e6ee,Healthcare,0.23116726052816927,37,50,588,1421,833,14.333009536968005,5422
fcda2f2d-7188-42b9-8680-74475de36a42,Residental,0.540693445546763,21,29,636,714,78,25.78682994022996,3566
df28586b-ef04-4d60-9b3b-5e6161645fde,Commercial,0.8802101095972983,44,24,450,998,548,52.42519234304121,6598
8f8fac93-0adc-4d6e-adab-5ef5bd130085,Healthcare,0.34044087059269657,2,2,1,842,841,90.851378146362,3357
d0bb35c4-5ec6-4fa5-a314-c4138a7525d8,Educational,0.3887834916818178,45,48,707,1007,300,45.54265912993541,5794
f5a77e6d-2a71-42ef-a400-b8acaae4fbc6,Educational,0.2592883461266531,25,46,648,1166,518,24.506408147202436,5626
5550b21d-d01f-493b-ba8d-d9331741fbe6,Commercial,0.31239461165029636,1,45,139,1172,1033,95.63372761355863,4129
2bc206fe-bce4-45e1-b3a4-5e8c5044dc43,Healthcare,0.3233980802644152,33,32,650,1214,564,20.617482758468952,4045
f6b47fb4-4156-4987-ae19-4314725bf197,Educational,0.2571268475447306,1,33,717,1159,442,52.5212943987664,5597
e4f3d381-f9d5-41d7-af16-98f6355750e9,Residental,0.6534392037843356,39,4,548,600,52,90.69128474676971,2047
fe27751e-6f22-40e9-b9ca-760bcee103a9,Healthcare,0.9341662509301512,12,38,255,633,378,22.357733544631287,8876
c4619739-8864-46ba-a4da-ca4cdd05c0b6,Residental,0.009691826052720676,48,49,24,139,115,15.036138286145722,6922
ef49d050-ff71-4816-bf6e-47ef006a1884,Commercial,0.08807206769864895,40,9,104,604,500,56.87997240576406,7563
b1c8b95d-11e5-43b9-af74-37ed3cffae00,Commercial,0.6856279364442314,26,4,334,788,454,56.11796191000421,6331
f81d15e3-39b5-4133-85eb-9d26ee794cfb,Residental,0.3235660666472202,18,4,5,447,442,38.662166058929984,2978
262de332-8235-4e61-bbf8-248d3b4c39b9,Commercial,0.2679155000033575,49,23,617,911,294,85.46956285767727,3736
259da1eb-bb17-404b-886e-444d95c25bca,Educational,0.39011635895261154,31,44,464,835,371,24.395405780445525,9400
687aeb8e-b76a-4d0b-8402-e2f4a17579a7,Healthcare,0.27539276304585536,50,26,624,725,101,51.34236259301468,6310
27f13cf2-1d6c-48b7-87fd-7a4ce43a055d,Healthcare,0.864763505939258,10,23,26,1037,1011,69.46275677874264,3961
511b2f62-8101-477f-8b71-2336e7c22a83,Educational,0.4401600981068555,21,49,205,1357,1152,47.67271216481562,9883
1c49598c-d4ca-4c2a-abc2-e09630b41861,Healthcare,0.45785658266393403,15,20,143,1078,935,87.6709753382382,5117
197b9984-abba-4fc9-97dd-14537f255992,Educational,0.5695478220267794,12,12,422,937,515,29.118689991249024,6302
edd0c0b0-e813-45f8-b2f2-cc455da6158a,Residental,0.03839149744136505,21,18,292,914,622,53.78752822481046,2982
ea0b577d-5e09-4234-be0c-e7624631130e,Residental,0.36167858670967623,21,19,552,1071,519,53.535271160369874,8708
aa7ad388-b9ef-4d4b-ba29-a8824caf299a,Commercial,0.933579004732336,16,37,376,930,554,26.08527650007325,9202
7492ff36-e3fd-4b19-948c-c14dd8913fb1,Commercial,0.3233815848791375,5,48,347,1118,771,82.01375470753065,9592
c56238c1-7d1a-4d64-b2e6-cf34adac4825,Commercial,0.5534702697232824,47,39,423,537,114,33.39539454097924,4611
737ec5a7-ca8e-408a-aab2-6b4ee7e5181e,Educational,0.07386767863505983,12,15,153,887,734,53.25216979615017,9629
ccd87164-fc36-4a77-ac27-1b4db78c8848,Educational,0.6680193357572021,17,35,710,1385,675,99.98824625757756,3579
a28e688e-c263-47b8-9330-ed35dca25c32,Commercial,0.38892111997801004,20,30,147,1151,1004,66.49755525292619,2612
0a86e667-e8a1-442e-b46f-7d32582c49e8,Commercial,0.14399562390552723,25,37,55,1030,975,50.15893636997639,7256
900fc38e-a4c4-463c-8eb1-49c10334a41c,Commercial,0.41102476969782953,43,47,663,692,29,14.925395592724568,4838
25e0ca31-44c9-41f5-9b04-f49f7f15535a,Educational,0.20258248631689957,34,16,672,891,219,60.10173584002845,7183
c3410d1a-cdb4-43c4-9d10-151fe7bf8b85,Educational,0.8968595658559577,35,11,391,1041,650,24.17373826383691,3849
1818e984-0d5d-4a96-9978-8a2f42b03095,Residental,0.5126859376957353,37,20,531,1372,841,41.66190010396447,1048
4804edbd-d9cb-440f-9d92-ecaa8ed8baa9,Educational,0.6612715315580336,42,34,180,556,376,42.12893927592679,4367
ed59fcba-b347-4ab6-ac28-3fe30e2504e7,Residental,0.037351940580933274,6,14,426,1021,595,58.648637635140894,6656
42d68bda-8daf-4b70-8f01-12334b4bc908,Residental,0.7304785999006063,29,43,332,1377,1045,17.326305318614164,8469
e2189b60-42ec-4bfc-910d-8b164075b7e4,Educational,0.6199744187151288,46,30,487,751,264,46.74506191379341,2798
14dc43ac-b6c0-495b-ae80-f4c3df620d1b,Healthcare,0.589289316975957,42,30,646,889,243,82.02786726889302,5788
ca1b4954-1735-4fce-89a8-25125cad4b4e,Commercial,0.9641845197122881,5,30,452,865,413,31.96611838046539,6660
a967dec6-104d-4e6b-a2ac-bfae320be68e,Residental,0.6392331125584997,12,41,129,688,559,39.837449894960386,9539
33404a7c-1fea-4b3c-9b2c-c7e5d80f5f28,Commercial,0.3910145365041302,17,31,639,1377,738,38.877518009468204,3812
70e667cf-846b-4831-bf10-e5ecf2d4005f,Residental,0.07018200301317734,11,17,235,488,253,27.08057560516029,8041
4c461fde-d1b0-4bb1-bc32-b9e63c38e91c,Healthcare,0.42483551445397116,46,3,210,1406,1196,25.28581400466586,4749
be377839-e1b9-4975-8db8-0353fd54ed3f,Educational,0.46325529813335764,9,8,391,923,532,90.88441036086995,3374
b7e1a397-1922-480a-8a00-8f8bf069d243,Commercial,0.722345796439882,5,17,464,700,236,61.433319309678986,5443
ef08bfdf-7610-4d87-bbf6-dc40787bbc87,Residental,0.02589017069630084,42,47,566,796,230,33.36223807820326,8743
ae93fc89-0d84-4bc9-a502-fb28c70dfe32,Healthcare,0.44967281405215387,36,1,663,1046,383,48.437507395122935,6448
28aaa5f6-27b2-41d1-b88e-9a77aabb84d4,Commercial,0.7219358249294464,27,18,361,911,550,48.849239529912616,2274
a096e6e2-4557-41a0-9768-9fa313222873,Commercial,0.4844178093469218,40,40,269,1046,777,97.44402023873425,4620
515906ac-b19a-4f66-956d-a27bee1eac27,Commercial,0.04865812213602505,17,13,306,931,625,64.00948062229932,6067
6a14d542-7ac2-4035-94c0-5a515a533de7,Educational,0.37113486407700746,21,36,626,1348,722,32.84278333149548,3789
9234d292-ef04-4128-9c04-d1e85a811854,Educational,0.30989952760105377,14,37,402,1391,989,54.2339214861175,6688
daea44cb-b9c7-4bc8-88c6-a564345a08a6,Healthcare,0.7126827772385131,14,2,200,233,33,65.78520627146504,7720
37b39aa0-395b-4914-bfe1-0c9789cef075,Residental,0.48847089816515343,5,36,615,880,265,20.509675389358762,4243
301d5895-d698-45c4-ba95-7beadf4ced8f,Healthcare,0.3587791332945808,41,47,371,1388,1017,85.32255693652455,1588
3726b046-a494-4053-be1d-6ca5e9ee3eb9,Educational,0.05009876833835114,35,28,590,795,205,26.138494730399565,7922
af9bc915-5049-45f2-a14e-c2bc20166bfd,Commercial,0.001443470914213596,34,15,569,1406,837,25.477406100545775,5339
233a73c9-6216-4fbc-b6e8-8e9964b61c5c,Commercial,0.41682902228746044,11,1,492,847,355,55.56225511580317,9091
e4ae7b3c-cbad-4086-ba9a-f2005fd48c49,Educational,0.6250945724580004,18,19,182,625,443,35.09200701038297,5530
bfddb9ec-2efe-402f-9d4b-a510b34c1591,Healthcare,0.6716037776252209,7,46,655,813,158,68.26053974569629,6777
992f87f5-4895-4df2-9727-2dc70e1c8291,Healthcare,0.9196552105472741,7,11,577,750,173,12.723878807314652,6773
c1d90782-810c-4d0c-98f5-ab1db533d893,Commercial,0.55806339679864,15,9,245,1277,1032,16.389601824823266,9618
b7b2c9c3-b0ae-4fda-8366-eb5a49f09445,Residental,0.7959510845219627,41,8,183,349,166,78.20799422431875,3491
8506caea-7f60-4e94-8f1f-1727306b1beb,Commercial,0.65619689029858,48,32,505,1378,873,21.082182332216913,6183
b1cbb950-4ea9-4f7d-9bd4-0d5a399f7d0f,Educational,0.7454183530387796,12,22,435,611,176,31.545825530557384,5236
02783ec1-a9f0-4ad6-a1e8-f8c8c345b8c9,Healthcare,0.12865399835497004,9,2,509,793,284,78.99679725056346,8065
c5e79245-325d-4e9f-854d-4a9947c71218,Educational,0.8579579916640554,42,43,12,458,446,35.80291657795819,1066
39d3f8a5-f863-43af-9585-21ec75545984,Educational,0.8649332651662394,40,47,326,348,22,47.0860599798576,6427
00922c88-8f36-4ab8-ba21-7a7a51839ad1,Healthcare,0.9627789036022655,44,32,255,1252,997,72.58465896442536,1735
eae45074-4faa-4a85-bd0b-b384c57cdc96,Healthcare,0.162794085599559,5,44,348,799,451,77.7383871074981,7114
657eb155-48ff-4bad-b5de-7537a955ae0c,Commercial,0.8690429949638785,48,12,238,543,305,88.82151949810668,7495
b55fae0a-28f4-4a3e-b09d-31ea6c7a0363,Healthcare,0.31496598528420006,8,42,326,666,340,81.58455568932735,4811
6dd0929a-7234-41be-963a-c2937cb6a6a4,Educational,0.4001015379011601,41,27,61,161,100,33.75233025420117,3087
2fc7844c-7b2b-48df-ac44-3e1e52135270,Commercial,0.21875150348968497,29,28,35,607,572,78.11573889932802,3845
dd578768-cf6c-4cc7-9644-c798e8b2d6f4,Residental,0.17710347893161893,21,27,192,725,533,37.043991270388,9705
16d4e7fe-c2d0-4146-9b2d-e28796634416,Educational,0.22955665727262886,30,46,194,531,337,22.710231205212835,9947
65d96396-f707-41fc-afe7-4f6d1dcc3015,Commercial,0.015919455114485337,36,21,543,589,46,63.74004750137373,2675
b4352fcb-281b-459e-8957-874d1b8d3e90,Residental,0.9402352581576883,17,40,72,571,499,88.80253115696878,6071
121fd3a9-03f1-4530-82aa-152dcc8db512,Residental,0.9732810323264154,33,16,157,463,306,83.58952694659034,1275
c35f6fc8-16a0-4155-94d1-abe417994e3d,Commercial,0.23517120752291876,36,33,343,490,147,47.9202126465073,7450
72c2c6c3-0cab-4cc7-9320-94f6fb0c1814,Residental,0.6698765604357313,26,13,277,1155,878,14.94219946478492,2980
25d3448d-8e21-4b34-9fca-bc6ae4a28233,Healthcare,0.656853581397312,3,45,305,1073,768,98.7056377125847,6071
760cbf27-f39c-417b-b6b5-4ac4e207f364,Residental,0.15112836721218315,13,23,645,1139,494,93.76428789270295,5257
a30b55a6-cb18-4c38-8073-1dd72419002b,Commercial,0.6194321970289131,29,17,667,1092,425,51.780013514914,2502
a85ba0df-190a-478c-899d-394bd7975d62,Educational,0.6075710055619173,50,45,370,452,82,10.803769883293251,7267
a2308702-feb9-490d-ae16-831bfb57b71a,Commercial,0.3753588345464628,28,32,576,1358,782,56.27588404888675,6686
6bd50ba0-25c8-4f73-9920-d11f971870b7,Residental,0.3341671235598628,18,32,88,455,367,50.836901663859756,8748
ba778dc7-facf-444e-afe6-e3ed9828bc78,Healthcare,0.5892578136035793,15,33,577,1004,427,19.972542114454217,7046
613b9a3d-ae24-499c-ae72-f2ea84d711c6,Educational,0.5363831854720477,31,3,84,985,901,10.885239498249476,4593
162ef24c-9300-45fc-a0d8-1b048fa2a6c1,Residental,0.5052279988881134,45,10,190,950,760,17.74274537022634,1839
dcc01678-6e87-4802-b112-235a2f7b3cd1,Commercial,0.7865364800802445,14,42,178,855,677,15.917149299850697,5819
ddd0a3a3-9d67-4a28-976f-259853e9a72a,Healthcare,0.40699446298230735,18,15,356,478,122,70.16407608717769,6656
2d25a410-e130-42f6-9c58-b84bf35ca008,Educational,0.4924465223616432,43,3,429,1368,939,57.252230719895046,3884
57124c6d-5376-43bb-8cbf-25f1d45dc0ff,Residental,0.12320691273990203,41,7,419,1177,758,28.419520285501015,6501
b5daf381-860e-4b0d-ab7c-5845f5dc2e61,Educational,0.013756277933879346,13,26,134,867,733,59.2140310311626,3876
06a86177-6601-46a2-a678-00450773e573,Commercial,0.6164180232535094,17,44,437,1383,946,55.7696885620511,3327
4fbca4e7-419e-467a-bbce-a886cab081ad,Healthcare,0.797235337666188,49,43,555,696,141,56.316033267346505,2117
7abf96a2-864f-4216-9351-bff2e8deead2,Residental,0.7998502100981277,12,8,439,1059,620,42.60979067696452,7943
4aa1bc73-6977-4097-a6ef-2c05e085c864,Commercial,0.16116986467589856,25,5,528,742,214,43.61370265596058,8678
f5286e21-460e-4f43-b2e6-147abe19166e,Healthcare,0.3138466064233657,31,17,687,1252,565,54.60173420270198,7616
edcd9748-a46e-44a0-9e0e-f83ea5fdea2d,Healthcare,0.6686672395224357,29,18,420,1371,951,56.63651530561223,1329
30356060-fd94-4541-af3a-04c2d30d22bc,Commercial,0.7571439708489156,19,22,395,1156,761,61.536079172447494,3250
78df835e-c8b9-4bfd-a016-40d2534fb65a,Residental,0.10494332077526769,22,22,94,515,421,67.24616483223518,3798
54aebfe5-09f9-4798-a76d-3eeb2b33cdda,Educational,0.16397356776281025,4,12,457,631,174,20.436261088010625,5302
d7a3be1c-4e1b-4827-a47f-e18e602eddcd,Commercial,0.6023948464673438,17,4,624,701,77,71.32210107425297,1425
7cad1b75-a24d-4d16-909b-62045fac7627,Educational,0.31085369672253027,41,27,91,130,39,62.582113460914094,9113
3def333c-d3fa-4a96-9386-2eefbf4e214c,Healthcare,0.8237371931729994,46,44,718,821,103,57.58591059310086,8456
597087ed-61df-49a1-abc7-ec72340328c0,Healthcare,0.6394334227852102,15,21,440,1347,907,17.770020102442686,8441
9ff951e1-8386-4254-bdeb-daf4d3545452,Residental,0.3099312108266232,28,23,706,721,15,47.97344441280261,7213
b0f899a9-4299-43dc-aed6-e40458b0894a,Educational,0.034533317769434246,40,16,156,1099,943,12.923979601132846,4317
3325f01e-b6bf-44bb-9582-4445bfde552b,Residental,0.4038599522243207,17,32,319,1001,682,97.8886489866039,2994
70a3f869-9129-40f8-89df-faaf27106b4b,Residental,0.7268383377273101,33,29,251,751,500,38.52615096802347,3058
24968e8b-7095-4dd7-9a5e-fa96354757df,Educational,0.2330016993897316,49,2,193,663,470,30.492742091713545,2589
18274a04-2000-4cbb-8cce-b5a6e2a3968a,Commercial,0.9639111924956929,47,13,60,1030,970,10.188281965093417,5586
235d8905-910b-40d9-a29c-389c28871ba7,Educational,0.35352652586842515,2,44,520,997,477,53.65460152730288,1766
c1309758-5cfa-4ad2-b595-89c7cd1c57c2,Educational,0.6410339247550179,49,4,402,692,290,70.53192289356988,5232
1711c115-208b-4feb-afb2-8554b2ae250c,Commercial,0.15837619511186662,26,25,556,719,163,22.926520537748583,2465
1fbb6e71-8130-429e-ad88-def8c1db8f5a,Commercial,0.9419761185944118,29,23,387,479,92,40.52572647227822,9097
63abba1f-f008-46e8-a7cd-7cf79b73deaf,Educational,0.1894709976167709,40,18,447,487,40,61.303798713422665,2003
9bf4c129-f7e1-4fe0-b2aa-8b8ddfc03b8e,Educational,0.919505670604542,17,48,352,1219,867,26.180970359526793,5666
2e523355-9aca-4ceb-9d5b-dcde4f9529a3,Residental,0.4079978834012168,24,18,673,1208,535,32.95529798603444,8334
6b0ecda5-ddef-4051-a4a6-82804ef5d47d,Commercial,0.6900904924250593,16,8,310,340,30,39.4396357346584,3901
6b758df5-c048-4a69-84c3-6ac8481352f2,Residental,0.8367385040815063,34,4,331,404,73,12.75754267935492,5750
5111bd0f-d548-432f-b7ca-f9f1931c9676,Residental,0.3823855714094838,5,35,583,1408,825,24.76719779513284,2850
fb167322-142e-4e1f-add3-baf5b17c8bea,Educational,0.35504308523500683,22,50,426,760,334,87.55033312425283,5932
2877a042-f8b0-4b75-8bb1-fd4e24bb1ffa,Educational,0.48694705327178966,14,2,174,516,342,68.68369022520847,2917
e2ab5149-43e0-4811-9560-6fad4a092dbb,Educational,0.5652562969886533,32,21,82,1319,1237,78.11347750431607,6383
ece44b6c-280c-4312-8c40-3cdee8a7b0e5,Healthcare,0.1646384682638511,5,6,638,838,200,10.482277090204411,8887
7c704142-ec86-4163-b3b6-ce5727f0cebe,Commercial,0.5558044583410973,38,16,239,658,419,45.27758009974532,3862
e2af14fa-ce95-4712-b98d-148f930bf59f,Healthcare,0.4603935597702248,50,2,402,814,412,12.732485254828182,9294
3197e806-79cc-4b53-a901-25293c7ab2ae,Educational,0.4209025487244792,34,28,400,1099,699,72.83461022500435,1636
ac298c13-97f1-4197-a993-49152e50a886,Commercial,0.57274275175935,1,50,640,1402,762,37.16265098576132,6812
30087226-51bb-4f92-b3ad-3c40a30e358a,Residental,0.3274835563992732,8,33,534,675,141,30.33060452322756,2886
67b93b4c-b537-455b-a2b0-8d1caac27f4d,Healthcare,0.1784265236556858,19,35,54,552,498,27.675535915435812,7067
9a6fc99f-1bf5-4ee1-acce-ad8f2fa34138,Educational,0.03560860014125966,17,30,676,1068,392,55.01014945121166,6064
827c7e6f-8e32-44d6-ab25-24e1d0e6e68e,Commercial,0.25154323336221385,37,28,516,1003,487,77.38921829613467,6676
fe45536e-e9ad-44fc-9d80-e7a3b9f6c7f4,Healthcare,0.5668821845007721,30,10,596,1369,773,11.098498012305672,2766
694dece3-19f6-4f60-bbae-56b38ba9244e,Healthcare,0.7870875955912567,34,29,400,820,420,73.01898804895205,3020
96a047f9-296a-4393-9949-87c07612f601,Commercial,0.15308075278395183,43,9,291,1113,822,21.76210852344142,9538
e2161218-9914-44f7-9496-50ee68de9d09,Residental,0.3625687115272802,20,27,90,919,829,86.64435666110998,4819
9101b259-53d6-475a-99cb-606c87d38040,Educational,0.8619615349536855,38,48,151,813,662,70.70881950219189,8316
51e7154b-a1eb-4280-ae27-6e9b096b9711,Commercial,0.920333516487925,14,23,562,704,142,24.06371565863985,9708
a6ae5fd8-c3f3-4120-b34f-0c55811a17f6,Healthcare,0.9844205110190061,35,36,139,575,436,10.222271396832504,3677
85254b09-9791-42d8-9376-2450da481c4b,Commercial,0.3955123368717567,35,35,361,1219,858,83.60674535787896,5668
c6229d2c-838f-4392-9704-62133cd46a86,Residental,0.4871633140134568,2,10,450,869,419,76.70273927147096,8833
6626afd8-f51d-42c2-ac5a-2501cb3118c2,Residental,0.7936731087715677,4,18,148,579,431,60.13533645510088,4891
c1a3836f-d372-473b-8c06-3020c2c679b1,Commercial,0.408398210463254,26,16,564,1070,506,68.92260335382772,6473
b92e69a1-6bd7-4a13-8b3d-6c2a1961dde6,Commercial,0.46576262403588153,15,7,192,269,77,73.39926386450716,2529
6f2e7e38-c73c-4039-b907-dbbcef25e456,Commercial,0.9184603746966749,11,38,620,983,363,98.4711124615295,2758
525dbbe7-e19c-4382-880b-43878e093d7a,Educational,0.014034113066003662,38,34,654,829,175,92.82440498777758,2971
f16422f6-6dfd-4cea-a6ab-060d1e33f77a,Educational,0.15413017887277802,46,43,164,1313,1149,57.42134874306713,5283
f7eecfe5-2996-43a7-a3fb-b46f8c3817e2,Educational,0.417415069665211,25,26,469,1148,679,90.7685535773769,4635
cb0e1b85-0cba-4cd8-91f9-41c5401f38ab,Healthcare,0.8566972963547737,39,22,46,1266,1220,45.76759420522599,5802
0dcfacc0-7ff4-4624-9691-f604871c6a8f,Healthcare,0.9591919174795241,12,35,481,1210,729,37.70227030231072,2792
3db14dc9-deb1-48f9-87d3-31c00eb4d202,Commercial,0.7490459077794945,34,46,178,855,677,49.95595064492656,6743
30055f8d-11e9-418c-bd1c-fcfcc67b4cce,Residental,0.6127305744554457,33,28,194,348,154,69.67861138610948,2386
7f067c6a-f2e9-4dfe-9f1d-36babdb38093,Commercial,0.7677467618501908,27,38,248,1319,1071,60.449934513887946,6786
08d455f9-caa0-44b7-9554-26d480ad91c3,Commercial,0.7959486096907064,1,18,396,1057,661,38.770825045879235,5469
c20b84d3-212d-4cac-8ce7-f87e11fabaae,Residental,0.24719850923629672,27,19,515,596,81,97.67073283050217,8140
b5e14ff3-2b79-42d6-b9b7-800cb622c86a,Residental,0.5060466209964223,25,21,226,953,727,32.3474330345859,4811
118f0146-49bd-4adb-9ed1-3fd3a2c69d2f,Healthcare,0.14978633228493443,7,22,162,667,505,44.71000105198272,4588
6bca0104-d9c6-41e1-8be0-8d80e8c86c36,Commercial,0.29332467882447244,11,39,533,1418,885,96.40643910597973,4828
1ff43669-079a-415a-b215-caa650df5576,Healthcare,0.9091069392703879,8,31,194,607,413,79.69275525954394,8963
bc627097-93bf-4a60-bd29-3bf5867e6f63,Educational,0.9981935981018855,29,25,522,547,25,72.81840386853861,4798
92630c6a-3623-4f03-b4f4-4908697b440a,Educational,0.6744908836545024,43,27,672,768,96,36.532742272148866,6943
f63d44d6-2f85-4340-bd25-8a9e88c778d3,Residental,0.7064839683278403,47,36,575,1077,502,67.44238825306257,3498
205fb9e1-3efd-44ac-b4c1-6a8e114fa060,Educational,0.3917349522411423,22,4,94,1098,1004,98.9405174615026,7835
fc4726c5-3182-4dac-b857-dd16f523e3ac,Healthcare,0.7165981600966876,23,19,669,1396,727,29.317158277402633,1565
4478a0ca-ee8b-4ffe-88a8-453c74ae7c56,Healthcare,0.5494717479609924,5,13,99,112,13,64.6059462785972,6283
669a5f96-d3da-4cc1-a502-94e13fb5581b,Healthcare,0.8718200440159022,33,23,581,694,113,89.17690391148655,1794
32730443-f39a-4528-bc06-f12eaf0b684d,Commercial,0.7721056795669216,41,38,492,528,36,57.52638157846049,1335
588cad4c-ae3b-4465-a2e4-352df9541698,Healthcare,0.19727656238744073,2,18,112,1112,1000,23.232355860809356,2568
3f59c44d-303c-4365-b683-e097dd8044b2,Healthcare,0.540390715119963,31,20,658,1335,677,47.90830339750752,2616
bdda5e5a-4ec8-47d9-a2c4-9fe227f61e04,Educational,0.10171872131075577,24,42,575,1211,636,16.459744396857594,3290
a62b7ad3-b492-4121-8a60-bdfc4c966d35,Educational,0.6979554006644062,49,7,345,652,307,54.455927164663294,3666
a2bf5a90-e1dc-4a0d-8780-544c827edf9b,Educational,0.6557915925085959,6,40,250,341,91,86.80391837405816,6662
1d9c7920-61da-4569-aa80-d022e5cb3154,Healthcare,0.8886120613613386,9,38,692,740,48,73.0741972859391,1790
28c3acbe-cd9a-4e6b-a2ef-b9175745bb24,Educational,0.7679496925969963,28,17,263,1089,826,77.89696219349437,4263
5b44d628-52ba-42b6-8a02-8d43f5024864,Commercial,0.0393091880191756,12,36,155,1325,1170,60.97269949697345,9557
883e44d0-9f85-4d2b-9d0d-d31ee808a930,Commercial,0.22417193439419403,47,27,331,574,243,49.11788014901058,7322
33eca5de-aad1-46d8-9586-e6b4572a840a,Healthcare,0.042050063973282925,45,34,374,597,223,25.2962024709298,6579
8ca0482e-0e1a-4377-bbe2-6fe4e2b64dba,Residental,0.2784145401763065,27,40,31,397,366,54.4783027471607,7150
4ca2e4d2-dae6-43cc-8708-86cfe454764f,Educational,0.6248410189390944,18,36,570,1204,634,16.979894649159622,8482
66edccc7-fdb2-46f6-8627-27e9b48c1ac4,Residental,0.7685498519165305,36,23,137,295,158,60.99320240269734,2873
de7d9e17-34f2-48fc-90f3-4fb1a54eda4f,Residental,0.08612687407344854,5,33,346,612,266,74.50985017671499,5982
a20b48ca-d6a5-493c-b915-400454a1aa45,Residental,0.2277505709735167,22,32,688,948,260,11.165577378463878,5310
60e53e35-7822-4f53-8f00-72e1a0a7a3b3,Commercial,0.9302969088880821,18,28,472,514,42,75.30459784191046,3575
80128cbf-6af8-404c-af75-7de8cba93c96,Educational,0.8198155279488177,17,7,403,1361,958,33.61416547494863,4639
cd471124-4b44-4ab5-b24d-60d509541ea9,Educational,0.20392830422799135,26,35,194,782,588,57.925198676007525,5450
e0a003f7-9ead-49ef-8736-e997d6bdf654,Commercial,0.6409947391183476,19,33,256,748,492,96.9215036114396,4762
7b379757-419b-41f1-aa29-7f362cabe9d0,Commercial,0.9185302786761372,27,18,550,639,89,45.057370529949104,3653
ced366c3-278e-4a0b-bb41-3cbf1fb27718,Residental,0.13619917571825935,16,15,171,683,512,64.87088744220372,5605
d67e4f31-f06e-42ac-91d2-82dfaf4c2ef0,Commercial,0.9070049743719117,8,41,184,1247,1063,85.26371314684769,3035
0bf80fea-d75e-4b4a-80d7-6e198509e6d6,Residental,0.8486541402454476,18,46,386,894,508,27.700653719131896,8686
bab2c629-95f8-4126-997a-fb445d951713,Commercial,0.5472380274832039,48,5,271,502,231,64.46326763326105,7452
56f50fa9-bfe6-4249-96ba-b3977594fa30,Educational,0.25920766203600343,25,15,429,965,536,35.88757506472211,8787
062b50f5-367d-4bbb-98c8-e8cd910ea71b,Residental,0.5595164752491985,25,16,117,1217,1100,26.919182396806846,1987
8716bf32-685b-4102-8b5c-b570c3692331,Commercial,0.08920736530674978,31,31,444,1369,925,45.37909309026476,6803
80f00c5b-bb7b-4812-8631-fdbf7eb5efce,Healthcare,0.101910732937603,33,14,330,1282,952,73.73142157051531,8580
33cced4c-9267-4bfa-b164-5e963dcda5b5,Residental,0.33560923671518816,18,50,505,1217,712,51.43610066108559,7689
6f515bd8-55be-42d6-b49d-b6fa0c78ce8d,Healthcare,0.24792274380968726,30,49,478,1254,776,88.3194305204801,7259
d2ba7564-1dcb-4dee-83c1-92e199106c9c,Residental,0.4094423842092294,12,28,277,1045,768,55.89858466230531,8157
baf6adae-1d2b-4d34-a1ea-0e2f745ad378,Educational,0.19914019956709328,3,12,81,126,45,61.1631233359129,1572
8546647c-e4fd-4031-87b0-b2fc21b526ef,Educational,0.9077563658863591,24,23,249,1419,1170,27.4565823945213,1120
a37af95d-4537-4921-ab05-b168734b1dac,Commercial,0.1494277525093557,31,20,408,1201,793,93.23779380702948,6873
071ed2e7-997f-4b9e-8906-5a0f8602f954,Healthcare,0.4420727359808866,30,18,489,1217,728,23.967519636392268,9652
ee596eab-a56c-44e4-a189-4fae489f6462,Commercial,0.7719561083214108,36,16,231,694,463,31.33024201291367,2962
65bd2098-7eda-4533-a145-9f67e957a19b,Healthcare,0.08083068151025619,8,31,201,883,682,38.35358084865306,6283
fb6ba03b-6cb1-4f9a-9989-848d5014ff10,Educational,0.19625920593380597,43,4,502,657,155,33.084793371939256,2110
59da9464-6e58-4b29-9f61-cdcc8cce2609,Healthcare,0.21893359230788823,45,32,295,947,652,23.385692436261667,6179
66744e8b-05e7-4ece-bbc3-8ec13e061981,Residental,0.9303552262744502,21,28,122,273,151,73.20560472825309,5435
683b1abf-ec19-454a-a2f2-89e3223fe9d6,Educational,0.6222181528174924,32,8,86,213,127,13.752026380389132,4490
999d18ec-84e2-480a-b45f-788c52b4332e,Commercial,0.18975250211984773,49,32,669,1260,591,71.58498205526264,1708
d5535211-cdb2-47ab-b027-85019e0e6246,Healthcare,0.5574975117338026,12,33,181,1346,1165,80.8772306681822,3372
84f048b8-564e-4018-9b64-23b00076efc9,Commercial,0.4393849987091132,16,19,562,1072,510,67.30961029588775,2847
4e9fec84-218f-4d0e-be03-7437c0dd3770,Healthcare,0.37641773590134875,3,26,413,952,539,20.887783689759466,8490
c902f884-b4ef-458c-8b7f-f34add69bd55,Healthcare,0.45958451779051135,27,2,584,983,399,34.367352624230016,1472
6e3e23df-9695-45c2-bb38-37a08cc57c56,Residental,0.2982392522127113,6,30,89,777,688,39.07821211099898,4316
6c9ee14e-85eb-450a-90da-63547c7082d4,Healthcare,0.5703690510945422,29,11,547,889,342,13.005112187808006,3988
df1f4226-5a5f-450c-acd7-0c182cbc6c3b,Residental,0.020644852822964355,31,31,571,890,319,53.267396521474524,7551
0068c043-f856-4d49-97fc-1740f4de43f5,Residental,0.796670023383614,45,47,125,147,22,12.257197145007536,5991
e7f56dfa-da52-41a6-9fb1-c859faa2532a,Commercial,0.6766018321938919,38,10,389,1356,967,41.47901637470305,9665
0fcc870a-8643-46ac-819c-ed62438b06e6,Educational,0.8132687727311172,20,33,77,185,108,32.04536657096963,5021
c0db8b34-9b92-459f-88ab-04ed5047743c,Healthcare,0.44877197083714926,50,29,386,1331,945,47.7249036541458,6169
9cba7c1b-85c3-46f2-aced-7180d0d28ac9,Commercial,0.009106313109809139,24,15,54,909,855,87.13768045687225,2284
72d3e0e1-448f-4f93-9666-ee9cf6cb7486,Residental,0.7484356178641236,17,7,624,659,35,72.09415705753347,9107
8e0ccc58-e73b-4e13-942f-fbc6eef78989,Residental,0.5962241682248393,1,20,711,989,278,80.11151114636482,7940
a5564ee9-428d-41bc-b59a-16805ac90cdb,Residental,0.7645365851397612,10,11,543,932,389,78.22746749647492,1188
bc6eb546-79f5-4737-ac7d-d616d7bf1f27,Healthcare,0.09950559865542363,39,36,144,244,100,78.79896957393879,9555
9451299d-c59a-4d96-bd17-f9dad8202f9c,Healthcare,0.19621171703170937,21,5,575,1423,848,50.23274701144425,2596
973c0cc9-f9bd-447e-91c5-649742f895c2,Residental,0.2302313780784252,29,34,113,671,558,77.97176910203116,1525
9476b43b-68a3-4a06-bd93-b268986522b4,Healthcare,0.8757559504757705,38,11,275,1392,1117,54.81959039989628,8250
534f89ed-e1fe-4e0f-8d2d-58ca8aae80df,Educational,0.5546689383716897,27,47,599,956,357,73.99602529190865,1509
c9b1c80f-f13d-450e-b4e1-f44a6986c128,Residental,0.7093888894050734,50,45,216,1018,802,24.076141167541735,8617
464e8547-3327-4eb9-b3cd-eea926f69db9,Commercial,0.07775482410676704,32,31,659,1101,442,39.400462767654,3887
6d36f2c6-6f03-408a-a2c4-bb3b55f36efb,Residental,0.6732530631349352,8,25,390,896,506,86.45299660558364,5572
87099977-7327-4eec-b7ad-44b12a968acf,Educational,0.8576350806858226,36,8,528,825,297,61.2140464719888,4835
e22c62bc-8bbf-4e46-ac9b-57ca101b165e,Residental,0.748366631425836,7,15,193,1116,923,58.07352982241278,4806
506a3e32-5710-4d9c-b555-bbdbc08ff7e6,Commercial,0.549652438472412,22,32,669,1161,492,15.22172803102141,9232
b6782693-93e4-43bb-980f-0812202ac7b1,Healthcare,0.34343962223322033,25,34,233,904,671,58.342199778116544,7096
1e6d1c02-6927-4f66-9d04-1e406e9fd22c,Educational,0.2150805966392535,20,34,551,1142,591,47.78675984436309,3649
f10d8cdd-2a2e-4638-9b04-dbf302bc7b90,Commercial,0.4540143999512892,49,15,25,69,44,25.831612940344975,2741
bd3a8482-87fc-4426-b4cb-e367ce73724d,Residental,0.2792585569847642,12,11,63,411,348,16.35598745810755,7219
3de75c7f-5e2a-4a19-90f6-1ea445814ba9,Commercial,0.1588015481388223,44,27,453,508,55,55.124824151789795,7374
9c208066-97d0-44b4-a12b-52f8e37b13fa,Healthcare,0.4679381420463933,46,34,538,1077,539,99.72890740148443,4008
c6f21695-373c-4a04-b353-a74db932eaa3,Residental,0.7934687580144366,9,7,540,847,307,71.79575892749293,9261
91a64fa7-482b-4965-be92-6c7574cc4807,Educational,0.8119977874624092,13,35,256,1417,1161,54.3192247840377,8396
28eef8e0-197b-4de2-b03c-902acfb60fd8,Healthcare,0.7828296832340652,42,20,10,315,305,57.895346090233446,5049
72f30963-bc24-4603-b350-84a5b0f26a9c,Residental,0.5139158153107473,49,14,459,611,152,61.12496251524658,9888
56d5ab53-f037-4b20-9c4b-add2ed86513c,Commercial,0.5547305583112431,3,46,596,806,210,11.237162803005518,1237
defc2d3b-3aa5-45ff-9acd-4e0060724c87,Commercial,0.5905182174277362,40,50,467,841,374,18.208492542885644,8671
c115d9c6-4c36-4d90-bfed-fd1eafbfe7ca,Educational,0.8055496796596042,27,40,376,1048,672,80.12355335372172,5768
ee95a430-b488-4172-9134-c2c8413df3eb,Educational,0.7501146585347226,20,16,677,1400,723,68.25267055868892,5047
fa09491c-a50c-45a9-8530-1965e0bffaef,Healthcare,0.5461509271866518,9,32,294,668,374,26.25151439504413,5024
f4bad193-cf89-4dd6-b4c6-823e528aeaea,Residental,0.36677503009142287,23,8,512,1008,496,49.27492876416675,7898
3a249a9f-8911-400a-b013-898dcbd01529,Residental,0.5630861907050806,46,48,346,1045,699,19.504285580622312,6874
e5bb5852-1437-4a61-b3e7-2762a16460b0,Residental,0.722850405794713,47,35,158,1107,949,85.68470067071917,8066
b83981b8-7fa7-49fe-842b-8ddb76f38234,Commercial,0.7267329225795429,24,44,534,1041,507,84.4662538391741,2196
fd0e1e07-196a-40e6-9f07-1a9415cbd37a,Commercial,0.9899610829576356,43,11,7,1009,1002,99.53369460178867,4703
7bb57269-18ae-41b8-b429-2604fa3b365b,Commercial,0.31685802510139804,34,37,128,568,440,76.43473148501786,5921
e9438231-283a-4279-a735-24f9df6cb9fd,Educational,0.023479474631991293,16,16,155,621,466,56.63499980220196,7483
35d42f19-e4c8-4d5e-97c8-113a9817aab9,Educational,0.38912217038064856,2,32,217,755,538,39.52916140521948,5221
01b203e0-cb43-4b4b-a8e5-7f554c07c4b1,Residental,0.8806158776449191,44,18,669,885,216,64.16883381134866,9227
f8e1bc93-cac9-4468-a5b4-647a8986811a,Healthcare,0.01998278788457286,27,5,403,927,524,49.68121863682947,2211
24ab0170-dcfa-4483-a81c-e2607b12dcd4,Commercial,0.342611756173518,23,22,372,1423,1051,63.826576561470716,2741
a142bec6-0b4a-48e7-94ff-1329c6ee5915,Healthcare,0.5747437365414766,3,43,179,800,621,96.69952890139206,2248
21d72765-f19b-4b0f-8504-d5c671a0c209,Commercial,0.9568752197063324,22,9,26,1216,1190,32.3188674108794,2538
67b1b2bf-6e65-4235-b235-401ca499efda,Residental,0.20586151828503885,31,48,672,784,112,50.74947318412888,9354
aee259e6-0292-4aad-aa41-233bf2a846bc,Educational,0.9586227868346624,21,29,662,1209,547,78.83367934369353,1630
5bdc2716-caa8-481c-be34-4f90ae27cc6c,Educational,0.14603999023040526,26,11,576,1056,480,34.141069702947455,9004
4e0fc1a2-876e-4a0c-b9ce-dd5f350600eb,Healthcare,0.13791047659144895,3,23,638,1241,603,48.60646203269902,2068
d262fb1e-193f-4164-a94f-71bc245dbd8b,Commercial,0.001541495908973678,36,42,629,693,64,86.62430971048259,2482
bc3537ca-bdb8-4b34-831c-b915075e7388,Commercial,0.8573679735288248,16,45,126,1104,978,17.913963312806384,2862
2dd1bfa6-98a1-4e96-8985-350b73b586fb,Educational,0.473240989934245,32,44,337,506,169,43.29154772079102,4353
832d615f-fc05-47b8-8e9c-5e78179fcf34,Healthcare,0.9576467092772734,5,45,133,715,582,62.1073661394446,7047
b9caa04d-b12f-45a1-b435-a09d363ba0d9,Healthcare,0.05246484498870896,35,45,383,1195,812,97.97608465544954,7687
c11cd5b4-56d8-4146-901e-61f517203c58,Residental,0.06879936231454076,32,16,687,1113,426,43.33582426853341,1095
c1a44f46-5d52-4787-82d8-2b33ef946fe6,Educational,0.6500878620305975,16,42,510,671,161,13.299687974702536,9105
e1d27768-5575-487c-aad8-8058fe88e67b,Commercial,0.44402819805221616,31,3,25,1236,1211,94.24401842033296,8410
283728f8-b72c-4a9c-a2c7-6e90b056f3b0,Commercial,0.9931568556330581,3,45,496,508,12,97.69707013015498,6392
6e6fbd62-b0ac-480e-9d42-c071e701eb24,Residental,0.9027174012201611,33,34,266,648,382,21.064244582395325,1102
8799c775-5ed4-4f01-9fb1-fab81817fed0,Educational,0.3948221487654334,48,2,69,467,398,74.68432662589032,5961
b0264ce7-1447-4494-ae23-fcb82e0fc496,Commercial,0.4071721882673135,5,25,120,1316,1196,70.27105175938553,4606
8d93be04-bd05-4859-b6be-898f634792b1,Educational,0.16864321975435193,30,45,479,658,179,93.51868209416376,6397
3248382d-2b48-4f83-be75-2a6ebac25671,Residental,0.16571112697735568,30,35,308,1279,971,38.88354035156387,8625
8dda2bdf-657d-40e2-9d5f-2a989860f696,Commercial,0.5423709837351864,42,42,576,1346,770,75.9634241393357,7096
60eb517f-e74f-4dc4-a143-08e6a41f7349,Healthcare,0.40720959288624325,7,1,517,611,94,15.459954910096538,7015
ecd4eb63-c4a4-4c0b-bbe4-ece3057ef23d,Healthcare,0.6196361987431197,48,48,285,1170,885,73.80262438627057,6541
684bb23f-0cc7-436c-aaac-268f82aed890,Educational,0.876964325832808,15,38,75,513,438,26.886596563255377,4309
c26c9c53-26a5-4981-94e3-6a0bba4ad775,Healthcare,0.08205470838772,45,33,119,1241,1122,66.58106366111716,8646
e3a8998b-1180-42f2-bdd9-820fb32fb7b3,Educational,0.889785699054755,25,28,292,1190,898,24.735455735250596,8946
e5a92d16-aff3-4e12-9ebe-61efcd3eb504,Healthcare,0.9672653633138918,28,11,472,1438,966,95.07060106939167,8946
08ea0461-0516-499a-b499-c74803b023b1,Commercial,0.6712672421756035,25,23,41,727,686,65.14510399742076,3139
3a1a2b17-34b9-4ac5-885d-3ea61bf62da9,Healthcare,0.3245556185637031,25,8,557,1296,739,85.4261569599281,3997
27e36d14-54f2-4e61-b216-e3d69db653a1,Educational,0.9991923698628432,37,40,98,245,147,19.33338074438752,9488
6730c6f0-3686-45d4-974c-b7f9fbc2e754,Healthcare,0.5164466127385358,8,24,461,780,319,20.028349497674327,9320
044b6737-36c7-43b0-8d17-dab8d721fe36,Residental,0.419582635590633,1,25,444,1388,944,35.14353026337576,6716
c9f94cc7-0b06-4a4e-b036-e02cf30b1734,Commercial,0.030629644747228735,36,17,111,1326,1215,52.308330497180876,2979
4f5cb471-5c28-4da6-9820-f9e080879485,Healthcare,0.559298947117937,6,44,618,1195,577,55.58513918121171,5786
277bf567-677a-4d4b-8aef-6084248875e5,Educational,0.1939138488390567,12,21,412,716,304,78.78805804059681,2862
b8d3489a-5a22-43ee-a7e3-2c62497cb0d9,Educational,0.9831336281233553,47,35,424,938,514,58.048401906127204,2613
745a850d-420a-414b-a516-628d408815c5,Commercial,0.09793676802315354,12,21,544,550,6,10.84605132998404,1307
76410ca8-8a30-44e2-997f-ebc6167a2388,Residental,0.37491928155384335,10,13,514,796,282,63.476506381305896,1508
a9895c8c-b5fc-4de9-8dd3-cbdc3890e61d,Commercial,0.9702964964563705,18,33,187,634,447,23.48521432769926,8587
8d9a7417-0bf8-4eca-adaf-8a9d30bc782d,Commercial,0.19042458545588492,27,4,713,822,109,87.66150279171059,9618
244e8f68-ce12-4137-80e4-a33ff4cfb613,Healthcare,0.7037233816870145,44,50,381,1167,786,83.1917115871289,8877
8a13cca9-7c3b-4260-96db-c4f9209f9237,Healthcare,0.40407459363310405,31,10,494,1002,508,25.761126902722197,3775
5e0481f2-30f5-4951-8f0e-3315bc5f83ec,Educational,0.3872954974185059,10,13,639,1158,519,39.29804176344206,6450
0147c608-7725-44f2-948a-3808b6dd0d75,Healthcare,0.1573782046476051,50,29,73,1015,942,21.12887013661517,5427
3b584da9-cf7a-4f6a-aa55-98e3f0b680a4,Commercial,0.7075029568539876,39,10,75,1164,1089,16.560418970898716,6002
06dd2681-c050-49ca-a263-d2c8de65ab6c,Healthcare,0.7088094246087634,23,32,458,587,129,66.09207264612583,2107
97a7ade8-1a3c-4033-a9d5-196fc87c41e5,Healthcare,0.040251217648817894,43,49,218,904,686,36.422289679032346,6254
c30075dc-abd6-4d72-a049-54f37860f3db,Healthcare,0.4564836437101708,3,11,72,475,403,19.551341841554212,5527
9837da23-5014-4714-a566-946a75f4541d,Educational,0.760346183353118,16,43,162,1053,891,68.69136206909673,3730
aacd79d9-80ef-4e51-9fab-3b3788805763,Commercial,0.6595430580385319,8,43,680,1138,458,39.91061362635344,1228
8cb598b7-d724-431e-930c-1add43c5e0b0,Commercial,0.9363044877959757,42,44,532,885,353,42.852134682863344,2863
b07b9fc5-67f3-403a-96c4-99b1d240448b,Commercial,0.8145635625359059,29,37,267,1299,1032,11.870317540099725,6777
2366f246-3f2d-4887-a6ec-4ad3b72d41c5,Commercial,0.14791355908781545,39,27,366,1083,717,15.139403164599969,4796
50c8dc59-ebef-4e8d-a8fa-9e82db9bbd62,Residental,0.9080295417779097,28,24,352,931,579,27.614733082978688,1645
d4d26c9f-d4a6-4129-8505-93b991fcb2f8,Healthcare,0.5662907720197762,38,50,170,447,277,25.239614094889372,6193
e9694685-5a04-4478-a2f6-9c650bd32360,Residental,0.23660750371536687,2,12,122,1225,1103,62.88141341450039,3883
7d7af755-e0ee-4dfc-8e62-3e780b8f2bc5,Educational,0.5450936868152317,45,11,133,682,549,64.36892633034192,9669
e904bf45-9152-43c6-9f34-b3955e6945b9,Educational,0.45545947968851674,16,1,101,1354,1253,67.46383092326845,2982
53aab37b-b6c7-428f-bacb-5fc3589b0885,Residental,0.22152693377939336,32,14,112,524,412,54.857043260833926,4708
b4a68da5-5ead-4feb-add0-5d2c468dfbe2,Residental,0.3398437733138495,6,48,568,1419,851,69.05337674085928,9016
a56bdcd7-e167-4495-b6ac-a74cb65467f7,Residental,0.47873680135576824,43,9,484,695,211,77.27425386220476,5955
17aa25bb-5771-4e66-b363-7e7bbacfff6e,Commercial,0.7101655351072903,44,29,98,1192,1094,69.69018765584725,9498
1bfd4383-13c8-4e80-9e6a-3b2318084f9d,Commercial,0.007083683636088911,35,22,373,626,253,56.976641642768804,2666
0b40150c-10f0-48f6-9ac3-42c2e3a4033b,Commercial,0.40487611851288574,11,12,315,425,110,13.698714374306576,7974
10db13e4-b92b-4890-844c-dc34f6de24f7,Healthcare,0.1594820018208183,19,23,120,889,769,10.29383347372399,1251
93bb3013-8dbc-461d-994c-63d60cad3a17,Educational,0.7471003071398853,37,22,72,419,347,35.220704687169246,7910
9b5b50c8-a703-40da-8e63-607564399a21,Residental,0.2661085392758815,7,50,309,1325,1016,51.79451230656651,3759
537f7336-8969-46c6-ab21-507e5206547a,Educational,0.8094389334644173,4,21,27,126,99,86.18837290653475,1915
5a7fed67-cd73-45eb-8a3f-acdd485635e6,Healthcare,0.36770878671137563,23,32,508,1278,770,58.30970913734466,3346
ae89a511-4d02-435c-9647-c115c0df8bf3,Residental,0.508817524900262,17,26,495,891,396,58.771615015092856,1858
c1f865af-b291-4a17-b633-629ea5a3e1fc,Commercial,0.7706988111250731,20,13,483,1212,729,82.6006635658697,3506
468d542a-d4e0-4a18-a54a-14b9b40399e1,Commercial,0.07707686751251852,33,17,363,1058,695,28.67052179370724,4037
086b2956-86af-4216-9cff-ce2ba615d532,Healthcare,0.9266684962907556,5,16,206,642,436,30.818649532807243,6803
887aa1e3-145e-498b-bf89-ab7c6f1839f2,Healthcare,0.11467317959081358,34,31,312,1123,811,19.748352502759502,5589
58aa90c2-cbfd-483e-afc9-bc8c77cdc5f2,Educational,0.524628244695434,4,47,485,1106,621,21.87482797750293,2769
e6166029-e2aa-4fec-8388-ad0fe522bd3a,Healthcare,0.795018072611769,13,12,291,334,43,33.27305598074609,5681
ba40e994-b25d-4e2e-a926-06520af89fb5,Commercial,0.19975672657102894,50,16,252,1005,753,91.41935831893318,3333
b4a927ac-1d02-4395-8bed-8be8c3cb2589,Commercial,0.5383980546162731,49,43,91,361,270,33.244937174973565,9410
0e8f664e-1f88-4a9a-ac55-861972aba21c,Commercial,0.7382383477973344,18,8,164,1171,1007,32.5733736153355,5119
8e193445-4a74-41e8-a1fb-2f3032167ff8,Commercial,0.4993202784809172,27,37,459,1037,578,10.618591265524003,7338
870ef76e-e97c-4ec3-bb97-feeb164cffca,Residental,0.2920526165453218,44,17,332,1424,1092,78.56061817730918,7963
564d5fed-c439-4e54-9f36-2e61c012fb6e,Commercial,0.8273802859686098,1,17,610,765,155,97.89183948736513,4683
a3835d2a-1e77-420c-a4e7-f83a4a684ca9,Residental,0.6408572857380217,42,8,379,491,112,69.61802726523003,9116
07ee817d-f722-44fb-ac08-42b4f2b0c40e,Commercial,0.925296246887951,31,36,714,1427,713,34.97521826857666,9883
0d5778a4-da4c-4696-adec-d114eadb21a8,Educational,0.1917303139331351,27,12,511,687,176,66.20138633680433,9839
93d66626-c301-4cb9-8c13-98a61ae3ca21,Educational,0.09730705778217841,10,37,392,972,580,30.524040765586882,7696
538ab112-5d08-4ef1-9935-006fb197522e,Educational,0.7360117524547577,13,1,522,1259,737,21.89808016051922,5534
c56c3bdb-fe55-4d43-9092-159cf1a4a0a8,Residental,0.6852234549196045,18,1,484,1177,693,97.86936043564667,3958
2e421af9-8bde-4ecb-939f-4cd6f7960dbf,Healthcare,0.7630295074888556,35,35,453,709,256,67.10179100210013,5972
fc7ef0e9-f84e-4838-ac09-ff3f389a2a5e,Residental,0.259119113193361,25,17,399,623,224,91.01516713697706,9953
baa78991-d1bc-49c5-a366-70a4bfca4841,Commercial,0.8347524776932225,37,13,458,1122,664,50.06098755976347,9208
7112bdd5-c25c-418e-b0a6-8811ce18d8b4,Commercial,0.7657478736364568,22,6,25,1405,1380,91.3198161977997,5633
af88419b-74a0-4983-bf94-4ed9bbd5fb71,Commercial,0.0927899025992821,41,43,391,780,389,89.57991851973173,7004
a466d6c4-f5b7-48d8-bb23-caec5d09297e,Commercial,0.8494810794038299,21,7,375,1318,943,91.82183481525581,6539
0f3f203a-d7eb-46ca-b03f-d725594fdce6,Commercial,0.08727898790245592,50,22,107,879,772,51.41472776504787,3432
cb83e488-8a99-470b-9389-1633c6cdc0e5,Healthcare,0.19563867146241354,13,18,324,1148,824,37.61121074609818,7586
3312c223-b7d5-440f-ad51-afe792312911,Educational,0.1545178599509519,15,50,406,599,193,95.38815587214935,1935
052e19ad-b57e-41c9-9613-3e1149928892,Educational,0.607313558677003,18,49,465,707,242,80.28884863535923,4717
4205e3d2-c49a-4c5a-8ab0-8fd59e915f37,Educational,0.38523881057037823,4,43,206,245,39,31.286643739515355,6974
89fcfef6-55de-46dc-91bd-5fe207ff98dc,Healthcare,0.6921071002653221,17,21,60,1386,1326,48.582163114595055,6267
0161601c-1cd9-4b1f-8cda-377d172e2459,Healthcare,0.48478107659709435,34,18,225,1064,839,96.8220109421233,6745
5a0ba9aa-0df5-48f2-b3e5-c507753884e1,Commercial,0.7563649704703299,39,43,489,847,358,98.61127288532211,2416
fe1b1a1b-2ce6-4d79-9c89-34525fa63df3,Commercial,0.5404554027501299,10,12,256,865,609,73.21005160765833,3397
6595c0b1-19c3-4db1-a759-28f063a4d5f2,Commercial,0.851766768149126,11,35,451,549,98,24.175604635221198,2488
206f4adc-0934-4632-b88a-a7f8eebeb921,Educational,0.007918556895935791,5,14,329,1200,871,51.588115653075285,2678
8ede0474-9968-45d2-8597-c99148263927,Residental,0.814234940088517,34,1,523,1082,559,24.650551462813606,7878
22b4e783-bc06-47d2-8c5b-17d6579c4bea,Educational,0.594394913688039,50,34,563,1432,869,41.281464984863376,1665
d4711d9f-e53a-4c9f-85af-5fd7cd024951,Commercial,0.9940471768841095,25,27,412,1172,760,68.10843137256111,7961
4a572584-e01d-4dbd-8b7b-4a7ccbd9475e,Commercial,0.18097264575262417,40,45,42,1187,1145,19.348529210285164,9712
8058c5db-68de-4a6d-9374-42a777abe1e6,Commercial,0.13837631654505744,41,2,336,1126,790,63.79772795469018,2844
87d77702-5c65-442f-ba11-05fa1ab0f8e0,Educational,0.147681858208476,37,35,330,466,136,27.164732567051846,7132
712c6761-98bd-4376-9a46-9311cc4d07ab,Healthcare,0.32449555244438455,34,42,321,1353,1032,86.06471780875688,8074
c314650f-1ce5-4c64-b108-d2ecfee405b0,Healthcare,0.6367652423857465,15,39,453,1003,550,58.855176113317896,7734
a2c056a3-0a68-4d2e-b2ea-63de9f110325,Residental,0.9472885949622909,32,1,382,1317,935,47.52097815993323,1129
df092571-64c3-4d70-b3f5-84723e9182ec,Healthcare,0.7062974233346132,6,1,415,634,219,35.996443237711574,8220
3739f373-e84e-4181-a1ad-bf8331c02b22,Educational,0.10559519297316589,49,47,562,1169,607,47.20803992146012,7374
7203fca7-4b98-43d1-9bd1-07ffa21cf74c,Commercial,0.551221144285662,47,31,22,606,584,90.76425462661076,8229
c6a2a9d2-9adb-433c-a378-604ac436bfc7,Residental,0.9257517667060974,25,27,599,1367,768,36.4103881552704,5357
4c6137a6-1da5-4b40-82f8-28a234c99e87,Healthcare,0.29374252081083685,42,38,674,996,322,31.616954032060526,1312
81790c89-1afe-4d6e-893f-4285dfbce4e3,Educational,0.06086103923906139,33,43,66,475,409,44.616202966187174,8159
de72756f-2b02-4543-a4fb-5c26cfe2e50f,Educational,0.1377841004245992,38,38,442,644,202,76.9769239209388,2239
7b77592e-6cea-4945-b9fe-5b4660a611fa,Residental,0.8692433863352939,21,3,627,748,121,75.08330201916536,8225
179422ee-0a07-4d62-9e68-cd1edf590427,Residental,0.8043965498214362,20,40,475,1405,930,60.56655290234738,8575
b560e179-c425-4ed4-9ff5-255da4eabfdc,Educational,0.5825885936367174,6,15,543,639,96,24.654931834772672,1280
8f6f5c82-3445-4826-a184-6984bd7598b3,Healthcare,0.33486046356701304,46,46,526,587,61,23.961382351451075,9021
c6c09dac-bcf3-41a3-b76d-3bae73ec9dae,Educational,0.6624338100660154,5,18,424,1285,861,72.63845331202499,3840
29ff2753-b987-4326-a467-0a49a9843fb1,Educational,0.43285862731219193,7,20,242,1328,1086,39.12855507251395,9902
34b4ecfc-52e1-4d19-b16b-7493590326ed,Educational,0.22843786999260607,49,17,31,813,782,67.50429462169743,4527
081254ea-6e31-438c-af97-40e6dbcfae31,Healthcare,0.595332118867221,12,11,430,1090,660,36.58637606863502,6923
b92d5899-627a-40a2-9634-296a9bab7e61,Educational,0.6907260375389548,18,8,214,672,458,12.802925943418211,7238
0b2afd0e-9643-42a3-b045-32da5ef19a7c,Educational,0.8588823582715535,40,15,307,313,6,38.193713208774426,5026
bb8e1237-b7c7-4d1d-9e7a-4fcce6b6c9be,Residental,0.4587882814721106,26,3,547,1432,885,44.78376144791474,2426
6545fc34-d8a8-41b2-8f93-46efc3650f9a,Educational,0.23526578177542523,15,24,166,468,302,87.73138224439575,1701
b2e81534-c6c3-44e1-91a9-650ba43befdd,Healthcare,0.2795454380004091,40,28,210,554,344,10.5669837976948,5897
130a3301-f470-4b4d-b249-c8ac4d36342e,Healthcare,0.13408613803060032,46,19,595,1411,816,75.81493332091863,8174
ecb64055-b20f-46e8-962f-c83dc1c70279,Commercial,0.14110983422480894,45,31,692,1196,504,46.29819614994817,5001
09a6a497-9f1f-45e0-ab84-0d190ab879c9,Educational,0.19616459111395435,37,4,507,659,152,94.63298096918773,3360
7a32494f-d15a-4e29-840b-8cc1e5d3e984,Educational,0.09786503528174506,17,14,258,441,183,59.83887208178614,8227
f3bb32e8-4a38-43ed-8b5b-0a8f953d2c31,Healthcare,0.6850180313860849,37,27,424,1082,658,77.52642975240657,3737
9036d1f4-8e5a-4d87-bade-5f502e43b468,Residental,0.4539472579705107,26,29,88,1416,1328,17.355191904596875,3850
d0742e30-8132-47df-91ca-f5cbb086c634,Healthcare,0.036236518081473656,4,38,351,1246,895,87.63268669020763,3900
de197d73-7ac4-4e81-bb8c-9d531aeac808,Residental,0.1570547447986217,31,37,484,860,376,99.6568456131319,6817
4cf2c765-9a24-41e1-8657-8f23e731ae8d,Commercial,0.5028233025007912,12,31,500,531,31,38.67526349152571,6705
1642e2da-62c8-4ed9-a176-69c896290ed9,Residental,0.5640309506736085,48,6,477,1178,701,18.68901846997278,1079
186de3b5-1816-4392-82bb-dbc099de29cc,Commercial,0.9751012173216626,6,50,347,649,302,74.9919344821466,8074
e9875486-63b6-4adb-99d4-28b7e0cf272c,Healthcare,0.05202526888828285,43,11,669,1099,430,52.07325356885876,4031
f4cc8fe4-89d8-4b6d-a71f-056499a9d560,Commercial,0.7185047722607182,9,18,63,847,784,72.3092588689214,4368
cc03521f-77c8-47fc-bfcb-ebb8454cf91a,Healthcare,0.87986613779123,31,46,4,1182,1178,35.44833633251161,7854
4efd77b5-cf16-4103-9a37-90822b4fe495,Residental,0.4616116512478844,4,46,416,1397,981,47.76858854546863,2043
4ca96dc8-35ac-48d3-a714-184e1e5abee4,Commercial,0.9238539527795485,48,38,310,1112,802,36.54715950734999,1791
b466f2b6-4a41-4af3-b8ec-b2838932d1e0,Educational,0.9131899015606346,2,28,419,836,417,63.43900053323977,9846
a4f58297-c3a6-4e59-991d-b171a53787a4,Commercial,0.7058208522319992,28,2,381,1425,1044,79.95153251924292,6522
2049c17f-58a9-4be2-9482-bcc917ff56a5,Commercial,0.6406711333373432,5,27,683,1380,697,40.78499275097702,5608
38a4ae24-810d-488d-a009-1e8a518a6f25,Commercial,0.44154968562336594,8,11,379,1046,667,85.628612515358,2828
5312f16d-50ec-4d24-b0d1-8282bede319b,Educational,0.960914526849548,29,6,168,493,325,77.31743082312661,5455
560495ad-61e9-4027-949a-46b9b237bdbd,Commercial,0.4089981662572728,49,47,585,648,63,71.96090264941071,4964
7fd654ed-a6bf-4ff1-82f4-db81709df890,Educational,0.911824446284669,47,11,183,954,771,87.8394297456581,6176
d73a9033-a3c2-454b-acdc-0df511749287,Residental,0.0564496966340684,37,24,474,500,26,71.61349242251495,2186
ba1cddfc-54ab-4657-b479-0f951546c1d2,Commercial,0.9722477314095362,4,31,418,778,360,48.88405404874469,7054
b47e578b-c34a-461d-97d0-dfb03313438d,Educational,0.5178233265980053,2,8,175,795,620,83.42405437267297,3751
1d6f3459-ddd1-40f4-8787-e3150a14da6b,Educational,0.8634755426405253,8,29,518,772,254,68.73673189252007,5216
fd30d7b9-1380-42f1-944f-557daaa31ec9,Healthcare,0.6956946898048073,9,21,402,884,482,51.3628654474294,9478
dcd3fcf2-2fd0-4636-9291-3ae5c06e51ed,Educational,0.5900816698175213,1,5,719,1289,570,82.06185507745955,8701
96053e3f-558a-4389-a1db-3a147e89d361,Commercial,0.4639895125743869,16,28,695,895,200,52.9820323322123,1113
78db37d8-8e39-434c-a5c0-888655f99a76,Healthcare,0.7898427895156728,45,7,34,711,677,77.651161307902,7017
ffffa9bd-7e99-48ce-ab17-4e27183aee12,Residental,0.7127765094534761,33,16,74,1109,1035,38.653488760111046,8063
eca3183f-f033-4f7c-9333-f956c8590e99,Healthcare,0.0034236259098945343,15,18,267,549,282,69.13062868472738,5107
f279a856-ce2e-441c-96d2-0942d53c99bf,Commercial,0.6784912741853473,36,34,214,638,424,78.65887166270213,2805
768bd781-977c-4708-8b22-4f1581261ab1,Educational,0.0815469048153985,36,38,506,616,110,25.569698427088852,6627
0dc1a239-3df6-4cca-b023-f291a0ce82b1,Healthcare,0.7357131446810476,8,23,148,222,74,28.501158087520725,7287
87c5b952-03db-403b-8faa-61717d0814ad,Healthcare,0.1338521248835517,12,29,436,836,400,12.305498838909662,4833
ecb739fc-2944-409a-abf7-06c183786108,Residental,0.5576033802454661,35,11,108,263,155,58.761910738164474,8083
7ddbc789-1d3f-4efe-9670-e950b8522536,Healthcare,0.49805298403823695,48,4,72,305,233,56.204575936921316,9814
a7ff39a4-2bf5-40f9-844a-600411f8d0db,Residental,0.7653017729122608,39,45,282,788,506,20.799513205261043,8071
f1493077-a54a-4cba-b5b2-36bddb4de7ec,Commercial,0.35634417784289774,7,38,693,717,24,73.96931552271127,2572
d92dca42-6828-46c3-9987-ab53fb7c028b,Commercial,0.2806715786262193,17,35,414,517,103,81.73627498155435,6310
94b8c3d1-d054-4600-a2dc-31b9ff66d943,Healthcare,0.32839656830268704,42,36,464,715,251,93.18361410438406,6591
b2a0d268-6a9e-4c25-885a-e9d3ccb7d855,Healthcare,0.37984971181042027,23,31,182,205,23,72.91397178309796,1028
0fb1baa7-90ee-4f1a-94e4-882e05808a07,Healthcare,0.12433897646957115,25,33,338,548,210,96.32988132299002,2628
854bdba6-11b4-41b3-abc9-169d90a0b797,Educational,0.7863197774825692,40,36,646,960,314,42.4919704325774,1199
28c50663-4fd0-4718-93c9-7a75a12731fb,Healthcare,0.8570701092036933,1,1,321,795,474,24.928370211285824,8178
a087dadf-156a-4954-b9fc-d9c9511606bd,Commercial,0.5883615274476403,42,26,479,1256,777,35.27529857034728,4351
fe55bd57-f8b7-4bb8-8c1f-b6848e00f0f0,Residental,0.17316257813683855,50,39,25,668,643,35.49872184026259,9402
fdb9a5f3-95b6-410a-8241-26550a1311b6,Residental,0.0027944693490041805,7,27,329,1039,710,52.43343740151993,7453
c7f9253d-1521-45ef-ae3c-4d23aa370a9d,Residental,0.6793356011755515,18,22,244,987,743,32.79177080317757,7470
fb798617-2c17-4f2e-bdd0-161801ba7a56,Residental,0.565342061655374,7,48,341,648,307,53.42368102775018,5693
4c0b6043-dac1-43d8-bf4d-bab168ef780e,Residental,0.6955709696690255,32,19,432,1215,783,69.66947846762382,3139
d5856bae-f552-43e8-b521-96a02c961aa2,Commercial,0.9252593915543066,41,35,403,592,189,98.63478693658476,7540
b08338a8-4110-4f55-9171-c92c4635cbcd,Residental,0.3369524787134661,2,6,5,1049,1044,20.039752501438663,2191
e6b9385e-3263-4b33-9ee0-ef190047af00,Healthcare,0.7403575271838607,11,37,366,884,518,79.60323663296927,5022
aeaf3ba5-1985-402f-85c0-87edbf12c85d,Residental,0.00012605054463987742,50,8,320,431,111,65.28820177968839,1562
e4b84933-7090-43a0-92a9-6481aa128f98,Healthcare,0.38328267329364984,41,41,694,1056,362,79.6822106462901,6879
1da459d6-8962-4129-89f7-2ce15707de49,Commercial,0.9670071258599484,32,42,639,1366,727,87.88469454916164,8869
a6faab2e-aaf6-4ebb-895c-dae9a8c82467,Commercial,0.8092433329920323,3,1,320,1313,993,49.29149765354284,8682
062b4a02-9d15-46ab-8bdd-3c470277706f,Educational,0.28857453658599586,46,5,205,1277,1072,23.055660029818554,7017
f5be7638-3427-48e5-8559-ddcd50c0b042,Residental,0.9765558478894175,20,15,544,1142,598,62.62309324371549,1147
ffdd51a2-aba8-43fd-ab98-d7c7f149d4de,Residental,0.12677111134080865,44,44,268,1333,1065,27.91180323209182,4791
1a05ac42-c32f-46b2-81d5-e92f9baaae33,Residental,0.1131375185038519,12,20,381,909,528,14.781112810064876,2522
ccf44e0c-2b12-400d-969e-5cd8b1e344d9,Healthcare,0.2589739973851307,47,34,451,1337,886,91.3292264920987,1381
ae614077-30a1-459e-9fd1-2656c183468c,Educational,0.5226582629905034,38,33,717,1171,454,97.14070136389695,3732
0cc8d88a-f704-4c50-b88a-b7ac9e467f4f,Residental,0.4776954381312294,20,27,287,1179,892,30.75463346719775,2349
f4821d83-6414-4eca-b9bf-37f8308b8baf,Healthcare,0.893842549449992,31,37,547,774,227,88.87457939002104,5536
94de5bf2-3af2-4109-b114-3bb5d6a052ee,Educational,0.7625251674827116,45,8,360,536,176,74.2732571004299,3130
6b024dbe-149e-4543-a2df-751733fbd617,Commercial,0.6809704959454042,49,14,322,966,644,24.898121046532097,4492
67be135e-89c4-4b04-b700-e79fe5c18a5e,Commercial,0.8556557085706589,6,42,720,1317,597,25.000849839443685,5415
1ecdccc7-cf11-4886-a69d-897cc224ebc2,Educational,0.6646478103954937,34,14,236,893,657,51.13158576831842,8634
c32ab576-109c-49ee-bf98-19c5bd673291,Healthcare,0.17636120846980818,16,1,94,363,269,26.94328054382325,8821
d7cb5482-3067-4db6-a28a-fd825cbfd93c,Educational,0.5390275829200835,50,49,10,776,766,73.7947811264983,5969
ac8d43b7-13c7-41d4-a11c-f0b88ec57298,Educational,0.5899032113635855,50,13,447,695,248,13.584338628678386,1627
b7681171-57d7-4bfc-890a-a949b7500da7,Healthcare,0.4862479333975456,12,3,702,884,182,39.01999076609496,9650
5c913d97-7521-47b5-9116-d07a9bc1045f,Residental,0.6677163084237806,19,19,135,856,721,85.82852022386672,7922
a00aeae0-0970-48c6-a136-cd86ebdaef2e,Healthcare,0.24373728101484238,6,43,366,872,506,98.25447798093414,5655
26790480-caf0-42cc-8771-27fc668bd41f,Residental,0.20821375957645616,14,8,597,868,271,58.64609502489117,7857
9872e732-7e3b-4906-8314-9c8132267e59,Educational,0.5557547417133004,18,1,39,944,905,43.088810233366836,3825
ea2b096b-e37a-421f-a9af-514f70c2d1f9,Healthcare,0.9672401188350237,18,50,566,1114,548,83.84255826115852,6222
4cdf4f7f-8934-4827-a2e9-33b43e80c119,Educational,0.6818937191484158,4,41,175,958,783,42.67330324216286,4140
795ec3a0-e90d-4628-afa7-7efe81712bcb,Healthcare,0.9537050925509165,31,43,502,1221,719,31.987914770766533,2461
ed212680-0b79-4ff7-9a25-1d56f585f083,Healthcare,0.2810635165200145,40,36,295,807,512,53.322219776867044,8181
7b965716-2cc6-4a5f-9d52-1cbc27f8d18b,Residental,0.8795099332177407,22,19,332,1191,859,42.111473404822355,2327
5ecc5edf-f547-4f4a-8784-8fa6784f43ee,Commercial,0.4869667963585368,38,2,177,1087,910,64.18643409070687,4464
b4228f75-1875-489a-9d58-3b8ab33d602b,Healthcare,0.3081380661963852,23,26,233,933,700,11.778378205776194,8476
5559c649-0d4a-4c21-9054-73ec08e069a3,Healthcare,0.7718875504991737,8,34,447,1125,678,11.161897696773519,8654
7aad7c16-dcf0-46be-a5ef-b0d3f014b9d8,Residental,0.5489777861587694,5,17,5,1399,1394,59.36563197734362,5524
ab356d90-a403-4b00-9f61-69db42161774,Healthcare,0.6226670814698688,43,32,77,1234,1157,33.59405370685176,6153
c316fe86-4ca2-4f76-be9c-afa76dff7c62,Commercial,0.571132980406101,29,32,294,307,13,36.121307256647,9266
9efa05a7-da06-40eb-94b3-cfd0cb86c78a,Educational,0.34943517185850126,34,14,594,631,37,60.17188599142269,6360
e2b74c94-e76f-41be-9d27-fea4b2d73385,Commercial,0.8738216227928619,14,31,331,515,184,23.078932554541225,8893
456f18fb-5346-4f9e-bcef-2136785aa432,Residental,0.7294086361616582,34,46,446,1160,714,40.55326885341093,6138
be121e0e-da58-4d95-8ba4-686b235d57aa,Healthcare,0.7573398057245765,49,1,344,518,174,39.680991042006546,3921
8ad41670-9e97-404e-9bc9-cd7f0ed93a0a,Educational,0.6341063362687922,31,30,212,1376,1164,93.90873815811226,3827
8a949d04-1c14-4cb6-a95b-b9c11e36f981,Educational,0.6113283861925848,2,6,367,449,82,53.06705566393029,9061
e4e3e011-5ccb-493e-8d1b-33d2c9aa1976,Educational,0.6994353099667227,39,32,581,1254,673,20.885017535896473,1360
702083f0-f920-44e6-acaa-ac42e30ed614,Commercial,0.10284814254550156,46,12,522,952,430,68.39348549434304,4958
0d6e61fd-a02b-4b53-80e9-ce37fbd50426,Educational,0.3555990947231573,32,31,13,391,378,44.70061904997267,3423
d9958a97-dacf-4b61-9a8f-4b672a6c9ff6,Healthcare,0.9033228411256783,10,41,132,139,7,97.26603603664684,4937
0be6b911-8bb6-4e8b-b9ff-dd50a873d942,Residental,0.7104749416746763,6,26,283,333,50,66.24811345135704,3856
01f84215-86e8-4eaf-8886-7723ac51ffbb,Residental,0.8279418933408951,1,1,300,983,683,29.8774994995321,3948
defd56d3-1f54-4564-8599-373850f06f30,Commercial,0.1329990728018161,25,13,621,905,284,23.136581105797656,6137
c828a220-f63a-4096-9165-796c453de6ac,Educational,0.037488874821917206,11,25,684,1020,336,42.987278582799355,9627
36a5ce9a-0383-43da-b7bf-d2439c190e58,Educational,0.2792692730288824,42,9,571,658,87,51.553306147684765,2958
360fbd57-0dae-48f1-97d5-22fe134cdd08,Healthcare,0.009548302600808412,18,3,446,1076,630,56.41935940980897,1023
01da0077-c981-4e1f-81b7-385556aded80,Residental,0.5598806380980426,32,4,573,1288,715,45.77417916215707,3786
04a06558-45e9-4a47-bdc4-23fa065da8af,Healthcare,0.5079611643414068,28,15,313,381,68,97.26348089276705,6362
45e6a058-c187-4374-b065-d06009a1dbb3,Healthcare,0.3059053321572035,5,27,435,745,310,90.43676667059552,4641
283216e0-e5c9-4918-aed9-c050001eecd1,Residental,0.6778843669845487,29,45,399,672,273,10.616501769203197,7880
b7866640-78c5-4fc1-a14e-08f115cb20ba,Healthcare,0.7030740045806463,45,26,49,442,393,42.44866415016515,5791
b9254889-530d-4a99-a287-c2e8e247b777,Residental,0.26467691491712775,27,9,319,858,539,80.23629356817558,1494
5a66f4bb-2285-475f-9b0a-c02e7740ab46,Residental,0.673978402601125,6,22,465,729,264,60.45000220357177,8504
3ebe9073-5048-44bb-97ab-2e25f7c81125,Healthcare,0.6509731140221044,6,14,471,1288,817,70.01989277940561,3381
12f77279-064f-4ce7-a08b-24d10c19ced0,Educational,0.8054562449108569,8,13,478,1036,558,21.09719505133523,9264
87b90a4a-110d-4c8f-bf46-2c4115afedcf,Commercial,0.5704439897910893,41,50,429,865,436,89.50625517556227,5956
4429d724-e5be-4895-b86a-980c92fb8840,Commercial,0.7617446652986752,8,9,41,471,430,44.63078157765042,8172
54110d12-114c-435c-983a-42cbd786b6e0,Residental,0.9757794929208752,32,46,249,358,109,96.27381311716148,4004
e4e56872-6664-4b38-bef0-6dff3a0e16d9,Commercial,0.3958767384400562,46,1,554,734,180,93.3077343347426,9685
6c805434-ce61-4189-9fbf-2d3230ed0683,Healthcare,0.5693990704556721,7,46,614,695,81,85.60320124299504,3823
f95c314e-ae1d-42ad-97eb-5812b6669d5f,Educational,0.026272525127826407,27,45,55,732,677,81.66313083794451,1390
cf54d15a-40e1-44b8-b870-df9d6231d38d,Healthcare,0.2520136656867388,37,33,195,809,614,41.60365058585903,3195
7824bbcf-f454-4a63-9cad-c238af64313b,Commercial,0.49307406431557,37,29,31,889,858,50.46812793295098,3261
19af6601-235c-4428-81ae-82ea3c8dfb85,Healthcare,0.542928312694918,45,11,143,1185,1042,63.08691265546193,1504
851a1b10-b297-4a32-b36c-bb9ac0bf71f3,Commercial,0.6698359082922167,3,2,34,632,598,86.33421593087122,4273
5ab7ae03-fcf1-4842-a7d3-b853649dfdbc,Residental,0.22278519838614053,1,32,693,1326,633,77.48620374071733,3800
2114b83d-d103-406f-a591-9cebb837b2da,Residental,0.40287803326300564,10,10,178,1341,1163,13.379746433165792,4208
03a36fd0-df84-4716-9545-0d4031242ba4,Residental,0.33511650354646483,32,16,308,984,676,98.41073135741749,4774
26fcee7c-463a-4785-99d4-b526eececa9c,Commercial,0.7086643682883486,42,34,158,467,309,59.7037090792319,7748
ceb3eb55-5ae3-42f0-84ef-749ff1ffeea7,Healthcare,0.00023583869735777085,8,12,719,1238,519,29.43013507467233,6594
f08d4e53-2c4b-4c2d-a27d-ca011f57ace9,Residental,0.5862369969994615,43,24,224,792,568,37.62486146922825,8254
db0cf971-3905-4773-80ca-4ad94b7af507,Residental,0.7149693057630919,15,24,252,1308,1056,63.33870331223735,8857
863304c5-b01d-4475-b592-a20cc9cf7ae7,Residental,0.290679151666157,32,45,705,1143,438,68.16044738639053,1710
f2d6caec-b09a-471f-85c1-8c3be6ae0255,Residental,0.95584352427295,13,45,557,1355,798,75.10943335746606,8834
e8debe49-667e-46ee-9926-204020430723,Residental,0.6607283892922311,1,10,290,1208,918,85.59825747477491,9543
8fffba5c-d37e-42ee-b735-ab849dda4795,Commercial,0.5522394909768673,2,46,556,814,258,59.816729079426366,6673
8212b6eb-795a-4dbb-8199-97d9f0e39e60,Residental,0.3056232650025317,18,36,439,443,4,43.97858737701954,5216
5117e9a0-a26e-47f4-9af1-34f8be7645a5,Healthcare,0.08347249917714872,9,10,328,805,477,78.24212021003038,2418
f1d91303-c5ac-4554-bd4f-c1c2c165409d,Commercial,0.9485434348289424,42,15,495,582,87,46.212013079631866,7611
0da1f88d-4938-4526-affc-078288488e8e,Healthcare,0.4067123429097126,4,50,308,858,550,35.55180928424291,5315
a40acf69-f45c-462d-885d-45ec38334733,Residental,0.9016972234407923,43,29,290,1065,775,40.105134799163366,3904
1c5be059-faae-47b8-8246-8d9f90c5efd2,Commercial,0.43925722325647587,40,43,461,1367,906,54.63699890661395,2301
2d614533-c9b3-4640-9ff4-8c037239cb8c,Educational,0.8364720019998464,28,50,447,1283,836,37.73159342287727,7409
5801361d-00c0-4307-8404-2c3f6483361a,Residental,0.5907375696985612,1,13,645,689,44,24.017054700455475,3212
e66b7cba-13fb-46b7-8a79-3d4ca9552f42,Educational,0.22099891014375428,36,37,95,199,104,36.53807414708261,5054
49184624-ece1-4d74-a9a5-109bcbd89cb5,Commercial,0.4966975557086659,16,3,547,1282,735,33.15235883533746,1210
3b15fdb8-1fc4-48ac-adea-151d9b8edcf4,Educational,0.8452088766709438,37,21,178,297,119,24.454717995955846,3058
61d1497c-04a4-4ed0-9f3f-dc4d0f6be2fe,Educational,0.5311953054299192,17,10,275,1433,1158,52.732615310141675,3434
59aa0e14-fc44-4fc3-9009-3a0dd25225d0,Commercial,0.5461812409927697,26,33,143,730,587,58.66151788958338,5813
c1a85eee-f116-48aa-9735-667c58e74f2f,Commercial,0.29813510519385744,14,18,516,1005,489,53.01491259523449,8511
5ca8e394-1061-4f5f-b601-9ce589cc1f04,Healthcare,0.5261955221216938,42,16,360,1438,1078,26.933899352043777,1278
968d1338-8a3c-4746-97fe-b8ffea28fd60,Residental,0.5168220810036199,37,39,51,467,416,54.11487640234923,3980
38817e81-125d-43df-b335-20f816e5a489,Commercial,0.289609483743133,30,31,74,563,489,59.04552653007616,1539
a04d0343-e033-4d18-912a-1754e71c78a9,Healthcare,0.4913532426221362,39,27,682,927,245,19.209459175009016,8402
530a9f18-c804-4903-a5fd-03e8221f9b1d,Commercial,0.6252875814083876,34,14,85,791,706,11.164572489662337,5074
f914a03b-6890-4ea5-9cba-9473c35e1113,Residental,0.7316426614002545,25,25,642,1211,569,90.812337090711,9700
e4f8cdf1-0cd4-468e-aa0a-b0f2cf140542,Residental,0.6713490600727074,47,21,245,719,474,38.81859867425074,7187
5796e6a7-361c-4052-9037-03e5464af7c9,Educational,0.8224075578708833,7,46,124,607,483,37.23039083987382,3806
9b7f0218-7233-4c0a-a65f-5fc480efe580,Commercial,0.20043934856911927,16,48,218,1308,1090,30.020810882035818,7638
957f5efb-af12-4a96-b5c3-f80eb3983cca,Educational,0.585067898768943,29,46,180,646,466,62.780822404535215,5427
d137d1f9-0a8d-47cf-afd8-405d2a0c2a69,Commercial,0.6435224185490249,21,28,454,884,430,55.19254280524383,8757
6c0249e8-b45b-48ed-8e5b-84b65918afa0,Educational,0.3201107170696824,39,16,289,996,707,42.552812441193176,4365
c53531d8-da38-4869-b390-1c49b65ffa80,Commercial,0.5621189569618161,3,42,70,618,548,40.05204032336276,3407
259de856-2f52-4ae4-8d76-a1d4d9a09631,Educational,0.1508354515345285,9,47,149,1427,1278,73.82487594025795,5921
5bcf26ca-99e5-42e9-b425-0f8e00e7b576,Healthcare,0.7143756589370389,37,15,164,400,236,98.5206386034832,7086
83efe4af-1b0e-4c30-a916-05862fb69d4b,Educational,0.44862057410548895,33,11,472,1393,921,22.952165846410654,5447
e38d79ec-9429-4b53-a482-17e41200d759,Educational,0.4153911815277239,31,33,279,351,72,31.356193118233275,5465
4938214a-43a4-4b40-8e11-369fbe235341,Commercial,0.02845152046045729,24,38,7,237,230,70.98923296538229,3438
3ad998ae-3022-430a-a35b-4b3839c23bc8,Residental,0.33198615016878996,20,11,383,1341,958,20.881884315230174,7274
49c142b9-b3ef-4061-9e98-b4ad91471235,Healthcare,0.07308978764944629,14,27,310,882,572,82.57599019017286,1679
74f9098f-abd1-47e1-83a5-8c449fae9596,Residental,0.24173708550457207,21,26,619,1029,410,55.1304964735165,1568
0cf0088a-3da1-41a1-9640-255737f7b4c1,Commercial,0.7070879492229667,12,40,202,1236,1034,40.82502875677865,3025
e8aa858a-c937-40ca-9e91-54bf939b4b6b,Healthcare,0.5926067559557375,47,32,181,444,263,97.02338383029472,1069
f4a9ef56-eb2e-4767-afb4-20119f0dfc9f,Residental,0.06258885848513274,29,4,257,890,633,57.704618631151995,1930
22893d3e-3e0e-4ff8-ae7e-cf3427fc29ce,Commercial,0.2301912785534994,41,9,152,227,75,46.629277162262134,4723
4a4eea33-269c-4979-9934-f59b717af886,Educational,0.8174548519935322,29,10,352,1348,996,28.99566405749791,2996
d278ed0a-f1f8-48a6-a573-9f5f6901f6f1,Residental,0.6945446572855644,36,38,89,856,767,20.111094822375044,1707
6511653a-9e9b-4909-a9c3-9843bba2b26f,Healthcare,0.388627010177111,45,42,216,826,610,97.99992477152941,6509
ca05c142-969a-43cd-90a3-312a99b0160a,Residental,0.5162930640461649,35,9,304,848,544,96.36264629627051,4893
f38ab9b7-042c-43f9-9f7d-32c2fa16dac7,Commercial,0.9996914702243611,28,32,68,588,520,32.96395663698314,3049
5e316def-68d1-425c-a7ff-1f3b8544efc1,Residental,0.3389908814402287,37,25,576,1299,723,17.80634079997654,4418
97168edb-c0d5-4dd2-820f-0981e8fe7ff5,Educational,0.6837172796122997,36,49,232,1141,909,68.216056147436,6375
aeb01a08-f024-446e-9d25-1062501efd44,Residental,0.8429576212874045,12,44,159,1382,1223,54.01860109269208,8671
a183f1c5-47c4-49a9-95a1-8ab294d8415c,Commercial,0.15593971841427556,9,8,135,278,143,11.480817479512126,4609
e131508c-3a87-4adf-85b7-a0bd6a1ac001,Educational,0.8698875814501065,8,2,355,862,507,23.564949319610484,2680
869ecf17-748c-402d-9a2b-3674bec868a1,Educational,0.23562885142961132,27,8,50,627,577,38.641432869686014,3799
83526065-5327-46b9-9416-2b9e309577b0,Healthcare,0.33654479867400555,48,17,664,1168,504,45.19165238108276,7753
278d1de7-1b96-482a-902d-733a174a6963,Educational,0.5170594098103244,29,44,104,415,311,88.40782648344941,7922
ff3c136b-5a6c-4733-823f-e0867fd2c90c,Residental,0.5218138377908712,19,5,26,1159,1133,79.51210408744431,5426
b2e09cb1-2149-4d17-92d1-1dc3490fe2a8,Commercial,0.39696055029929067,40,19,440,842,402,84.28206693122739,1277
10cd895c-6952-4310-b92b-3794256b381c,Commercial,0.3291560973613894,48,42,367,1139,772,84.64260453457683,5526
382700f1-cf88-48e2-80ec-6f1a5eb1f319,Educational,0.14884360353736648,2,34,483,1274,791,13.224983902736014,3337
b72ec67a-531e-41e3-a851-de48d530f96c,Commercial,0.10657870904470479,36,50,475,550,75,61.62234648159286,8672
1a964202-51d3-4d4a-829f-1414c80f31f7,Healthcare,0.42685983710116915,15,6,393,888,495,44.04430935067954,1911
fdad9302-a542-44ac-bb19-daaedd84f18f,Residental,0.5154758751895585,24,34,660,1043,383,74.01011644608926,3668
8a5a5927-88b2-4bd7-86b5-695ababcd93b,Residental,0.0009387483476637204,26,37,192,1437,1245,17.382869884906047,5670
5c7a7a6b-317c-408f-9f71-c9f94678cda8,Educational,0.057078341438062785,10,4,32,1087,1055,95.57824472269189,6086
d4bd93b5-57ee-46c2-be1d-75ded74d9d25,Residental,0.13678326302526744,7,46,484,746,262,72.41602095500444,6617
c044f95d-59fe-4a68-9e45-8718fa92e4cf,Educational,0.38835910989294675,30,24,390,915,525,89.45449180991,9456
aa80e320-4d67-45a3-851a-b2b86a5520e0,Educational,0.07391894464350979,13,49,249,907,658,86.040734980756,6710
b5075a2f-d148-43a8-8332-30f25a3e881e,Educational,0.1985892514332228,26,14,298,1186,888,71.29214598564546,2801
fd35a049-1f23-43f1-9511-c829909ed4a4,Healthcare,0.9568942711780362,31,1,192,241,49,83.22221475548294,2385
ff0411ed-e0d4-4cf9-902b-054f8301827f,Educational,0.2987230656761134,25,14,262,733,471,77.18840326704073,7167
5d42fa48-29a4-4cd5-a781-69c82fe620f4,Commercial,0.6961664224142331,3,21,226,1379,1153,14.227314029676975,1315
0000e6cf-e386-4318-ac8b-e1233c0a5641,Healthcare,0.20205351146775263,13,42,220,885,665,67.06586382996508,6484
b13b2883-d99e-4945-ba95-e072aeb4cd66,Residental,0.835252646878106,13,41,361,802,441,76.00242625058891,2150
43f86a8c-f222-4c68-b82c-329ee53e7f02,Commercial,0.5661918779646635,10,9,229,1355,1126,23.645980090895883,2718
f6442c92-708d-4248-b05b-d9c8d14e0a6b,Residental,0.1390865962371598,1,1,420,1130,710,43.00387046772397,9185
4f603cb4-4574-480d-9b81-6a3bd7662a36,Healthcare,0.6924273562516438,32,44,532,968,436,38.64006337254395,3874
9ae3de37-112d-443d-b14e-09465c15bf6a,Healthcare,0.1698321408556669,39,26,243,1317,1074,20.85709950115529,9284
a4af700a-be76-4427-9e5f-1303a48eb67f,Educational,0.27351856650267403,26,7,464,1329,865,45.04699533341976,2422
e5d42bdc-99e6-4323-8406-b82a45a72ed5,Commercial,0.20434377591164665,12,17,231,849,618,53.14436965546015,1741
fed74f6e-d2df-4449-a3f6-f23b6b108f8a,Residental,0.0995723890172191,42,9,468,619,151,52.33208067752265,2400
491024ab-b83a-42df-a083-5740aed167c7,Residental,0.14376883789261563,19,23,416,1175,759,33.190043708721866,9331
643bc1fe-c897-40d4-be71-4dcf2536a63c,Educational,0.4801874342447525,12,24,641,642,1,99.24419363537153,1341
9e1226f3-6474-442c-b4a3-bb74846a6b0d,Healthcare,0.46942134999194196,39,30,619,903,284,62.37340534018417,1669
03fb375f-5198-43b8-82a8-27417c85f1b7,Healthcare,0.9223138582972569,49,42,569,743,174,45.50512695303385,4109
ad1d4ee5-9656-4fe1-a1e9-aea737e4e7b2,Commercial,0.3879969045698174,7,1,550,1184,634,96.92217018508433,9603
620a8139-fe4e-45c0-bf56-4c6a3a14fa6f,Educational,0.345099490309277,11,6,105,667,562,62.40690407504946,9128
03c1cfb8-757f-4b7e-ad68-d856f1ba9c52,Commercial,0.8033334300362929,20,36,436,613,177,39.74095340673683,3659
cf90cfdd-f1fe-4bcd-a406-df317b0eeff0,Commercial,0.8014493398236805,45,24,706,1246,540,15.911997070403746,3374
d83dd09b-1b41-402d-9ffe-16ea13a4c92e,Educational,0.7762298519711862,13,12,10,724,714,99.01610748396155,2679
72166689-5cab-4a27-b569-d7441dcd22fb,Healthcare,0.5387720076314253,13,29,658,937,279,22.06242570299627,9190
fc6e1be3-a693-483f-93a0-9134c10b5c3a,Healthcare,0.9839577349572306,29,33,224,1099,875,61.50166003593487,6928
50dd4535-d478-4ee0-8c2e-c63499a0eaa5,Healthcare,0.6097568142000255,4,11,539,1174,635,90.98525910976724,8734
ec0b4071-ffa9-4262-b32b-4f8afc2bae9f,Commercial,0.13167069946231913,1,47,550,1008,458,51.854670985416284,9460
ee82d695-1ba8-496b-8026-65c321763f96,Healthcare,0.45851184158114144,32,23,478,853,375,57.837572641677625,1003
0d9c8853-073b-4a04-9a10-2b6ea7d10137,Educational,0.3052165713422892,16,3,205,740,535,54.67379485749305,4789
517d372b-922c-4993-af97-0a49dc92467c,Residental,0.13882561514059188,12,32,707,1060,353,45.83891270795903,5766
c6bf3549-a8d0-45ce-87e4-5402b1ed3dfd,Commercial,0.8019197910808561,35,14,414,1014,600,29.430646611474117,3891
f8ed3b5f-ada1-4517-b05f-3584b4b1ecfc,Commercial,0.1221457288520531,7,24,610,936,326,55.90656829361077,7914
d10789f3-64cd-460b-92bc-e7f1a4e21604,Healthcare,0.2739911491915221,48,24,138,908,770,30.53707031656539,4447
c663efd7-5ba2-4692-84e5-bc161e2906f7,Commercial,0.6169568707976242,44,27,369,1331,962,19.306172561170996,8061
21db85af-09e4-4bc8-92cf-852bb164650b,Healthcare,0.16102875430466057,24,32,390,1372,982,46.44041532695967,5085
d6d6dd03-35c4-425b-82ca-7beff3cbb45a,Healthcare,0.04670544687353251,25,32,88,941,853,22.51491875416906,2301
2e3b1d9e-22f1-4588-8782-bf8c0c065b78,Educational,0.8454529423088981,48,20,594,1204,610,96.92247058449242,2437
d8880d1f-1915-494e-8430-3ecdd3e24b53,Healthcare,0.4588746448415314,7,7,19,847,828,33.82732107792641,3046
9ea3b607-b263-4143-85d9-b2faba908c3c,Residental,0.5255439457706853,46,33,100,934,834,69.43853095952579,9851
ffd9f9fe-7e8e-44d6-ba90-6fb79bfcf256,Residental,0.13576041277460793,5,2,69,236,167,86.72371231403814,2592
caa52e26-0ad9-4fe3-bce0-93ea54076576,Commercial,0.14631615816897559,9,6,698,1340,642,56.92352190596796,7542
c2844957-e7e0-411f-a856-1453938faf37,Educational,0.27081364897715177,11,25,456,1195,739,31.30601750394157,5034
d03461e2-451f-45bb-a455-28aee6d67f52,Commercial,0.4508998915603929,3,7,459,676,217,52.61718663762569,7854
368c2e70-9fed-4b59-822c-85a6da23fa4b,Commercial,0.2990215078392787,29,7,535,916,381,64.03248528693754,5619
31f5b5d6-2a6a-456a-b3ec-9925fd04191c,Educational,0.4196990226918863,28,22,287,368,81,88.42559297225091,7335
c4603b82-af72-420c-89d8-c416186483cd,Residental,0.29615106651627343,48,11,510,702,192,49.78915794874327,3519
c4c976b0-c3ae-4ec8-9624-eca1e78a4190,Commercial,0.7415094961965896,23,47,671,699,28,38.48043975685853,5645
9496ced4-3c32-4114-8bae-7edd0ffa2614,Educational,0.23701467847279012,33,20,9,1379,1370,49.55687769124642,8948
827de47e-e6a5-4254-8068-f4df22747ba4,Educational,0.056883651619495934,28,4,152,291,139,25.160689550177793,5049
fa97f2fd-74de-47fc-8748-5f3ea19687e0,Educational,0.08020321413648579,33,31,46,1234,1188,14.726736789039265,6196
df5e9a40-8498-479e-a48d-5cf4c428d8aa,Commercial,0.5870548051755555,43,25,267,370,103,18.534183689613485,5749
375caac7-c731-41c7-a0fb-7ff246a88219,Educational,0.09481838181387137,8,48,46,232,186,48.146331088993286,9584
cc504d71-1e54-4c20-a5b3-74a4adf6048c,Educational,0.16806586718450933,1,50,113,873,760,93.3567176394249,8415
8871b581-feec-41ae-a665-fbe92f26cdab,Residental,0.14738501413823535,43,15,62,1295,1233,21.023014386217227,9371
fa3da107-110b-431e-8110-b259442c4f39,Commercial,0.7668716791112368,22,37,475,499,24,33.22903070536401,3891
59ef668b-252c-492d-9dae-9c671f9eb343,Healthcare,0.3709608523708223,19,48,254,1223,969,23.73801972469336,2861
8e63d0ad-4999-43ec-8845-c25e90968d20,Educational,0.5331488252188965,27,7,197,279,82,87.26475003519108,4033
c9fcd0e1-4acc-40c8-9cbc-d69b2070b6c3,Educational,0.27265050032476323,34,30,421,1019,598,55.46448874567964,5754
9956b1f0-227b-4553-8367-87481801f2fc,Commercial,0.3295114563958076,12,48,691,1315,624,22.653932725863545,2706
1994b78c-13f2-4058-a747-6364b356baa2,Residental,0.12386206702038371,26,41,666,1091,425,73.81121393690873,2327
687bb770-7e22-4b7a-8158-f867cea9dd56,Healthcare,0.406481356610764,30,15,348,1013,665,36.21717343904557,4576
80c7fd7c-4d7a-42f3-89ca-688f3ae18f7f,Commercial,0.004462949792118809,41,25,39,521,482,53.283958610073526,5346
91ea35f0-9072-47ca-97ae-db56b0323487,Healthcare,0.8188916941704136,36,23,333,781,448,88.27203456673956,4058
0a08fb5d-d272-4858-98cf-9477a19c9af8,Residental,0.21825977903669258,16,23,618,1185,567,90.23566030430997,3983
a12d2a4b-9592-4ba5-98aa-ab99fb8dcf68,Educational,0.8042090692937433,12,49,260,1007,747,65.08449948669752,5779
d39c4e9f-e0f4-4f96-b8b6-54cfffcf25e2,Educational,0.03793295477362857,42,31,45,755,710,98.39663086148387,1635
cc10cd22-f009-4d24-8d49-286e8cce8676,Commercial,0.0014371571425467744,12,1,705,1365,660,86.8404253050879,6314
bb1dc82a-fb00-489b-a940-c9ced90c4a55,Residental,0.6116555813321296,10,33,610,897,287,89.38361875804559,8658
23827a20-36d0-49d9-95da-9e9f24da5f16,Commercial,0.6638667953783531,16,34,99,562,463,21.071162901014326,3565
e6994b57-513f-45c4-ae7f-24ec560982f4,Healthcare,0.7420245762954408,36,23,653,1048,395,18.205801177921543,5245
565089cd-d180-4929-addd-3cd64a64f6e1,Educational,0.020103786708927762,26,31,625,1346,721,33.746338669046715,4229
bf8ae8ba-7689-4906-b83a-1773c44308d8,Commercial,0.865879907885378,5,15,195,813,618,80.59363414743649,6780
fc59f150-38dd-460c-8b09-36635ba0bd38,Educational,0.33467878673193285,46,33,483,512,29,70.27474494884305,7833
95492d82-84ee-4c5b-ab88-4ec292cd99a0,Commercial,0.10120172609795863,12,19,140,674,534,36.571532383958385,6938
fdea4fd2-8b25-463a-8cf0-8ab6ba6d58d0,Commercial,0.7708780513686985,39,28,262,306,44,97.13794992550032,2136
e559f3fb-a0fe-4800-a865-798258a5358b,Educational,0.5848741388069281,21,48,214,663,449,33.583218015205844,8287
8780da70-d90a-4f1a-883d-d5452b39abdf,Commercial,0.3574991856795613,2,10,310,393,83,21.984371590698416,6579
061ad956-9af6-42ca-9e0c-207555004d97,Educational,0.881626530497853,18,6,520,1336,816,12.39909958894507,3018
f7755e99-11e5-4e30-92d5-aa92a9c99d6d,Commercial,0.3351749839249045,24,33,716,1339,623,51.91822597437156,4288
17c8bf16-a5dc-48fa-87e8-96e610274e48,Healthcare,0.8380233434739625,5,22,467,531,64,36.26736486923918,3055
fc3228db-3eef-4609-8225-0c483742d3fe,Educational,0.24890854228513137,30,7,483,871,388,58.84026066307674,7421
45b1655a-ae15-438a-84a4-91a4748eb3b9,Educational,0.3496877355332513,24,3,538,1387,849,53.48779749851584,3259
816b2725-d497-429a-97f2-3138e82b8293,Residental,0.7142277273405262,7,19,335,1045,710,62.86022590388888,3039
222301fd-fb38-447d-96e0-cff43898cc06,Commercial,0.15411951890452646,30,19,472,1003,531,12.079183243590823,8955
76f0ed9f-7962-4797-bab6-dc02cdf41b01,Residental,0.4740760342047792,26,5,144,1205,1061,75.64437659719523,7870
de5ddca4-0111-423c-92b4-c0b02dfbf43b,Residental,0.13716577012333186,39,3,229,235,6,16.616711129617528,9967
3fcef052-e346-4cda-993f-0abf01696ac9,Residental,0.6181601676571528,29,14,129,802,673,59.69620060868966,4277
4a1029ca-d497-4f6b-9ef8-82ca2c958ca9,Residental,0.8372118846867022,5,23,648,1002,354,96.38178930439719,4613
daa05500-9803-4d26-a6ac-11e7d4e94308,Educational,0.8484337305644127,34,22,65,974,909,53.913931639639415,3519
b8d93888-c9bf-40a9-8902-269680d6aa88,Residental,0.6696286457182669,1,5,286,694,408,78.02615455687905,5390
674a9bc1-5a56-451e-bfc7-c99f6d320c4e,Commercial,0.6166316201429652,24,25,302,319,17,75.38335019761554,4593
333fb9f4-7c0f-44eb-acfa-ecaa0f0a34fa,Commercial,0.44649519054017106,12,40,176,473,297,30.051631646613465,6565
6a98f701-dfc2-4cb9-8b3f-54e1c4c83100,Educational,0.7998196719763936,13,43,219,752,533,19.902167466080314,6994
864b6b12-a87b-401f-8519-940acb9cc7dd,Healthcare,0.5349118426859536,38,3,95,1440,1345,59.93031567526113,4169
16015b69-b064-4f87-958f-465b4f320da2,Residental,0.057412730212098806,46,17,359,363,4,35.354590271347774,2545
c377c4b0-6abe-4901-b98b-3dc0274c0e11,Residental,0.5761332279006508,47,16,58,1349,1291,43.2915307269286,8399
b9ae8d18-3b20-4d22-8733-0a4792bc1326,Commercial,0.8023278037802207,19,17,447,584,137,62.80312862870795,7081
62d6c4ab-2fbd-45a5-af80-33a70ed465e7,Educational,0.577397834209202,37,27,228,772,544,34.357598146753205,6148
b27a5083-7049-4857-9e7e-3ea4ea968b26,Educational,0.7950083414038341,22,32,403,1285,882,91.3895583160465,7313
937eab29-cf8e-43d3-b8d6-ed77d7f88da7,Commercial,0.02700197991611486,34,27,527,771,244,42.21385288610121,7643
5a17295a-e5b7-49c5-a5ec-98bad11a925c,Educational,0.040787836692038004,7,43,197,1307,1110,16.00266103342405,7852
7f73a4d3-47f1-4936-844c-7a55385cf903,Commercial,0.9556744389100554,28,48,157,586,429,77.80023052031228,9773
9e255209-cf14-4a56-8ea5-722276d40669,Educational,0.9494757362673922,4,27,345,730,385,48.42323110781511,8455
f3803a12-1b28-47b7-85d5-04f0c87c76d9,Commercial,0.6921026113835548,11,46,179,539,360,23.447320548292815,6819
657336a6-e338-4030-8b5c-3225581d4cb7,Educational,0.7609291064869894,23,18,88,928,840,90.71716692905669,8117
d76009ef-e286-418c-94a4-053f5d8a42b1,Healthcare,0.39574763525731027,41,31,631,1405,774,33.50065842421849,5674
0434734c-5e2b-4b7c-b4be-6ca9da4def32,Educational,0.08041461424761542,48,8,406,1374,968,20.28246240960481,5963
fac095a8-c431-4047-92f0-d4740ded3b0e,Healthcare,0.9961019488445249,13,45,3,827,824,77.55516282636692,8411
a95d592a-1599-402d-ba6c-7bca028a5612,Commercial,0.3469670172528816,14,18,253,411,158,78.11181013158605,9392
54f696a1-8a52-42ec-8b57-21bb138f9764,Healthcare,0.7205778180576281,18,29,263,468,205,89.43799413932997,3211
303f3948-6b3a-4352-ba28-7e5645301304,Residental,0.9970983114098732,42,49,516,650,134,76.78754400921687,6370
2606a534-249c-406a-b049-d0a6aacdc5c3,Commercial,0.6766130616948913,6,8,355,758,403,15.645166419308195,9152
50382d0c-8994-4720-a289-b88371c01d67,Residental,0.06493189794988807,40,10,287,1398,1111,69.96436314732625,2784
3b9e7c46-2dce-4cfa-a70e-f259876aaf7a,Healthcare,0.18900610053726807,7,17,446,629,183,63.473957308522834,7528
9db8a801-a6a7-43a3-b43b-9414233363a1,Commercial,0.7154334759518322,44,25,672,688,16,48.799632609299735,8676
1c14b59f-8a53-4db9-a96b-b30467dd1782,Commercial,0.18224324129357505,39,3,555,555,0,84.03242443400055,7072
3b99b0bb-444b-43ee-8af2-21fd7e356f5d,Residental,0.5236934538934107,5,49,486,818,332,47.4184958845435,4374
6f9f65ee-5663-465c-aa24-424d7df4454a,Educational,0.8737133822998004,34,42,491,617,126,43.98066206799592,3711
99d1f5ee-3a54-4c74-9a32-e7560e1402f7,Residental,0.4146039894629816,25,12,536,1169,633,79.31504058140335,3483
b840961b-77cf-4ee8-a75f-6e48819be7d5,Residental,0.552801605557727,14,34,525,611,86,27.2622764303752,4598
4ab16bd2-9957-445d-8eb4-951a2ac10093,Healthcare,0.05956311041820328,29,42,576,1085,509,27.3028663659632,4616
ec027e66-0c15-494d-a78e-2eeeeb892e31,Commercial,0.520206484575966,39,23,42,1373,1331,53.44420862429423,1268
1452b9dd-1d93-4cdd-b7c8-5f490f6b4f03,Residental,0.5551686880170801,44,8,52,1275,1223,49.62225776922216,4196
94a4ca47-e5b6-4d19-962d-9ed27f9b7b8f,Commercial,0.6098357285604756,43,16,458,980,522,48.793185117034994,7688
4f5cb5c3-b176-455d-aae8-0fb516d5bc6b,Educational,0.3533821932865677,7,42,17,1031,1014,93.24215302189427,2710
0d125a15-97cb-4b12-b7de-8f541d8a38a6,Educational,0.40077036794889276,13,40,669,915,246,93.36286831514532,3352
be6657bd-bdfd-472d-8b3e-61102aa342fa,Healthcare,0.15259921909331564,4,45,603,1411,808,94.07146257242762,3461
3705b932-b1d7-428e-a5f9-16ff6661c01e,Commercial,0.6399529031842256,13,6,530,647,117,42.08516623765964,9908
721ce764-48da-4a06-b44f-c06b60c47403,Commercial,0.013114400904065127,16,8,308,638,330,93.22094162522475,1222
01538542-e198-407a-b582-850b98809f89,Commercial,0.38918621343445536,17,36,23,1232,1209,59.95729176883948,9110
097064d9-daff-4ff9-af76-3757eddb3646,Residental,0.023821484163980333,6,9,651,892,241,60.952021805347464,1056
442c2249-497f-4b09-a6af-04586508da1a,Commercial,0.9228337480423207,16,19,430,1123,693,76.08025587409008,5890
5714139c-7e63-4424-a689-e44f98d25e40,Educational,0.5792310430746451,45,31,388,1285,897,60.516233454718225,6852
a87fc3f8-1184-4928-bfc0-09781cf4e83a,Educational,0.16484038133279033,8,22,290,1242,952,21.1400148768235,8405
08d3238b-8878-4496-8752-1f0acee5b891,Residental,0.12076862835773006,19,19,559,1233,674,53.105170603798136,4453
f1daea17-c391-444b-920b-ce016c49a7c8,Commercial,0.2482835714720001,33,41,397,901,504,85.96502802260015,5098
70f191ff-10f6-482d-8883-1de99186de64,Educational,0.13776523938883634,4,16,211,428,217,52.520781371806784,3265
f4195afb-1eba-4349-ac0c-cd983f618342,Healthcare,0.48472057899903165,32,41,438,629,191,22.691228424969207,1050
3eaa0748-afd4-4705-8544-5e76105c0e47,Healthcare,0.08682643582942173,37,8,351,1023,672,97.67659240189883,7210
7a487bca-d2ba-4812-ab12-425ae63cd8d4,Healthcare,0.6347318876468374,2,49,375,488,113,38.193953471168236,8512
96fbf2e6-d645-4f40-8623-c0eb24eafcae,Commercial,0.9704817703239209,37,32,127,622,495,72.31476255874665,1575
3585cd9f-d628-4455-98dd-e874dbf987b2,Residental,0.05150670749937036,29,14,720,900,180,38.09482403954986,5712
6b6808a0-ff21-4188-91f9-51cb57ab973b,Residental,0.19318646314811405,40,33,669,840,171,29.94192183184225,9864
a0b1285a-bf61-426a-a23a-5b2cc63b577e,Residental,0.45270999387038724,9,1,125,1030,905,37.86944124638665,1860
584e215b-1ef0-4049-8fce-25ff9e38c4a7,Healthcare,0.19526187496484826,17,10,98,402,304,64.7443324815904,3352
8f57a325-b757-4c01-aa39-c292718f6cdc,Healthcare,0.8535879574594414,3,24,255,261,6,46.42438876482006,5335
6d67a71b-b5d0-48c8-91c6-e5f3db2df4da,Commercial,0.5339153204476905,21,18,130,1172,1042,27.111498138367644,7755
352a3b0f-656a-44fd-a249-525a17bc7796,Healthcare,0.8824356119303562,33,21,170,1354,1184,16.673619585535228,3648
d60a63a7-a157-4fd4-9660-76db5845160e,Educational,0.8519239611156169,45,31,478,605,127,21.137407872774425,9897
8e6a5264-40de-4583-b311-36cbfc16ec2e,Residental,0.5185278044542367,25,21,28,1103,1075,39.1123820514202,2277
6f1bf37c-4ed0-4ec9-94cb-3b80537ce80b,Commercial,0.7242850587277245,4,17,144,256,112,32.86385112543289,2577
65aef19f-67a4-42a7-a544-18480ae55bd2,Educational,0.710397354605468,45,1,64,1324,1260,45.18656742144143,3195
fd861ec7-5f6d-4139-89ea-fa8cdcc5a21c,Healthcare,0.18270128242710182,12,44,646,1203,557,32.169513341475195,8917
45f553fd-3e0e-419c-95c3-6559e504362a,Educational,0.9976585591251002,42,28,284,1137,853,64.13481547162368,4030
4aba8b5f-e95e-442a-9312-a8388c97fee0,Commercial,0.7491509076670623,8,39,244,512,268,17.538288661623945,1142
7ee58a2c-e97b-4c78-9a7c-b0d962378897,Commercial,0.6702881561262248,21,30,33,229,196,14.739021219881604,9215
7caf2a6d-8553-4dae-ba9c-15f2a9176032,Healthcare,0.5167550756574878,45,22,120,1090,970,17.67635440640419,9628
a1516338-686e-4eb4-bdd6-0f90b11e1e44,Healthcare,0.6811614324271347,21,45,538,608,70,22.316127020465863,1419
13b3c126-c7ce-4f2a-9a1f-8fdf413ea9f3,Healthcare,0.9223540016373165,43,36,26,1219,1193,20.81238582638328,2377
1b7fe902-6f75-438e-89d4-80b28006fa9c,Healthcare,0.2959396937955151,19,33,688,1301,613,32.39598110141845,1818
dae75e11-0b3c-41a4-8ce0-0fb7ffefe601,Residental,0.7783291195357944,9,13,473,926,453,50.426041242456044,6265
ecec6e78-260c-4689-88fb-8fc08a6c2085,Educational,0.576635010791936,12,42,254,667,413,35.47596439004899,3908
0e3a4708-07c3-40cd-9046-4c7c3edfede8,Commercial,0.9246625646761295,10,14,259,769,510,35.2773754621606,5291
6482b889-cbde-4be6-9d42-2e75d9332228,Residental,0.8502782436413325,37,49,619,972,353,45.49597542275673,2879
cb560731-db62-4ed4-80e6-6383ad23b3b4,Educational,0.152869843343151,45,37,680,968,288,43.75154687470315,4675
4ed5ea78-839d-4741-8861-f60bbbd9a665,Healthcare,0.646453004505386,26,43,493,1314,821,93.37793553446662,2720
16cb764b-f918-4eb1-a67a-bf5172c09f70,Healthcare,0.6814364917242152,10,35,685,700,15,24.34416915834189,3703
ac663e44-58bd-4f35-b59c-fdf2722922f3,Educational,0.9094575216896706,12,48,8,628,620,63.630268977652996,9157
ec841126-3912-4ed8-b176-f9fff7ebce4b,Educational,0.8302691903936137,43,15,189,497,308,19.669785003538497,5034
f17fa34c-3d3f-4afb-8af0-479da42d155f,Healthcare,0.5314636485835824,12,32,395,615,220,95.49168907567609,6415
1d3eeb0a-fd3a-4733-99ab-f7e97ec0f540,Commercial,0.44135204983245524,4,10,559,815,256,83.54224475168019,2883
d2e73ce7-f237-4f73-a4a1-83c7d1f30934,Educational,0.4547956312172641,28,26,128,257,129,14.785964233569633,7864
068d25b6-f10c-41f6-bc0d-76461f84c7e7,Educational,0.8298001903112067,48,46,333,1296,963,95.54966571610599,3571
c20b47b4-70bf-4f90-a408-55490a4b98f4,Educational,0.4952187868279686,26,24,126,1333,1207,36.138485925208826,3497
c97b1120-7818-4925-883b-f2442b3fb647,Healthcare,0.6049244190923896,34,41,224,672,448,68.31012877989728,2584
7e58f835-2106-4441-bc7a-91a33ac0898d,Educational,0.3901957744339124,10,4,680,1338,658,75.89672061385961,5126
5a58f0d8-653c-4d74-b441-a41571b31be5,Commercial,0.3376330773905988,3,36,576,974,398,81.62094669317334,3781
9166e5e3-a8cc-41a3-852d-d4344a917a0f,Commercial,0.9814170607961545,32,50,576,664,88,13.990535959408435,5471
897cda72-cd44-4eef-a2b1-5cb9a047dab9,Commercial,0.9993966956541349,3,6,4,588,584,31.126022898540576,6342
f7f85bfb-587e-402f-8bcb-52dd44c724c4,Healthcare,0.4266035146774687,20,48,108,232,124,28.028704088224863,6142
4e37a3d4-8027-4504-95d8-a0f19bb60b0d,Healthcare,0.7119268710322547,28,16,669,1353,684,63.8413271021186,3648
b8192a6c-c81d-494c-9718-3c8810104401,Residental,0.36595833782711684,10,27,163,1161,998,44.297729237570806,1940
bad1e5dd-cefb-4654-bffc-36c4ba67de17,Commercial,0.3832985741923748,26,20,124,740,616,41.828592214759,6501
f25c626d-0324-4f40-a54d-2d3793b00cb5,Educational,0.8185819584497356,47,2,526,785,259,35.11013067617492,4094
af25fe5f-abb0-483d-a860-b443acd29f15,Educational,0.06570791007597776,3,22,558,1163,605,98.10751666115732,3846
96473bbc-a2b1-48db-b8c4-3afdf3dc35cc,Commercial,0.5792328748840965,17,41,3,96,93,15.96534375531857,2311
dd019407-19bf-443d-a8de-2c5c4200b61a,Residental,0.8019212755912312,20,21,433,1177,744,93.91094701197207,6076
5fb01ba6-5554-488d-ae7a-14f8df3c1f76,Educational,0.7944876188579135,21,11,444,773,329,64.44176714337367,1125
f5e03b5f-2bb9-4d5d-bb77-26cb22f90ea1,Commercial,0.1264067418031546,8,44,337,533,196,82.6669193212161,3002
a3f43452-6d78-40fe-9586-653f79e493bd,Commercial,0.28860228494698026,23,6,206,1237,1031,72.98319885417413,4288
01006183-2d4a-4edb-9d33-5560dba8419f,Commercial,0.08313078385720174,6,48,30,1212,1182,24.41018835469231,4408
be41ea3d-c02a-428e-bb1a-6eb1a4747fe6,Residental,0.5053875046225212,37,35,40,367,327,25.23322287167232,2790
f803679c-acdf-4933-857f-acf700bb02f7,Healthcare,0.4174085659981257,9,20,32,814,782,78.45000582267645,3831
da64e69c-85e0-4134-8f81-9733568992dd,Commercial,0.8866385486523692,36,23,244,902,658,37.464139776429576,4981
ed3fcd96-2192-4cc9-8572-5d43db08a4e3,Residental,0.07615140371538753,3,15,91,314,223,88.52829123480839,6886
d22400bd-5135-4770-bec7-50e77d55ac6a,Commercial,0.6221340236165976,36,18,412,571,159,98.57174616393976,1908
59452fcc-e86a-4798-a847-129c6de3af6e,Educational,0.9737009338080029,36,20,325,1033,708,44.25953279817307,3073
ee5e851e-cd1f-465c-a695-21de28b58441,Commercial,0.07188823529992872,6,35,454,728,274,76.02765247881334,8407
608add58-0e61-44d3-a31a-b27ef9e8c848,Educational,0.719799785076143,37,10,475,1368,893,61.3080216057911,1983
2ee007a9-18fe-4f87-84b9-ed2b2bc4eeca,Residental,0.7148904276340707,7,42,54,1013,959,36.03158096895096,2551
fb680ab6-5cc0-4c9f-8b4e-de42c59e213c,Healthcare,0.033653127324641874,29,27,436,977,541,45.53019258557506,2856
fdd98c22-43e9-4f06-bfa8-c156457b5089,Educational,0.0007757521512491428,13,40,282,1066,784,27.109194815306562,8320
f56eaaa1-7c21-41cc-809a-6c209615ac21,Healthcare,0.7403171593313743,12,26,386,1114,728,75.46446322229907,2520
b978410b-5f65-469a-966a-f5f99f6dfd73,Residental,0.5671801468228077,11,49,717,948,231,42.06335908394368,6203
2734356b-6918-46ec-a607-cd67359d1d7f,Commercial,0.3609303239428945,22,20,312,653,341,71.44239992789952,5457
8a78eb54-bda7-4b43-8df4-adf9fe28df5d,Healthcare,0.946003187873173,42,6,199,597,398,10.066349849132028,3713
b590eaed-7608-4c43-9318-1714a0b74ffa,Healthcare,0.40418692088757735,39,42,101,1213,1112,21.205161162031345,7075
c430867a-6170-4d0e-8094-f91328e5fe51,Healthcare,0.9174203503687101,3,36,554,733,179,59.59716907520143,5909
2d547756-b673-4ff2-8b90-4d2b4df4ccc9,Healthcare,0.02264261630251263,15,6,633,1060,427,65.56462426990511,2171
82ffee01-ace9-4823-bb9b-2383033b65fe,Healthcare,0.8116533929088812,39,32,330,396,66,44.062809011143464,8749
c2408048-ad4f-48cd-b29e-1fdbb7bb9214,Educational,0.014375336694056218,11,34,702,1033,331,71.8518087791255,7549
d552b97b-c74e-485a-b2b8-56ce04c09c74,Residental,0.554381776810568,42,29,141,1113,972,67.39476823581444,5406
adc922a0-164a-4fb8-9132-9b06373e3e0c,Healthcare,0.5009658268668424,25,50,379,583,204,17.122765835896903,8733
efe83371-f480-43e2-b4bd-996e4df753b2,Residental,0.7111834648602674,28,49,402,650,248,80.68703333284911,9301
919b462e-e8ca-40a3-b750-8142c4046926,Commercial,0.37410985648855855,12,27,518,948,430,68.92285059610053,3412
614b4d6c-1c6b-4646-877c-3c99541628ef,Residental,0.9010695789682052,6,5,540,699,159,77.1716873188047,8381
48742a6d-102c-4290-9d70-96a609522b5f,Healthcare,0.059242341215669625,33,19,319,944,625,50.54595508165515,4855
3366dcbc-37a2-4e2b-a4d0-e8bd1ee033f9,Healthcare,0.5304804445944657,11,47,338,574,236,57.9761560146063,8365
d80f9225-3db5-4a31-9c57-3aeb82aafdb0,Residental,0.6786762502084113,47,13,338,1380,1042,10.87037180972792,9441
e792c3e6-558d-43a9-8341-9fe585e18cfe,Healthcare,0.3020287905285276,37,31,337,703,366,79.26233748711593,1415
420474e4-c50c-43f4-97a1-8ee803342d33,Commercial,0.4024096783747796,45,46,543,836,293,16.992132818531758,8818
8e415f43-13fa-42c7-a03d-41d7982ddfda,Educational,0.22928033655655766,32,10,129,327,198,82.72909956892903,2550
4bf57263-49d0-43b8-8581-5268c2640a8b,Educational,0.05908883368882489,7,42,625,675,50,13.705556455605066,2040
e18271b9-8ff0-48d8-83bb-185b12f2fd62,Residental,0.7720030495777198,41,31,450,1193,743,76.87719919964842,5774
d32d7e26-670d-4625-80f0-8750d656ad3d,Healthcare,0.08771171774776498,2,50,625,1069,444,81.02101425178306,4381
7c174b4d-f446-41d1-8aea-2ef6c5994780,Healthcare,0.3556669850323654,5,47,240,1270,1030,97.3341805929208,9322
8f88418c-385b-48b2-a464-6f5dad4b041e,Residental,0.6031928566301143,13,12,332,1430,1098,29.472500802356713,6943
56bfa58b-b36e-4ebf-8b1e-835e55d755a4,Healthcare,0.05801903659050722,36,44,511,1337,826,40.71560430169764,9006
c92c0c83-8174-4170-85d6-4f24d2575c5e,Residental,0.3923812932112718,50,17,368,1074,706,91.39328344915259,6307
047956b1-32a3-4483-b3fc-c41205f0cead,Educational,0.4111636071395254,19,28,36,88,52,99.26496168064324,2410
3bbec928-c98b-40c2-98f7-87e41b9c5451,Healthcare,0.5978902014898221,16,27,48,871,823,83.73233293932059,1518
051a6a35-40f4-45f6-8f50-87119f9e3647,Residental,0.5676029295540924,11,39,669,973,304,56.71262227110441,5145
ba10c781-b301-4216-9cb6-a4c73aae2c5b,Educational,0.5448593790648053,21,15,395,657,262,17.72170430027727,6300
9695acb0-0707-4ce7-b5ae-1fe43e9584fe,Commercial,0.9691492529016102,17,40,667,959,292,62.96113410923836,5381
cc772bae-afac-4125-8363-5995a13ff8f4,Healthcare,0.7930015910659035,29,19,28,634,606,33.92074935245806,6569
2cf4ef39-b711-41ca-8504-191d949716b8,Healthcare,0.787621420748501,11,22,460,1082,622,78.97000899731759,7869
16dc9ed5-3059-42f9-9a8f-7259ad5509ab,Educational,0.6479287868555416,8,12,332,347,15,96.89056816707313,4011
117303da-f17c-492b-9c8d-9a5e42408827,Commercial,0.9358021435665967,15,4,133,251,118,58.090070141508264,9943
a12c48ac-9331-4b19-a910-9adc8c90dd87,Educational,0.5294454699130192,44,4,447,897,450,44.10145714834372,9440
0e0b68eb-5132-410e-9f10-fbc15f168441,Educational,0.3183346584003629,13,28,28,1163,1135,99.64840943405893,8580
4dbf5155-f1d6-487d-ad3a-85207dc416b7,Residental,0.659296980699067,28,45,282,1122,840,14.23963919590129,4416
51a60a02-3b6a-4d75-a983-3f65e792c10b,Educational,0.30226887720065654,9,8,32,1364,1332,98.3122584124337,2541
7d75dbab-2815-4881-89c3-2b1a83c7a00a,Healthcare,0.7581310036076958,16,34,127,555,428,51.09188473299052,6627
494a67f4-62be-4f21-bd0d-0b017c7b2402,Educational,0.6097680859079926,1,8,497,915,418,68.61623831422835,2978
9ea82e8e-285a-44c8-9e5e-82c8815ab8b8,Commercial,0.07896684270258547,12,24,329,843,514,71.75740131356628,9030
2bdbe175-7801-41a5-aaad-908015046be6,Educational,0.10880679900782753,11,39,598,1165,567,80.30083614986003,9482
5f4eab9e-6379-4485-8424-22ad3854d712,Healthcare,0.6397874234882791,38,7,481,806,325,84.95475581605724,7103
0cfbb433-d1ad-449a-9a4f-3d30d4c61333,Healthcare,0.7445950194742418,38,14,208,1076,868,26.81772717254207,3953
7c2c3d13-6b82-4dcc-ac5e-f84a70838ab4,Educational,0.14451304807508325,24,5,567,710,143,31.984622650638485,2873
d842597a-89a8-457b-a7b9-0d620cc35646,Healthcare,0.34966906130735065,47,14,70,746,676,77.44620393511266,1926
87a82a61-ba34-4977-82c7-bfb0aff7eb47,Commercial,0.49591260196359166,39,12,189,1084,895,42.464620256979245,5625
776ccc00-3f05-4c61-a6ec-01fc9567241d,Residental,0.11072801884902383,23,25,482,992,510,19.232443288760997,1030
c86bb75b-a29a-4c88-84f1-b0855fcb98a1,Residental,0.16348960160073878,47,13,690,989,299,88.38785872050849,8328
40cd8dd0-335d-45d9-be68-3c6d40262fd1,Healthcare,0.2032621057798516,45,40,457,1217,760,95.15170966959721,7395
82bab9db-f1e3-4eb1-ae29-86e0aab3dbc8,Educational,0.4745010417389157,28,26,250,771,521,69.96748373732028,2228
165a06c6-9abb-4e9f-a9de-c18b82b61c3b,Residental,0.14921985787452696,32,1,338,748,410,19.778963179955102,1488
c3075b3d-af40-46d1-a6b4-f3200ad7d5b7,Educational,0.6767632511672446,49,11,330,362,32,65.49175564457346,9767
6a447ff6-369a-490c-8723-99e8d7e26403,Healthcare,0.6988548292015615,9,16,121,383,262,87.06912650319775,6816
74219870-f3e4-4c11-b0d0-fc4877f6137a,Commercial,0.9421012717625119,45,30,254,1289,1035,92.7056246189144,8858
6566f583-cc94-42d5-aff7-9cc178433fe5,Commercial,0.07981370108455565,48,42,348,1401,1053,18.42936300541337,7966
7ce0317a-104e-4862-b2e4-6000d586a665,Educational,0.9085085713330691,37,44,578,596,18,85.91381059966952,7293
92144994-6771-43ca-82be-2651f5642249,Healthcare,0.5972545276010353,17,10,77,1434,1357,16.695461241519553,3109
9427abd1-fc85-4bbb-8f2e-19d69cc450b4,Educational,0.34481734384546137,19,28,431,1090,659,45.74069063521247,6199
7e839855-48a0-4b93-992c-e544a511977c,Commercial,0.6273054758073354,30,40,495,1403,908,35.785910914742004,4280
f1928af9-74b6-41ba-ab34-01a54bbe15a0,Healthcare,0.27868963745301145,41,20,26,169,143,14.727951880539951,1543
f13e8b61-b9d8-4778-965c-d4ed20484751,Educational,0.11135922440211721,6,17,387,1141,754,47.388368124399896,4411
69078cad-e555-4b41-9407-1cdc0bfecee0,Educational,0.4703978602815464,39,41,424,709,285,97.24746962763523,4175
acff2ab6-6cb6-46a5-bef5-53baeb5cc55b,Residental,0.9255382254746344,38,38,461,930,469,20.883820509949878,5687
89ca4816-a095-43f4-b134-12761795d2ab,Educational,0.7548433174951443,38,11,645,1294,649,21.089310996453023,8205
7fbf8b08-a452-4133-a108-1b87da724b9b,Educational,0.5090592195088449,49,45,298,707,409,78.6639882631806,4684
06dda9db-49be-4b62-9a58-1ecd4ca67976,Commercial,0.20649507112520504,31,49,364,813,449,83.75980610059301,3469
1f315c5e-ba2f-4803-912a-a83d3d924dae,Educational,0.07605673161734372,39,32,521,653,132,70.06569133784905,3176
322d7882-6cc6-42b2-a6d4-30c6f8361bc8,Educational,0.49659356490575124,7,27,505,560,55,34.59237165717601,6467
28593bb3-76f1-4e88-81a5-99f9fe20d9d5,Commercial,0.3483330959028146,1,22,132,662,530,54.3866399760945,3953
66c851c2-fa1b-48de-9820-ff180df31b07,Healthcare,0.1663577256712634,8,9,397,733,336,22.482973387554107,1862
1adc31b4-f5a0-43b1-8a9f-dc7eea3012b2,Healthcare,0.8118095257514636,41,33,167,934,767,15.892328518541081,3223
6f588d81-4c9f-4f6e-8793-c323c5ec8108,Healthcare,0.8010549166050137,20,17,109,586,477,61.45112726917247,3122
af1b2f93-2faf-4134-88c9-d1040d81004e,Healthcare,0.39536055094143907,40,4,151,370,219,46.12268359531425,6366
9ca080de-e837-4773-aa11-1d9ce3159a86,Healthcare,0.45483104068925206,35,42,533,557,24,28.26666383067431,2825
d55a3176-b80c-46e4-ad9f-6a2699f409c3,Commercial,0.6963483319714836,3,15,350,427,77,40.791090811478526,2206
7d0300db-e9cd-49da-b778-b213b8c34691,Healthcare,0.06050919658165865,16,13,322,719,397,15.998520038324529,6573
47b3066d-b272-4e3b-b72d-8b1f1298857f,Residental,0.9522664352659589,13,17,552,619,67,25.826603076245135,5426
21f7726b-4110-47f4-b33c-af5871d2db88,Healthcare,0.08877200867940083,37,48,374,419,45,49.48418415264508,2314
19e2f6ac-5c51-4488-90bc-724428dcde94,Commercial,0.27799060609688364,15,41,57,68,11,76.31088250797114,2351
f2a4d286-034e-4926-bc3a-495903d8cd39,Commercial,0.3797489154190159,46,31,352,1137,785,83.59581105383936,9575
51d2c125-a654-4478-be19-cb37544275c9,Healthcare,0.059365486498506814,19,41,684,887,203,50.43151854919557,8063
09d9314e-4569-49a4-b62a-b36972f12807,Residental,0.8104960348118667,48,40,133,1091,958,28.128075244023098,7769
96529be7-9d93-4bd4-9075-ae19fa2491d8,Residental,0.9862215280334949,12,28,453,957,504,43.99912474615348,5772
b3756b21-c656-4948-87ab-38b39a7a9bb0,Residental,0.8266430162324242,19,11,611,1206,595,58.97855598310894,1126
ddd90d20-af64-4d9f-9451-96e30a3f3e8d,Educational,0.18049046612019048,7,31,714,1081,367,35.83221701648526,4652
b4893d02-ffe7-41d3-9556-6a7466d09b9c,Residental,0.48897796522174,44,4,466,1274,808,32.0136033203801,3503
354cb626-db88-468d-88ff-94c80254743f,Residental,0.687812078719939,42,11,710,1303,593,79.34852723904801,9343
bfc26af3-30ad-4b85-b58d-e08181670400,Residental,0.030124852225404952,31,7,681,731,50,75.05542485235691,8784
83090555-3c61-40a5-9be3-2fa0bee061d9,Healthcare,0.3054662521531609,6,21,599,1022,423,67.37074380945612,7383
2600b685-5f2e-4503-a02f-eb65164b4d86,Residental,0.6931477675014104,8,50,225,865,640,84.86432575998057,5382
d0e13d36-587c-4d4a-90e3-7c54e13e0854,Commercial,0.9320471252682183,44,30,75,1345,1270,39.449878003675806,7226
7f084bd8-21c5-466b-9ec3-0d4db7ef21e0,Educational,0.3180425525243059,13,8,239,539,300,67.99489863671224,7132
b3569357-46ac-432e-b890-e9eb13616eec,Healthcare,0.3696404058742575,26,16,245,354,109,48.21250579189898,3949
c0d7cb07-0a50-4778-8e98-9204016a7e35,Healthcare,0.5267189973960507,2,24,640,1336,696,78.39410634372011,5521
a511a984-76dd-41ba-95dd-96c5fc292487,Educational,0.0217741982520423,23,6,53,1294,1241,43.5903944983412,5156
d69f18ef-c900-4956-95ab-a8bc9e977b02,Commercial,0.024379013603675004,21,16,578,983,405,62.476167002362736,9451
3788d8cc-64cd-4708-828b-c7be373cbe71,Educational,0.7414479777685158,26,34,183,433,250,54.68990142804306,3727
0ab30824-71c4-4cbe-b1be-e9c04efd4c2b,Residental,0.15149986804363746,21,31,377,1328,951,37.034881899525665,5811
439cb5ee-8776-410b-9d83-5a8358e2bab0,Healthcare,0.9225382563949903,32,28,429,801,372,41.650297541222386,5850
30fe4e4b-66e0-4e59-bf95-d3c23cd8ac4b,Healthcare,0.6988683356230615,22,37,394,875,481,91.45549552126307,1226
fc2306ee-20ff-4285-84b6-ffdfb9d55211,Commercial,0.750036184618231,14,27,390,485,95,17.031463638084492,9870
f20bcd32-6acf-41d0-ad78-a77cd1aea484,Educational,0.9822580115176633,23,6,577,1204,627,38.710991433093085,6659
78cdb523-c3ea-486f-ac33-6e90d3d2dfad,Commercial,0.7164411063877003,19,45,221,437,216,26.144402878703424,2817
a7113be1-9cf3-432d-a00a-1af431cd307d,Educational,0.06150697973362518,40,26,88,1334,1246,71.70302970002821,3496
49ab7e77-c3d3-49da-a3c6-77b6f8839fa2,Residental,0.7533138337834431,9,50,192,1368,1176,95.66487329837005,6822
8b199262-a7a3-40e6-89e4-79b27c645a7d,Healthcare,0.19519116461407982,34,33,143,561,418,76.61796582368902,1466
96b11ef2-f288-491c-878a-8950f4c85c97,Residental,0.5838390724750749,25,14,285,757,472,70.65567759065337,3414
9a55839d-f94b-48e4-9c34-8cdb2e21ece8,Educational,0.8782484786877689,20,3,223,1043,820,83.36873935660606,5161
99ea1af5-6d22-44ec-a191-49a1c8ce1b18,Commercial,0.3014823554626074,38,24,595,658,63,18.14546420675299,6669
a531c902-6715-4a74-a691-19804277fa92,Educational,0.3392569565472219,38,48,171,467,296,29.70076730074034,7295
f4272d8c-f88e-42b8-b015-c993d703b279,Residental,0.09972351787529798,30,36,349,985,636,26.763253046216366,5686
e158807b-d652-42e1-8407-ef050a3eb7fa,Educational,0.8118121192062493,33,33,603,1215,612,89.0920520110637,4623
e6a46225-1a9f-483a-822e-d582aaaa9d97,Healthcare,0.5486690984283031,9,33,528,1173,645,73.37521625733673,2516
1ce6d78e-106e-4b25-ba4a-961fbe1a1b12,Commercial,0.878755258428793,27,33,456,1080,624,22.472039657022528,2969
81df2981-1aee-4975-a831-dc8b9882fb44,Commercial,0.0497531808620949,10,43,294,1328,1034,87.99809087797226,1753
e4b54894-266f-4cf9-9915-52f657ab640c,Healthcare,0.7790645705717963,17,42,695,889,194,12.592978552316062,1055
0bcb0f3d-02fd-4ede-b343-1ccbbef39b2a,Residental,0.6078408803056183,25,29,693,1243,550,82.39849139366373,4362
343fc4f6-1e52-44a9-9082-110fed46bf23,Healthcare,0.6519724233501093,13,43,294,939,645,55.051239725535375,3666
f515a7d5-96f7-4da9-ae30-85bf8a60f9ec,Healthcare,0.06428250483195708,42,29,392,643,251,67.87059159577639,1726
d8020620-5aa1-4588-93c0-ffa7ec2f2b00,Residental,0.5075608530259732,48,3,159,621,462,82.73551518309655,8512
79d29d6c-e9d7-437e-9ffe-ed78e9d81b1f,Healthcare,0.14596876820564675,7,32,132,647,515,36.6693978075138,4313
d3c0b706-bcf4-46e7-9f56-551d860ff0cb,Educational,0.372980455321417,2,21,650,1147,497,41.30566059914065,2509
bc8ec040-c122-44a7-9b01-86ac1ebc530f,Healthcare,0.3224285790064002,14,37,163,1041,878,25.07128468488095,6012
038699bb-ee2b-466d-b061-1ce82b11e612,Educational,0.26477253885070795,15,44,714,1288,574,56.089465153889286,6850
a2456f47-fdc9-45a5-a57c-f9fd1741df40,Healthcare,0.5651149321337086,11,23,137,1305,1168,51.30729870952652,9469
973bc536-d764-4cd9-8535-8d596884dcf7,Commercial,0.1421640378532617,22,25,32,82,50,96.5396636211981,2807
a8832daa-8820-4597-9667-62783070155a,Residental,0.29520067652289705,23,47,608,1115,507,39.844236216441274,2024
fdb2c12b-b471-4838-81f7-363604ddb0c0,Commercial,0.7535769988127612,17,3,390,1302,912,48.563894430897044,3642
02e0bdf4-4e2b-490d-8cb5-8e2d951320ef,Educational,0.32288132529808256,22,40,424,688,264,60.2136932684568,4211
7e0d8402-d6db-439c-9fb5-206a79a86fd2,Residental,0.08500407548725875,7,26,66,1360,1294,10.367405447358943,8301
1d29d590-3e51-4c43-bff5-81a6fad2fd33,Residental,0.3085561249283636,25,15,700,863,163,67.24534578901992,1352
9550c327-15da-460b-b8f1-928fc28f4afa,Educational,0.538791484005928,38,24,711,840,129,65.59522801648313,5361
f03db5d7-0ae4-4579-b829-b1d2fb8e7900,Healthcare,0.01178479006769173,40,26,550,741,191,28.232557325725068,3618
81b53a00-50d8-4663-bdf7-7a5aa215213b,Commercial,0.5680705965055435,6,21,150,876,726,17.369362511522674,7745
094c1c17-a4ee-4137-8c25-5949554be6e7,Commercial,0.4767507459589294,24,32,114,1204,1090,22.90800809604258,2672
72fa71e3-ba5b-4be9-b1fd-ce3bc65cfd24,Residental,0.035946232148369894,39,37,82,779,697,90.72711061483581,6086
fd28d9dd-6770-4ec1-a814-34bf56383da0,Residental,0.8510179016858029,15,27,645,854,209,24.505188450477824,8389
a3b2aebe-a97c-44c0-9105-a764d0adc91c,Healthcare,0.4225674127705328,1,50,546,1084,538,38.390558150753336,7814
dbc56649-acc1-4146-a2da-f9e4de38f5ee,Educational,0.853580502691071,44,25,58,1188,1130,70.0212408426442,6691
a99502f0-a6f4-4887-a384-e33335989f39,Healthcare,0.8905795734031968,18,23,296,413,117,93.09523833570618,4984
383325ae-fddd-4268-951f-3153dfd2708e,Residental,0.5809716813112227,11,12,131,516,385,75.63943884837568,3890
2c7d9eba-f738-4823-8580-bc753da456e3,Healthcare,0.5583780318701507,43,28,181,205,24,73.80644533099215,8656
1d470b03-c9f2-41f1-8aa6-1dc63e641545,Healthcare,0.21183057783021908,10,25,322,454,132,18.947857583297875,4106
c1d9bce6-2c1c-46f7-b763-32cf69541681,Residental,0.42389031946216216,1,7,163,357,194,69.29924556209778,7510
ac837317-a578-486f-ba68-49cd544becf8,Residental,0.2153900168455788,47,45,164,735,571,30.835770886375457,1377
11ddd847-8f6b-4a93-821f-6aee14b12a2f,Educational,0.9841926815060482,38,3,630,1382,752,27.545300580333226,2858
bdca8c54-8932-4230-9667-74e2012b0158,Healthcare,0.5100739372871052,28,34,602,745,143,17.198040963314533,7907
3101b2a1-cfea-4273-bab1-6559f004bc00,Commercial,0.8522932924170461,37,48,61,410,349,96.08436040720268,7196
05af0690-03d9-440f-8c16-23d04b366dc5,Commercial,0.21999375434255508,32,21,605,1178,573,71.15246221189858,2144
045f324c-dcf8-4161-ad37-7004960108cd,Residental,0.1921517607647243,25,1,209,891,682,95.32955185254568,6444
425b49e2-1b86-4d7d-af4a-453b7bae3946,Commercial,0.5665639147910912,9,13,433,594,161,47.4641407679003,9502
6d70d29e-8f5e-4bfc-8ae7-3847ecbcb26c,Educational,0.22058725297518,6,5,564,978,414,72.91919281697334,8175
33302ad7-604b-47f3-b6e4-a6890ef213de,Healthcare,0.5450288003780732,9,11,556,608,52,15.85067209363623,7909
952f4d7a-802b-4503-8a13-814f4b9d57dc,Educational,0.9661702279246961,20,22,307,688,381,37.807521486916635,7748
d2db51a1-7dec-466c-bd1d-ddf6d2f50eb1,Healthcare,0.3786864427003609,15,32,215,1013,798,92.19611719670907,9739
91ac3cdf-b527-498e-9cd8-6e7095e8f3e7,Commercial,0.6178330813269853,41,29,63,1076,1013,88.75897305853474,9538
e953d54b-b9ac-42d9-9f7b-02af79a81ab7,Commercial,0.4456779965916322,5,29,270,1149,879,26.58203408022496,5671
2e07357f-6a7d-44a9-9683-8f7c7ed783c2,Residental,0.5945719199381996,6,5,487,1364,877,50.822015471081194,8942
04a65898-94db-4260-9d81-efc104024291,Healthcare,0.16843789826425482,28,34,232,390,158,86.79577489747862,2305
83f0e257-e741-43bd-8ac2-59a88be5fb60,Healthcare,0.09163884863414218,18,28,390,568,178,52.89960491946867,2856
547a3a24-a21c-4b9f-88ed-b4c2689eefcd,Educational,0.6957662176881074,47,19,131,162,31,72.19219757798834,3058
33731900-7c38-4e28-a8a0-137575d0af4d,Healthcare,0.14862768318851516,32,37,695,744,49,45.51271190228291,9217
5b75d756-4a76-4626-b8ac-7047d16b2370,Residental,0.13529465372495186,48,1,208,866,658,46.65546127267792,2686
e74af327-fad7-4929-9955-97e779efab61,Healthcare,0.1172917950451593,17,36,541,1275,734,43.74361930519626,9613
597178f5-9560-476f-9c3d-7fbd576d6116,Residental,0.19117928045405008,4,46,256,1429,1173,52.096339573827606,5722
13d9b549-3cb2-4ac2-969c-82042b36cd75,Healthcare,0.3926585699513401,17,21,365,400,35,14.668888616316575,6256
533d8946-90fb-4a69-99bd-e55c3a16119a,Educational,0.8015265401848718,2,15,491,1179,688,43.59138453774915,4595
c8dafa92-99e1-4942-b0b4-5293b4a45699,Healthcare,0.9504659257886133,28,27,506,1385,879,70.33538389685907,4734
b7e719ac-013b-405a-9288-253406a6f9ef,Residental,0.5022247647431151,32,2,294,956,662,84.00951092633773,5525
61cd6eb1-5561-438f-b33b-9f68845955c7,Healthcare,0.6170504864440333,20,32,706,888,182,68.94121803896458,8050
8bec0aeb-71c6-4cb6-a67f-318a7e897180,Residental,0.01918725640297836,18,47,152,291,139,73.04543942140995,6632
c8892170-e4f6-4993-99aa-286d0ca742b1,Residental,0.9455960741764725,23,48,49,1295,1246,74.71208393235818,7875
014fd397-c6cd-4c89-82b0-49429567a2f6,Commercial,0.4482851220200649,33,39,382,1116,734,13.897410046154342,7395
55b06907-a642-456d-aca7-83a41e2fd13d,Commercial,0.733137148415488,24,38,380,1346,966,90.19668820911754,5739
ee9f6dc2-29ff-4140-8a2c-cbc084fd34e6,Commercial,0.18522575017348275,25,45,326,1242,916,94.62509692398044,1998
5d538a61-07ec-40e8-a818-ad634768b17d,Healthcare,0.12761938944344908,43,19,247,1075,828,78.87852256681722,3574
8c6d0c28-506f-4601-9d40-988fb3f1eecc,Commercial,0.9902161770328558,39,25,596,1130,534,55.77851535757157,2351
d81c48df-7434-47e6-9f15-501f91174877,Healthcare,0.9252139774950965,5,8,535,987,452,13.624051042133491,7328
49a74f6c-99c3-4a69-a3c5-6b39d4f0a9f6,Commercial,0.5934465283251823,28,19,224,311,87,14.773701034960137,7038
2c0aec11-78ec-4294-9124-6f840281d5c8,Commercial,0.2780255135305454,50,18,625,1258,633,64.12272257283749,1841
908ea7f8-2d6c-46fc-809e-7a45bd3a0a4b,Educational,0.727195627053345,30,8,106,820,714,50.230732827993485,4857
1da690ee-02c5-45df-918b-e2a2b6563402,Residental,0.6826174011977475,6,44,378,1385,1007,77.32157427989385,7681
4b236c92-cc00-4867-92a1-91a6b814ecd4,Healthcare,0.863370637316514,28,23,197,603,406,18.423477295178007,2354
d72119a9-ca80-40b1-89fd-d620e0e7eb79,Commercial,0.9670560229090597,27,45,584,852,268,96.34159669983416,2118
490d39b4-da56-4c66-ab1a-31758602745b,Educational,0.8728585150961023,8,38,687,906,219,52.70054847566817,9227
dffbbc58-0c81-45fa-af2c-cb69eb86558b,Educational,0.9627081763569566,6,37,603,797,194,82.2692279368934,9327
10547caf-f6e1-4a07-b67c-9f9ff6fcd767,Healthcare,0.27525856345317534,12,15,649,1248,599,67.73642284384111,9720
c82b1dc1-bd85-4a29-924d-79bee4cf62bc,Commercial,0.6550378843430879,43,35,195,563,368,61.24175789344781,7328
8bf11d48-e25a-437b-9bf7-6b5825c77517,Commercial,0.38169393163641263,13,36,284,1222,938,88.9395548630122,8693
59998cc4-d64a-4e88-b1b4-dae935093625,Residental,0.44132638561441173,7,13,48,583,535,71.77778575164764,3475
cc991025-395f-45e2-bfce-13422bbe10e6,Educational,0.5601084477307836,40,37,333,770,437,24.720046555180133,4457
ed4227a5-f76e-4800-8e2a-2c2608334293,Residental,0.5487621942137835,48,4,229,1088,859,26.4116051987268,1187
df1f0ba5-7527-4f4f-86aa-aa8f88d77357,Educational,0.2867726796272373,15,37,149,375,226,47.052722000842394,2989
8a55029c-bc17-4551-b2ea-7af0e8d1391e,Residental,0.37227539228586914,23,36,336,695,359,57.20081974729197,1260
ab2cb9a3-5402-4ea2-ab9d-3c0e81445d9c,Healthcare,0.14211371639039994,9,34,553,943,390,71.32807870583838,6277
88da2d7f-0903-4b04-ba65-a8656c394ce1,Commercial,0.020869842696489505,47,37,528,1396,868,19.611897694179135,9858
a37dac4a-41b5-484a-bf44-436a8aa5113c,Residental,0.07066672327235002,20,26,504,1265,761,76.93042317631445,2083
cc1af512-8e9b-4548-a4be-cbc1bf957e69,Residental,0.570086514098377,19,22,6,115,109,14.612334730021928,4421
84585f6b-b830-4e8b-a895-6365b6903717,Commercial,0.4239882239734075,2,11,64,845,781,80.03358171324166,8300
0e403877-d01e-4bfb-bb19-fb662cc15394,Educational,0.924113287041778,35,29,4,1408,1404,32.040727933224716,4084
e128e1e4-11fd-420c-9813-959f3d8256da,Commercial,0.8863843914472045,37,25,123,1221,1098,13.191277511991208,8720
3a88ffec-b077-4dc9-97ec-05fb1d71422f,Educational,0.011586243158548837,5,28,402,1278,876,20.43313918480831,9657
68bb81e3-508c-4ae6-8a35-7387801f500b,Healthcare,0.11431080234874114,24,31,668,681,13,47.777362541746975,7216
a32b9171-dbfb-41d9-aceb-dff2cd3ac59d,Educational,0.1694227582037846,11,32,67,1351,1284,94.89109732428611,6577
6cb8919d-18d2-42db-ada2-c351830e11ae,Residental,0.10001640814110524,38,38,423,1324,901,32.27684855133363,9081
8e233671-8087-4569-8c3b-aeefb24e96be,Educational,0.6778593117042745,42,46,626,1022,396,65.99485060208507,9298
e710f9c2-282d-41f7-bfbb-7c44f9a07469,Healthcare,0.30855718817937816,25,42,110,1399,1289,26.906090791562022,2554
67ec66b9-b4cd-4b2d-b211-9beb30a41066,Residental,0.788617259934348,47,30,476,1378,902,14.022705191114593,2678
7a97769c-ad40-47f2-9ee3-0eee58efba82,Commercial,0.7167962902939262,1,25,649,1276,627,54.66722823588463,3619
27f55695-c7ac-4038-803e-bde8d25c19a4,Educational,0.04321329392490658,13,9,381,1034,653,48.328477437820254,2373
fa841a3a-cddc-457b-b90f-0f6a47c33e05,Commercial,0.8981909879624096,20,8,550,907,357,27.34419531377462,2690
a4e0ae6e-3d7a-4fd7-bff7-0bdc9c7330fc,Educational,0.640939382641093,3,49,458,731,273,39.91918375778009,3140
bbe477ae-9c36-42cb-8f17-bb8dc789d0d0,Residental,0.8310793099240215,46,18,658,780,122,19.276620936511446,4389
397e481b-e754-4221-96d3-b22deb6d7601,Educational,0.7763454673270259,30,20,566,916,350,40.66560178879235,3334
638c2c8b-854c-48a4-bc3c-48cb1aa60666,Educational,0.124493531747225,20,23,460,1333,873,44.22142812552671,9990
94ce647f-77b3-4569-84a7-57e1fb984133,Healthcare,0.5221718767870911,10,2,534,1348,814,12.10008440155934,6288
5298769e-cbd5-4b64-921a-df16527d78ba,Commercial,0.7999004397517279,8,15,226,1408,1182,75.83647257292581,8420
d4c8cba3-05a0-470f-9c47-221b554bfdf4,Residental,0.09064022727533982,27,13,22,748,726,44.20598996514362,3414
97ebe81f-d823-4a98-bc41-c2bc8e59dca2,Residental,0.35028306625208405,12,23,473,791,318,82.29896178605004,1436
1086f564-3436-461d-8e7a-fd31cb855ddc,Commercial,0.7235803920118143,10,33,568,632,64,21.972567556674072,7928
5d6fd542-f5a4-475b-ae1b-a790925e9d51,Residental,0.21479337302784662,34,25,140,1059,919,28.224765719422173,6766
726f84e1-a8c3-4c28-a9a0-bbd2eba8adcc,Residental,0.7932802061633024,32,9,43,920,877,30.769719942865954,8701
794b1e61-8c80-4bf7-9d59-848bc19ea190,Residental,0.6120668666254665,16,5,565,657,92,23.889460992426464,8458
710ea0ef-e67b-4e13-a73d-e7fbcb04b264,Residental,0.6415241767986419,36,30,22,1387,1365,86.17633917549084,3124
f0dbe481-c406-450d-923e-542e1ecdf527,Commercial,0.9899879286043772,20,20,430,578,148,61.71690291909103,5309
b686a927-ca3b-4ba5-96fb-a14ec45992b0,Commercial,0.2239280205790779,45,27,440,911,471,93.13899500441721,2553
9b06bf7b-4754-4dc9-97e9-528f7886e39a,Residental,0.8282106931013364,31,39,145,1090,945,71.668298867201,4178
0c8a6d27-b6dd-4039-ab49-2908d98e78cf,Educational,0.13072008214820208,48,18,604,934,330,39.53145910674709,7135
7c9abf57-5dce-45e7-9392-d65d1cba545c,Healthcare,0.8505446669987304,27,16,671,1381,710,19.256972434319003,2087
b33815d9-9503-4a53-b837-7f59eeb120d8,Commercial,0.787758812049039,2,42,351,720,369,27.662851197950534,8098
8e401dd8-ffff-45b4-ab5a-a92dcf731f59,Educational,0.6538198093388323,21,14,42,61,19,20.489934298492592,1960
bbe8f556-0a42-460f-a863-d47d7a6d2492,Commercial,0.48806787972636323,48,45,46,1222,1176,99.03943238896784,9755
b54bcdb0-2ed8-4330-9dd1-80670fe6cead,Residental,0.43685614104352566,14,19,614,1077,463,52.756762108215675,8586
7634481c-d8e3-4a01-88b5-f4314803522d,Commercial,0.9262952846861952,3,25,5,1024,1019,99.85563807217713,2059
f3b24256-bb07-45b8-bd1d-74d5a85f6a3b,Residental,0.22412203427687905,46,29,217,1336,1119,81.74750730654128,5318
0a13ccd0-772a-468c-80ee-0f56e6eab9ea,Healthcare,0.06300149633102448,3,33,131,1047,916,63.6381489360766,1253
f6eae236-5789-4267-b738-cb991c9ba348,Educational,0.7310946278167745,26,2,322,759,437,80.34157281699072,6404
88499b1a-7398-46b4-9058-f45e454834f0,Residental,0.33778016594116334,10,48,135,240,105,54.4804186670117,3945
018304ef-7c57-4cd2-8ed3-fb17777e11e9,Residental,0.3851320764884283,22,17,364,1101,737,91.43249094031216,8156
d00989fa-61fe-4191-90a6-4550b19b406f,Commercial,0.44140423534912976,33,3,307,587,280,68.24459972693937,5488
11260c66-3ec4-4e53-9e6d-182ad9f7e916,Commercial,0.3507335919469333,23,45,323,1355,1032,95.82859229854516,5588
58c15fe7-a298-402d-8dce-aa368571ffe2,Commercial,0.4105933813513689,15,41,515,1264,749,54.725634453270466,3895
697453da-68bd-4891-a429-52d6f4b2eaf2,Commercial,0.589309013026773,41,50,420,694,274,54.4274063852424,9384
8a3c2560-1bc6-4eae-b8f3-9959d29cc075,Healthcare,0.27102196035331594,35,37,554,1433,879,72.0981496173816,4746
8e9d8f8e-7c2b-4550-be4b-2cf28b2c9f7a,Educational,0.8568445163288568,48,37,295,401,106,67.48948657385027,8860
b94e2cd8-a6ac-4c77-b0a2-a5a7b58ad072,Commercial,0.11909636961930048,26,5,547,632,85,80.25070906856136,4507
6a6b21d7-529f-4838-9654-514cc183fefb,Residental,0.11591099635196545,47,2,58,235,177,25.778027307893822,1836
979beaa0-c0dc-49aa-b85d-4728fcb1c998,Educational,0.34873909793310165,17,20,388,1404,1016,43.664469018409555,6484
f45cffe9-96ff-4c6e-a0c0-3c56ecf51122,Commercial,0.6040386272953258,15,18,717,726,9,34.75042662856889,3941
c1e00dcd-192a-41c1-bb06-dcbd188bfc1a,Healthcare,0.22880555650648593,27,27,704,1081,377,47.46023683071528,4490
adf83909-502e-48bc-b71f-6f9c9c4da474,Commercial,0.5913502156685922,42,7,508,1168,660,64.51786295105887,7739
ec875035-b4a8-4fa4-921a-5a7e7fbd42e6,Healthcare,0.28287820161373456,19,35,318,558,240,22.48022149720424,9957
0c4f4d6c-75ee-44c6-bf2d-44a89602253c,Residental,0.0784804705114015,43,49,80,483,403,46.879586242041015,4483
119bbf0a-f4e7-404f-a15f-0cc858fdd14f,Healthcare,0.6631786695529093,36,26,583,836,253,56.60406348765838,6470
20fb2a6c-dc0c-42c5-a786-1a7ad9eebffb,Healthcare,0.23455318920605606,49,49,651,804,153,89.55675008164208,2106
c557f63d-eeaa-4e7e-a9dd-9d443050a1de,Healthcare,0.18389936153409114,17,36,311,1215,904,93.06186551413202,2863
73ede73d-f1d2-4015-93f3-309818ccdd5f,Residental,0.33357238975852765,34,7,306,552,246,59.56402410637761,2410
a9b6e629-425a-4744-a272-47447eb5c335,Educational,0.06726877266753417,10,21,212,1222,1010,85.75646024911984,3532
5cd94e07-d706-4233-a9b1-7d73d915ae08,Commercial,0.9134818403335063,10,40,600,677,77,36.47444723941144,6716
4a10746c-e8a6-4e03-a567-d4e9e64931e8,Residental,0.8889784130189821,9,21,656,1075,419,77.54938873696779,6634
0f4705d4-e87a-48e5-8447-650703cc25d9,Residental,0.6143476059418116,30,29,138,457,319,49.749657292807775,5713
3379ee09-e26e-48c2-8523-d0ae06b76f65,Educational,0.6275005942823585,29,9,176,1134,958,33.55043008786612,3677
21e765b9-14e6-4055-8cb4-05546eb9692b,Educational,0.39995600482000604,26,26,125,808,683,79.83353618939904,6281
d59e7abc-009e-4882-8809-29e8fe78b87c,Educational,0.8511427654613047,22,49,265,758,493,68.70253265088763,2836
4c1b4439-870a-499b-bb4d-efc8bc2f2be9,Commercial,0.30406380956558154,3,31,352,1284,932,11.77752938015941,6954
6d770313-ead3-4ae8-bd7e-a8d642dab083,Commercial,0.7377377250462056,26,38,600,626,26,64.19149272188483,5302
837bad90-e267-4682-ba46-a89da6a268ae,Residental,0.41934381881729355,28,2,610,1340,730,99.08122084912357,3075
b4da5c06-c944-48e5-8913-8af3514928c8,Healthcare,0.3508014941873274,8,13,630,1107,477,62.72880550309923,4748
66cd36f5-bd26-4472-893b-be72312502a0,Healthcare,0.6456276457005663,36,40,143,889,746,68.59856039043184,1275
bb7bceb2-4d97-4aa2-a546-26512dd66bfe,Educational,0.9278988393694758,40,32,376,1064,688,20.940788403746964,2956
e53f04f7-aa18-4e8a-9764-c0f81a497c2d,Residental,0.6109637223171549,47,1,191,1398,1207,18.677881346977742,8402
7ce05183-843f-4a0c-97c9-e3c90048f682,Residental,0.20307672273417343,23,42,517,1330,813,36.007900644602486,5351
d1008a47-5b7d-4cc6-9e65-2e74003ce256,Residental,0.9207361410652378,23,32,495,846,351,92.88562543103768,2550
fefcefbc-b9e3-44e5-9efa-d5596eb7b6c4,Commercial,0.9769650137948643,28,16,531,983,452,36.51999768680966,8695
a2c0376a-3646-4939-bf37-f735588ee1ac,Residental,0.20487156706642484,3,25,309,759,450,86.06273761295328,4382
7e95bc46-82c0-421c-aa58-bfb393607763,Educational,0.426183310883819,12,3,290,944,654,18.77107345498795,3355
d90df2b6-4a8a-4086-8898-f0189a324ab7,Educational,0.7818448639105169,30,16,423,468,45,94.03724967105798,2526
5a42821b-c878-4db7-8523-80dab085a6df,Residental,0.5582442714684361,28,47,644,1315,671,11.123603020766403,4652
523e4cd4-1bae-4f9c-aae5-1d422b9f9d5e,Healthcare,0.22071381507947563,15,21,422,1106,684,77.53502954172173,9869
770372a2-44e0-4103-b2d9-56c35d7b1dd6,Educational,0.18475430398452208,6,8,617,1074,457,90.65080300741768,1131
822bed75-8652-44e9-8cff-405d2e971a74,Educational,0.47420052506561583,46,17,151,377,226,34.38745416742471,2965
ab5d9855-465b-4cfa-8046-f2e6dfb39656,Residental,0.1749770138467539,4,44,492,1155,663,14.890906434279216,1523
d4af564a-9ec0-4ae9-8e7f-c4cb2211a737,Healthcare,0.4549521981778091,31,3,189,1223,1034,28.242949559137553,2803
f976e215-15e9-49b3-8410-2e5a2d3fe041,Commercial,0.21008032637436003,26,48,658,711,53,59.608821282244435,6746
8e67025b-516b-45e5-98fe-07980895e2db,Commercial,0.9379708510903464,17,22,529,1225,696,97.89243181841029,3842
dfd241ba-1ee0-49dc-a022-56820422d492,Commercial,0.8133267649031445,30,28,62,225,163,33.461454991812445,1115
0d2b4f8c-0d4d-4038-a81c-5c29d6f62529,Educational,0.22284092783431997,10,23,6,138,132,38.05824760299319,1698
38d5d0b2-e699-4102-a01b-485f30939355,Educational,0.6839527455858498,47,29,316,1144,828,41.18545999254039,4621
25d41543-d42f-4f15-aaa9-0b562a6adb90,Commercial,0.9069196771876069,2,16,549,873,324,54.73635224739481,8714
09a71cf4-9ea8-4cc4-a6f9-4f42a319dece,Educational,0.35300319625045073,30,18,297,573,276,53.58405546614994,8556
583367ee-fd97-4dda-8d82-d4ca1467fb6a,Educational,0.83031230202563,38,29,114,1309,1195,35.7898638345617,1629
3003a051-7bc8-471f-b729-b90a55fdb899,Residental,0.46389731631178477,17,6,384,1095,711,85.90365841497743,7584
90249d27-d249-4e67-9fa6-f576a8568992,Commercial,0.10997916045681633,50,35,508,1194,686,93.78179989153993,3390
1518bc0d-cfc4-4080-9cd2-27032f30d2b2,Educational,0.11177019146823874,13,28,84,1162,1078,57.80065323909951,7895
25385a79-7402-46e7-a831-c6937d28267f,Residental,0.5815030030619743,39,9,635,648,13,46.37555820802799,8743
7bf6b8ad-67d9-4908-bac2-92587f931a98,Commercial,0.6984219804483964,16,9,31,114,83,22.122491049121003,8707
14580360-c4f0-4c3b-b020-2793ccf2723b,Residental,0.07685854344462772,1,43,370,723,353,67.94968302415275,2746
6b8d6788-5a15-4566-bf06-e302248ad9e0,Residental,0.5078677987217843,42,46,682,944,262,23.568647024352423,1727
68a3ad37-1d02-43fc-8a95-a1d30a4896ac,Residental,0.642522686841639,9,11,579,1184,605,70.27375843467598,2409
f244ccb2-f2df-40b2-931b-d3004bacf2d7,Commercial,0.15324301628697445,38,2,189,1410,1221,31.659702885592804,5782
db260c45-6fe8-4ce7-83ef-5d67d6df45f6,Educational,0.4516129441862239,42,48,272,1320,1048,32.22181441666579,3900
49967ab0-24d2-4457-b78e-cd3049d3a6b7,Commercial,0.04723563667997133,33,48,593,1314,721,20.497920253859718,1257
e1298b2f-2428-48dd-b9f6-4b9dd48fe479,Healthcare,0.15181875731315764,24,21,112,476,364,65.01347857015337,3428
48df340e-9a92-4220-bdf7-d3fa31c87e08,Healthcare,0.3447508985202541,26,46,683,1003,320,38.37256095193547,1737
48e5e99d-baa3-41d9-b6a9-de80c35eb734,Healthcare,0.8767168564356751,5,50,327,642,315,49.70256785702308,1983
1caee44f-0c68-443e-ae64-f038478868d2,Residental,0.4126842168528404,19,10,601,1359,758,20.640501196477153,9234
2a646196-c5da-474e-80c8-fd83cc1e3b04,Educational,0.12431962553765141,38,39,24,950,926,19.101359103818602,9972
66e37129-e749-4b5e-b249-e3136841daf8,Commercial,0.8391905549646148,11,46,513,1274,761,13.799457079778215,6971
e4124d60-a2a7-43df-815d-ad1717654aef,Educational,0.7660933868524733,40,22,482,1263,781,75.46645715421108,6523
8b4fe540-e515-4e5c-a86c-dbd0ea539f4c,Educational,0.8608595289941614,36,48,307,1128,821,94.6594683875537,6770
2a058f2f-245e-450e-a8d9-b9128e80133d,Commercial,0.9281061568312394,2,29,216,346,130,71.8098342330007,6434
e1ec2a0d-fa29-4ea4-8e94-669fab5f9158,Educational,0.8536748195038174,18,26,639,1336,697,44.46812991446473,2432
7c86c098-ffee-409e-8257-47efaa178831,Commercial,0.373328690720361,14,20,620,1176,556,30.20317823702618,6340
76d96cad-a761-4306-998d-1ced1a48cd13,Educational,0.33371139395521765,45,44,351,872,521,19.76190343822363,5560
28131574-eed6-4897-be43-53db8de0d8c5,Healthcare,0.8959969436458282,13,18,118,982,864,14.59520846062168,2891
38221dcc-e421-4455-acfb-6e393d6fce92,Residental,0.05680641260598662,31,32,545,1234,689,35.37091182750801,1076
7ad5d6f0-3b36-4114-8c21-d5dabedbe8f7,Educational,0.04232008991032732,7,30,698,1167,469,17.669471415550575,5973
681a44e6-7419-4c2d-97fa-5e343930fb80,Healthcare,0.223450214538354,50,36,700,1146,446,18.711458198572146,6016
ad5cb45f-a5d3-4ff4-8e34-99da91e92b56,Healthcare,0.3357017935856833,47,46,503,720,217,42.19183754515717,5275
92bdd5f5-6663-41d2-9cd8-3ece7982850f,Healthcare,0.8376962680022254,35,3,10,1323,1313,15.602137800971114,4827
e1d90b1a-b95d-40ac-81fa-439c20e8372d,Educational,0.4862394638640548,31,48,15,912,897,47.5972532675684,6349
09b2de84-3f2f-42aa-86a1-9cf1095288b9,Residental,0.48709696418488413,10,49,277,1262,985,74.30029584517925,4322
0fca0520-8388-49ff-9f2c-d137c9b29ebc,Residental,0.7995412696222557,4,2,13,970,957,14.889020598619474,2685
5ee2b2f9-104d-45c5-9838-3e3f4f29c60f,Educational,0.07173285397233187,39,25,403,844,441,48.50074729668692,5819
64a26b07-0aed-4917-b8a3-33812bbdb74a,Commercial,0.778588896513187,28,31,448,1150,702,51.135175510234525,5834
e0f0599a-73c1-41d7-9060-5a032f1b84b0,Healthcare,0.6720043596281522,32,45,405,1241,836,43.895699965746175,5224
0683dde5-79ea-4cd6-8eb3-297c85b6a90a,Healthcare,0.19594981948280898,45,46,623,1375,752,29.642612377284202,3343
41fbfe98-250d-42a7-a459-ab78e31cf0d6,Healthcare,0.09136443007177353,15,6,76,712,636,41.00200955119528,2182
41732326-3c94-48d7-bb31-975f18d04568,Educational,0.7956475255323806,44,13,498,1313,815,72.20855748404486,7332
8ae56dc9-f53c-4c5c-ae20-bc8f58d23460,Residental,0.33785696157272505,48,17,385,559,174,21.498137978168856,7881
ea2bdf49-64e9-44c7-a719-49a0f6581002,Residental,0.33270406110917583,36,15,291,646,355,54.784957450929966,1657
b6143292-64e6-44f1-a325-2b547d4bdadb,Educational,0.4987240029995553,44,48,23,911,888,42.34967582595752,6779
68108e73-a3b2-47ec-8c28-e3b1ad53e409,Healthcare,0.7899494370735733,5,19,657,795,138,76.82956015587182,8957
d3f87975-0f0e-42ff-a256-c10d8cb28570,Healthcare,0.8915141385874708,37,24,441,1302,861,42.220165371686505,9323
52c9d968-366f-48ef-a700-c648033918b0,Healthcare,0.964428743634964,9,3,120,1095,975,25.095567624585605,2821
72e14052-16f0-4a72-b783-03509f7758bf,Commercial,0.832232241658868,24,10,141,189,48,47.00751098852237,8205
b832a266-4283-4814-bef8-7ec2f029a4f4,Commercial,0.03839458913029714,16,33,605,758,153,32.40819509851549,9731
0777d3d8-48c3-4465-966f-91a70bc46c9b,Healthcare,0.020059441333421968,2,38,542,620,78,95.30224273237883,9491
447ee899-3f63-4cf7-8a9a-da7030c68d8d,Commercial,0.13795463317163448,36,30,156,1281,1125,77.91734891391057,9209
8e4c2713-a8e3-462e-8803-af8e8f8f849f,Healthcare,0.15183219233607992,1,34,324,683,359,81.48380556806413,3665
3f171aa7-9839-46ed-bfc9-5563d928ffe5,Healthcare,0.3775360400599438,34,26,581,1214,633,30.824215107011213,9600
4ca0edeb-f9ad-47c1-85c3-9e718aac1bad,Healthcare,0.7653447364307695,50,44,282,543,261,37.259712818860606,5078
6c87faf8-e84d-4650-865f-96e17271119b,Residental,0.9884190504637461,2,48,534,594,60,33.078574518660744,6484
b2c53b8c-2fef-4667-88ce-f740f63a5dd9,Residental,0.177608133087933,15,37,548,1371,823,10.717867548983204,5101
d230ad77-43fb-4349-9f6a-0edd84e86fae,Educational,0.4706094001964123,15,25,250,902,652,10.96311484776917,3936
ae552ebe-2dfd-4150-bfeb-949a74248afc,Residental,0.40140884957765266,4,46,109,801,692,57.548382228277354,7594
8c161384-11e2-465c-a629-4d139d47847b,Healthcare,0.4853922519230939,21,2,3,709,706,51.14990988069281,6676
19dab4f0-5059-4f6e-8dab-75f7fb1fc964,Commercial,0.1978398826096649,42,34,565,1203,638,71.11240275125823,1747
b637c3d6-3f82-4223-aa62-13e49f8232c2,Educational,0.29190628556484577,4,42,257,315,58,46.18668416577092,7763
3a281ae0-7af5-418f-a435-62aa2fb8aa42,Healthcare,0.4929592481041112,41,15,268,627,359,72.82452904832155,6576
8c7cb20e-677d-40be-837a-ed5b67b5687e,Commercial,0.45530869698737886,24,40,603,981,378,42.0858248351685,4407
7ea876f6-d4c2-4d34-94c4-d8e35bfc3888,Healthcare,0.6457679731103322,12,47,207,1197,990,56.099058422536515,4818
302dd985-d40c-4dff-b9fd-0bf267004dad,Commercial,0.39704183285942185,18,50,447,642,195,70.66660354664396,4147
f2ab97be-2b08-480e-96c5-a562014b3110,Educational,0.40009817707597695,4,22,215,1326,1111,64.18629261404058,9568
32aa6d5e-1ef2-4c95-8a4f-289b1397c3ef,Commercial,0.5039992145221226,8,29,306,845,539,88.95195598188255,6274
8da3c8d2-413f-427b-b52c-cc753782ad87,Educational,0.2895431768285138,27,5,336,784,448,48.43062564967507,5989
cbea27f9-e023-4ab7-b4db-54afff1cbcd7,Healthcare,0.659623346437685,27,29,704,720,16,98.87963594604734,8697
5cae9131-c3d0-4e8c-bd09-b376126b01cd,Educational,0.4932777123348264,48,25,434,948,514,65.6667990943346,6377
c38d4aae-a9a0-4d1e-81a8-3ad645b7c816,Healthcare,0.009999334776570334,2,11,238,755,517,18.66623196289542,7355
9907cd6d-9395-484a-a367-7cc2ecd76f8a,Healthcare,0.2730098497282578,21,31,467,1173,706,25.883615747356217,9403
8fe3afc2-56f0-413e-b55e-0fb376a0bb53,Healthcare,0.376675511879038,21,14,685,856,171,51.7653396204179,7011
bff3a496-037f-4200-8d76-dd442ed1b303,Commercial,0.5704343813752206,29,26,141,764,623,39.11731577176579,4497
a123d000-6db3-4f40-b93e-9fb87197be37,Commercial,0.4622196611327304,25,42,249,375,126,67.18067501581169,7197
8b2041a0-a475-4c0d-bab1-e35dfd56d4b1,Educational,0.36898760326709756,31,39,470,601,131,18.630485146820178,8267
499df47f-d124-408c-8261-459da766ccf8,Commercial,0.7957716721122041,50,30,423,591,168,48.41898282386056,4941
e8ae6e51-c0ee-4f04-a1a0-5e5a2ffc76d8,Residental,0.760478244915806,7,7,12,1351,1339,14.15136546337374,1570
ec66aea0-ec2c-41c0-a1e6-e81d166b6be0,Healthcare,0.18120907667264907,21,46,195,1416,1221,98.79745166350008,10000
1b3a89d5-ec2c-4f76-835b-01d171af2ed9,Residental,0.5186698144737776,26,46,601,653,52,72.94830108252908,9830
6e785ebc-b024-4c8b-9b8b-6e9a05d7ba0f,Educational,0.11565897693088822,45,31,120,1009,889,16.561569887329654,7645
54858a22-31ac-4bda-bec9-9da16742e1c8,Residental,0.6921122395980727,27,31,105,1281,1176,41.748316725658654,5906
f190642f-0d6d-4e3f-afd5-86bae2a27156,Healthcare,0.8578310837313117,44,10,595,985,390,32.40871436640387,6247
2119d3cd-e5e8-4991-bb2b-1c84590fbe26,Commercial,0.7001527441787228,18,3,605,1031,426,34.77737268896516,2344
f76da81a-18ec-4e68-bc3c-255548877453,Educational,0.44075432831634864,20,48,238,1215,977,61.88169413768499,4991
c241f4d5-bb26-438d-ab4a-0db88de250b4,Residental,0.5376317913758982,8,37,349,738,389,47.14218336228093,7504
6bed9e1c-9969-43ea-b851-95e8a0f19396,Educational,0.2681690991963056,50,39,387,695,308,80.64098888536026,9831
9363733e-3de4-4f89-8676-9d1164563b30,Residental,0.08160507834072883,36,8,179,1323,1144,72.51150606470785,1727
e0d93e84-88a3-4811-973b-7b773cc40095,Healthcare,0.2980483479989031,38,37,71,837,766,66.29812649423974,2365
ea6718e5-5a5b-4d5e-85d8-61fb500c4396,Residental,0.628468300017003,3,1,274,481,207,30.812385385337315,2019
a5d5a214-f890-4be3-a94b-90af0591f9d3,Commercial,0.664899528235333,34,41,155,453,298,97.56368405764823,7222
01303b63-230b-4d29-ac26-99a964a183a9,Educational,0.07246935764912255,47,38,455,1385,930,87.17713277660344,5364
04756d1b-5024-49ed-a8bf-b7d5ea42f32c,Commercial,0.47499614965684145,10,19,624,1168,544,56.02038773967883,4812
b4475efe-e4f3-44b9-bb32-1674d114be73,Healthcare,0.16796199431821013,28,33,52,1328,1276,55.64993372436781,9263
1cdd6a01-0193-4141-b688-26592d82447e,Healthcare,0.7199230240383365,22,15,344,1261,917,48.597006054120264,9385
70846adf-1603-449c-ac41-083489ac005f,Educational,0.181004116723546,7,25,680,1139,459,86.31356626084393,5211
f1ed1323-75c2-4190-ae9c-9723224a6df3,Commercial,0.3302662921575159,3,28,174,413,239,30.59749275739602,6877
7f6d8ae2-b2c7-4d84-83d3-5b1ded68d1d2,Residental,0.8467369187084254,16,15,289,558,269,40.330996075340934,1274
299a54b0-fbf9-4378-974e-c7b713078eeb,Educational,0.25803028681984264,35,11,173,610,437,93.46507342691064,7958
f93de20a-b983-491f-aca0-9df4357fc599,Residental,0.9578526556890211,35,40,272,625,353,92.11616088415035,5477
3050a8d1-a164-44d4-b97e-1e3f4e8c2dee,Healthcare,0.39173399398826747,6,6,128,282,154,81.27980724471087,4241
f1a89b12-ea14-4c27-8e7a-8c683c0bd96a,Educational,0.488935286790507,28,15,374,862,488,95.39224879945807,8582
c7559a59-7142-452d-9b2f-fb99017e4715,Healthcare,0.10355937440371199,50,5,550,1279,729,26.752864642883633,3092
fd469d3a-3a73-4ef3-9335-f631e81c4c76,Residental,0.7656689339645818,30,5,135,1326,1191,25.795156200285433,5806
130eea48-fc2e-4924-9e40-269cc0a21fd9,Commercial,0.6720502850073629,3,21,314,823,509,55.314870838032604,6746
99ba0b93-155c-457f-a2f9-48cf3f1a65a5,Commercial,0.23389984504910832,43,12,230,396,166,77.48624838242702,3031
7c61e565-adf8-4917-9ff2-1eadf5a9b082,Residental,0.3537792957176299,24,27,161,1287,1126,39.23478029852228,7855
ffa538bf-2180-4457-9654-eb8f7ca894b0,Healthcare,0.9618107760413456,37,38,171,1227,1056,12.98720069859294,6813
e3e33ec9-2016-44be-a189-f5682c5cf3aa,Healthcare,0.9842666519755924,5,9,313,751,438,87.3224667207795,1156
e012027e-6137-40ab-a9ae-1bf94e21424b,Educational,0.48228104966581453,24,16,599,1138,539,63.991129864320065,2585
c29344bf-95d2-4425-bd76-a9117ce8d37d,Healthcare,0.7357125555287757,30,12,187,221,34,37.71682015551349,2921
6d1f3cc5-d020-43a6-8c3c-5f6613331593,Residental,0.884294492904814,6,27,707,1297,590,22.152062144432136,3230
30a086f2-55c7-4ab9-95c4-7a7df6a81a03,Healthcare,0.06454468195490248,25,7,177,1261,1084,44.72200029170829,9130
c040ded7-48e6-4a33-ac24-889bc01154dc,Commercial,0.759394818674678,44,36,318,386,68,61.05930086747751,9911
271cccfd-cec7-46c0-9e87-b3cc131dfb97,Residental,0.0938395887601372,18,15,324,1197,873,73.67783706121648,2106
b548fc38-ba7a-471b-a0a0-ede75da34a85,Educational,0.6674646475049326,25,49,269,1128,859,59.819492605311,8173
d865e048-b860-4a57-a750-0409d04f3650,Healthcare,0.07977055420043055,31,41,287,539,252,96.77752055235302,4643
1620e395-2a17-4670-821f-23e487b11e23,Educational,0.6492749763532017,5,23,19,983,964,67.00858479378897,4997
75ef55ad-e69e-47b9-ba8b-5d569cab7d3e,Educational,0.6521803441259063,20,25,250,494,244,61.71107254787026,6537
b33b4415-7079-4cbe-af20-734d880bf66f,Residental,0.2615653237453561,20,17,681,1415,734,29.204360974049063,2488
cf924bfc-4fec-499c-93b6-f81ec9a20f88,Residental,0.7980567451108552,23,26,123,1366,1243,17.88076167951722,5915
30629f9a-455a-4cb8-ba24-cb7d359e8a1f,Residental,0.8309769644656129,49,17,74,980,906,99.66527811811203,7727
30880f09-1708-4135-8336-69dcd860b36f,Commercial,0.6605943517640597,38,40,679,722,43,40.17718642382655,4688
11e912c9-2061-4265-9fb1-3b9cb31d1cc8,Healthcare,0.7756178059874974,46,18,62,1234,1172,49.906574317924836,4813
b59a8573-7d89-47fb-be0b-8f013d758371,Healthcare,0.43363999372200424,39,34,475,660,185,21.577182729574005,4920
6cbbb2f7-c1f9-45b3-9ab2-3fe0601bb8e1,Residental,0.9118727638115405,27,5,413,1003,590,90.59497735681535,1081
34102feb-3f77-43be-a3f3-84e6d739c045,Healthcare,0.9248121355611395,18,45,135,1234,1099,46.2795102366653,9253
d17ab7c4-98c7-4a6a-8bc5-096c034e8428,Residental,0.5392516169166622,23,46,491,1082,591,39.846226215576955,1779
27f25e4d-fe28-4b8c-beeb-c8aef01681c3,Residental,0.8845206200077074,48,25,272,748,476,93.2137882866939,1806
dd2c3628-bedc-498e-8a4b-7091ddd389f4,Educational,0.844529125856916,3,27,72,1170,1098,25.663692647458504,8991
af274d85-8bd0-4f07-a287-d7a1420354c4,Educational,0.9685211954394722,22,10,164,1307,1143,95.63113152301014,6290
716d0131-4495-4edc-bc0e-7102b2d9713b,Healthcare,0.6221594742056518,13,13,250,669,419,85.94998318180797,1101
23e26173-9522-4f58-89d2-e0cce592fbe9,Commercial,0.8705370672359964,44,46,202,456,254,61.10960342247229,6774
aaccbaa7-7cf5-44ce-ab10-9afe0489c81c,Commercial,0.814524691110269,49,15,435,1194,759,23.839986457078567,9859
faba08a9-8508-40a1-a0df-12690ba3be86,Healthcare,0.9694174873185873,13,18,219,901,682,38.90825261221596,2152
bcf39879-5337-4bc3-ade9-f2ed209dd1df,Commercial,0.6006028349160614,7,17,638,937,299,42.21128801387659,3755
4381f217-84d1-49ba-b16e-b166b2ff39a8,Residental,0.8098279080887238,37,48,25,211,186,18.78444131127638,3420
58e328f2-b605-48c8-91a9-221fb2ad2a02,Residental,0.4338236816872616,40,24,174,1018,844,88.58487184200443,2016
3ba9a9b0-ca07-478e-a572-38f44ac753be,Commercial,0.6933606018523829,26,35,431,946,515,27.61588116098552,2936
4247de20-1608-4845-bc41-fea87004eab1,Residental,0.09648778449142392,6,45,35,922,887,24.461184573117762,6838
9de394c2-c694-425e-90a5-2c2225092d1b,Residental,0.06261608367088412,25,39,652,1252,600,10.74478658634102,1210
c84c9abd-0ab7-48ac-bee0-b938138a548b,Commercial,0.2934115766293719,23,12,344,851,507,96.49355915018154,8581
6b474a7a-ea28-451d-aa5f-e9162ad9f626,Commercial,0.9877488390779933,10,15,567,1031,464,12.55215972353557,5473
722010ec-d0bd-45b5-ae1e-66f17e1d063f,Commercial,0.1086698765240166,43,35,707,1240,533,58.84425725571881,6360
bd0ffd00-16ad-44f6-a622-a6a691ac1356,Healthcare,0.5529670276805068,19,20,565,1282,717,71.40239610159426,3886
5d447764-3672-4873-907c-ee15f2bf641f,Residental,0.38337877993741576,26,17,676,1103,427,34.72543499923786,5347
f44cd481-8c5b-435c-ae27-429feb98e46c,Commercial,0.0040725261049829875,48,41,481,1218,737,31.71870224744341,7066
929496e8-219b-4bd5-983a-bd13577327b4,Residental,0.9724182176160362,36,27,278,703,425,69.5653838507245,9679
1a37b5d0-b426-4e63-8822-71798fdd370a,Commercial,0.8285555753479432,10,50,348,620,272,55.08528201299569,5853
54f4884c-2b2b-4a36-b51a-01a6b4a3772b,Residental,0.8068002175662647,37,15,280,956,676,95.7518873386733,1266
cf5fbe04-f596-4413-94aa-ec16002ecf73,Healthcare,0.10939915258689381,1,22,549,705,156,46.87949840572725,1431
04d23a70-ce36-4993-9a2d-81ddf6fd3d65,Residental,0.3606636217678527,22,18,399,1125,726,32.544217964124655,3682
5b7c4492-661c-4659-b241-998a0c178319,Educational,0.5631018715819112,26,6,413,1338,925,59.73682463282776,5712
ec6adf2c-e2a8-4cea-baca-bb73b964c62e,Commercial,0.5180613587094245,2,50,118,401,283,99.35031795115201,6630
168db799-2167-4be4-9723-fc85f6a0fabb,Healthcare,0.25090609397407526,38,13,379,455,76,93.04644918361222,4008
fba81261-4812-4aff-af30-d04a97860cfd,Educational,0.16942404087307683,8,20,12,1294,1282,29.543687238759443,2611
ca667dbc-f99a-4825-9207-c0401590e23e,Commercial,0.531243702100778,19,28,514,602,88,60.97608320599926,7541
17dfd482-3308-4b41-b225-d31ce16e70c0,Healthcare,0.955673962088256,39,34,205,1031,826,96.21480977251446,5451
df76ad0a-d978-45f5-88b9-8d55f5965754,Educational,0.28335442316308834,8,47,205,947,742,61.04162971568265,9288
aaabbb8e-2284-4f54-99da-5adf1a62881b,Healthcare,0.890811817510448,25,49,446,577,131,98.11259230902964,6861
967b7b71-9018-4880-aa08-e99a8af1cf25,Residental,0.7851292683261193,16,41,184,1103,919,40.32040913801288,9360
162fcf57-b3ff-4dcc-a1d5-842c6eb8a82c,Commercial,0.3328938358319047,5,27,446,655,209,71.88193910244263,1078
2f8b1d2c-3ca5-4823-abaa-1690ea0bd602,Residental,0.8657030786058287,12,26,83,1389,1306,93.00200756691541,9093
cdab897f-7f81-41fc-851d-9556e1854672,Residental,0.18282151657101453,12,36,655,981,326,88.48019046288523,9452
70c22790-2a77-4ef1-bbdf-f670205f1d98,Educational,0.1963533729297905,10,43,680,891,211,39.9055308656568,1256
42624e77-f87a-47f7-88d0-fccf07f1bc90,Educational,0.5304885761769034,33,16,693,1211,518,96.2859495083736,9410
9ed87c25-579b-4ebb-b3ce-c774fcf1aa6f,Educational,0.3465627876153283,5,4,20,1238,1218,97.53977676720481,4031
d6b240fe-6473-42ef-abea-78eeb83579c6,Commercial,0.6806211738082627,31,28,380,1039,659,65.50422952781031,1234
2c17efcb-1bfd-4403-9e1f-60b07db58e8a,Educational,0.3395073816157813,18,34,235,1092,857,67.90746273626274,3586
88f44d26-8aee-4324-9432-937e0d0c0877,Residental,0.035781949249222955,31,41,22,215,193,58.414903545014255,8210
f57351e5-34bc-49fb-be2e-482785cf7727,Commercial,0.34912715687647,37,23,356,810,454,97.15948894473787,2768
a5b9a686-41c0-4466-a869-efdbdd4d7b1a,Commercial,0.570548564415369,45,12,120,284,164,94.44993965441522,6879
b0391a1b-1d16-4933-8bd5-402dfc54a0a6,Residental,0.34342593316582004,1,32,636,1109,473,11.877470599621688,8811
1119e9db-b713-406e-87b6-cf794f1ab44b,Educational,0.950646949988279,22,47,134,727,593,59.4784933477888,7846
e116e7b9-32bd-499d-a6f0-1134e078d4b0,Educational,0.24631151125093775,45,3,122,128,6,24.602233265455737,1353
568fd293-8e32-4582-85c8-4d7614da8b43,Healthcare,0.4442529784818159,37,44,506,1044,538,14.327561305204187,4364
bfd41f6d-0bb0-418c-8dbe-482c7b0e7978,Commercial,0.8267543010947689,32,26,143,1373,1230,16.121360848511184,1077
3d1f821b-7df3-4903-9365-8f92a796064a,Healthcare,0.31139290631903704,7,29,484,1257,773,63.20793312397521,4382
b6238f22-40a3-4bea-9eed-b9555820d8b1,Commercial,0.23367386597991346,16,38,640,983,343,50.04082758690494,9612
715c50f1-2b2d-46b3-a96e-fe1c1d7465ef,Healthcare,0.25094467408814436,49,17,142,258,116,54.695354086316726,9409
55febdef-6e98-4d9c-99df-4003f3f1c28a,Commercial,0.22613074271700218,4,41,21,1408,1387,99.96406235715048,1054
dd2e592e-81c1-441c-8008-f25f09afab86,Educational,0.30166169009630206,40,47,473,1150,677,10.036297990932875,3191
44982aa4-dbed-4322-8d8d-01502b82632e,Residental,0.32910369423779184,44,23,130,253,123,16.040142056767202,8983
43be91a3-ffb0-4ee9-b766-caed9bc27bfb,Residental,0.20486574890044595,9,34,434,730,296,94.4319437911255,8773
923d6fee-33c3-4e38-91fe-ae3e7370eddf,Residental,0.3198567454979033,50,13,300,680,380,95.65892454646557,1500
6077009d-e832-401c-91d8-6e297ef92be2,Commercial,0.15574413797499365,50,13,500,1125,625,21.457596795288104,1829
e2a66c35-e1db-42ca-b9b7-cd76460175db,Healthcare,0.7715736846332606,5,13,321,1170,849,21.707972694480848,8904
54f321be-f530-4c58-a4ef-177818318829,Educational,0.5196454860769055,21,48,447,913,466,92.56113472096209,7825
1c7160cb-e023-47b8-8227-68e0d4e12aa6,Commercial,0.5473302542909323,29,14,17,609,592,79.63449099666018,4740
9ec28509-1191-43d7-8809-09b8033d4504,Healthcare,0.16577132911200732,23,20,393,1188,795,80.34953600488028,8988
f0703aaf-7788-4fcd-a5ef-b7b1959a4af6,Educational,0.9681872519320184,21,8,586,1387,801,49.13591626258226,6083
8ff93769-437f-4898-be72-c9d1b89f82ec,Residental,0.3700355845363644,16,34,188,679,491,97.54200400743275,3039
310be08b-82a2-4691-901d-268f58b7a65e,Residental,0.7151732197835775,13,4,361,1068,707,79.27894955895785,4558
f32304ea-00d0-40f6-ad33-48e1fd9166b1,Healthcare,0.45022400347732483,33,30,40,350,310,42.109708497109125,9626
608fd72d-9db2-49c4-944e-7e332f1dbb00,Healthcare,0.7913024539936796,32,18,332,1358,1026,91.70772960729539,5270
135a9253-1c51-4ff8-bcef-8022ef79a134,Healthcare,0.6923211466409334,27,30,379,1252,873,49.37714088709363,4449
0a323b04-4453-4364-a7bb-9ababa9c1dbf,Commercial,0.11408133122678321,48,12,438,1175,737,59.189822709506295,5823
bbf25040-aa9f-4b36-9f84-7f12abee69eb,Healthcare,0.8685897919395615,5,29,41,806,765,82.36065377871599,9669
ed740f7f-cd13-46db-9358-8615eeda79ed,Residental,0.7767565559787528,40,15,197,747,550,43.113951332002216,1412
0ce8eb44-30e3-46d8-88c0-35aca4525162,Residental,0.009719948771082065,23,30,556,902,346,82.56319565332399,9914
f377e44a-647a-44ad-a113-b0a45d459319,Educational,0.2960976692147287,38,22,52,522,470,38.934655683661134,7464
6e753474-f4c1-4c0b-9a3e-b6d271debb62,Educational,0.14414144279507957,30,42,171,813,642,81.8892463913431,1692
ed781e58-f8fe-4eb0-a902-0d9e48c9e243,Educational,0.1755993573748561,47,43,280,1356,1076,62.691088932097834,2844
d22ab7b9-9ef5-4acb-abaa-07d5175d9475,Healthcare,0.25863098417303043,30,45,204,309,105,54.537083587896596,1840
b83ad1ba-8b19-4a83-b7ca-d1f3c4014569,Healthcare,0.3612585499448093,40,26,266,496,230,70.70870300865504,2082
b997bb0b-a07c-4e12-8f45-d9e5c12e7460,Healthcare,0.2701667257529804,29,2,404,1345,941,73.80553433407742,8108
daf871cb-cbff-4e61-b82a-a71ab30289eb,Educational,0.9483650724811267,4,40,720,1270,550,34.80317294572852,3484
5e69e3bc-99b0-4de7-a19f-a1de0c6673fd,Commercial,0.37029320076353733,33,22,98,129,31,36.56073820840807,6320
846fefee-16bd-4c30-aef0-1a8a4abeea09,Educational,0.7972808946358717,36,46,590,829,239,11.639343102375177,9889
537c222a-3b9e-4b7f-a4ad-f55a0295ef6b,Commercial,0.8377292981768621,40,41,377,1414,1037,73.63397727238016,1422
5d16ce90-be70-4c20-9256-0ce5f627b76b,Healthcare,0.2826747005837221,31,37,123,1030,907,15.383901940006744,5693
58f2eb50-322e-4ea2-b5d5-8c20c43f697c,Commercial,0.7096129878508445,1,50,218,570,352,46.084329551485034,6882
3247743a-dcbc-4c49-98d9-016bfa08adaf,Commercial,0.9258434184756074,9,19,139,851,712,46.325196900093964,6962
d3ee8995-05ea-4185-b9bf-177954f6e397,Commercial,0.10564215024258528,32,35,397,808,411,68.65793595066117,7974
f1e62b2c-1af4-4475-aae3-8b17c8020948,Commercial,0.7090787610026709,37,12,580,1397,817,74.13561521228975,2894
36ee93b6-1d37-4047-9836-fd01fa3a83b8,Residental,0.07726861525398443,36,36,55,1069,1014,52.74442343360512,1667
537c5e36-bd8c-4a1b-bd1b-f53fca9a4660,Educational,0.49750153951477927,45,33,2,1211,1209,20.75618161741329,1475
8689acf0-4b4c-4497-bac9-165e54a0d47a,Commercial,0.8263672899071361,14,22,459,1360,901,23.314441447751484,3109
f428354f-6942-4686-b1f1-47ea34032a60,Healthcare,0.4190831782188621,17,4,644,1433,789,75.4168497261287,3162
79870780-594a-422a-8a81-45875b728896,Commercial,0.653660383860296,5,49,578,948,370,17.50122487494089,7596
b608b893-bd4c-4ca2-8620-a9a399e59dc6,Residental,0.8079767492826214,42,31,392,885,493,70.89735007889567,4881
7c164e03-1479-4691-9762-fc3459a36d28,Healthcare,0.049742164019693225,2,13,22,856,834,66.45154164682286,7677
ca219d49-4b9e-4541-88b2-1ad41be68707,Educational,0.7680503470691155,1,9,549,642,93,62.41414485986304,6903
c6c16779-bc01-4288-943f-cbb17a614c73,Educational,0.3402524063962409,41,2,334,1181,847,52.90186670145524,6813
aa136bd0-364c-4661-a788-6da58e098c29,Commercial,0.6167333854128468,35,35,625,768,143,68.14888460893673,3341
c2abbf79-ad62-4940-8871-e39403658fe4,Residental,0.7991695909579686,24,37,555,1092,537,85.97275010334522,8369
4e0a33a7-1312-44b4-8014-00df30267594,Healthcare,0.22497203366228824,2,19,139,908,769,82.7710960626627,2872
b29e86b0-7dee-4a7c-8556-9b35e619c03f,Healthcare,0.8091062100269395,20,27,657,1316,659,40.30625142816959,2376
8440f042-0c74-4f20-8dd7-e59df92fea5b,Healthcare,0.6143711157928305,2,30,654,1395,741,35.067726629907035,8552
d78a8f0c-252c-43d2-b9a1-6f54a3bf5b80,Residental,0.8293921925184626,16,42,195,1325,1130,43.55112664950933,4309
8ba2f007-6ba2-4c75-aa46-7da74ca3ca2d,Healthcare,0.4937434980410059,22,11,303,1388,1085,67.86263679751889,1016
55b7b294-5530-4d1f-b528-9adec7abb1af,Commercial,0.01130240127962312,34,22,327,1370,1043,11.599405821642245,9138
5113d1c4-72a9-4da1-96c9-7f40fd41f46c,Residental,0.8302165815361245,5,43,368,1356,988,53.143842791440264,4690
cd0f49a8-bbff-4a7c-ae8f-91523f01b530,Commercial,0.6294056355872905,1,44,550,848,298,97.3005530075259,9927
7cfe6955-b395-4c3b-8e96-7cf2305d91bf,Residental,0.9366167942936615,11,27,517,1112,595,93.26613715092934,7552
979377fb-3b3d-4ba3-b76c-f72983bc25eb,Residental,0.010637750590765771,49,38,262,1122,860,38.206931809470206,9219
39939494-0ed7-4e0e-90c3-7f57bd92c97e,Educational,0.3614795690341638,35,45,43,1265,1222,12.757426189677526,7450
407a7d47-b170-422f-a579-a751f4c8a731,Educational,0.4302525784667861,33,48,149,931,782,64.19003365579238,9168
36b3a02e-f23a-4dda-9fce-a166cb8cb738,Educational,0.5020528686846356,46,26,236,266,30,32.18165219103898,4084
b7cd1c98-7856-455b-94d6-7a7d1e151784,Healthcare,0.4605404464631272,42,49,553,636,83,63.948324821525894,3176
de8182bc-3576-45d1-9904-13e703328795,Commercial,0.920542135943061,32,37,280,1118,838,77.12868475398123,6404
3c4ca37d-f3ba-40ea-b5a9-36c56eb903f5,Healthcare,0.04210832851740798,43,5,282,869,587,36.68557150446862,8800
346f82f7-b3dd-40a0-9701-e391a8fd462f,Residental,0.6391311975279877,47,33,474,906,432,76.20364950613826,9232
4f933bf7-eaad-406d-ac69-e6aa51234ce1,Commercial,0.11173930183058844,34,23,467,967,500,50.74797260278702,1484
f358515e-ac46-4518-8a75-5b7ab1c1f0d4,Healthcare,0.5770598352004359,22,37,24,180,156,27.569834879632417,5139
52e6a1d6-4002-4e93-9ffb-b73cdbb50a75,Commercial,0.4925620890269713,14,15,344,644,300,80.94698706978554,3644
f09a8766-7ca4-4189-8c40-7ca3dbfb3afd,Healthcare,0.5008613585070207,8,40,658,1342,684,59.312917598174295,3165
996bbe83-a71a-48b7-a4ba-bf990910918e,Residental,0.43867871190603724,10,50,5,1175,1170,89.25945286885073,9915
81b4fdd8-6ce5-44a0-b50a-3e6a5ffbeb0b,Educational,0.2796141713053861,31,7,261,1215,954,44.24886182933944,5883
3df93289-81a6-488d-a9f2-1a509be1f313,Educational,0.5113667869140114,12,4,447,927,480,93.59004501760411,3360
1b665bc0-143a-4d69-83b3-48591149e47e,Educational,0.281689831104442,24,32,211,396,185,80.38200305903153,3409
d6847c31-6cc7-48f1-b0ad-9cdf348c6b4c,Educational,0.7169362000713183,25,32,231,939,708,64.5417911571124,6539
39ef402a-a232-40fe-8c22-0eafff1d0811,Healthcare,0.6522772431321883,4,21,119,1120,1001,99.46962893466784,7297
d7cccbb6-ab7a-4eef-85ab-a62604321b09,Healthcare,0.8041399062270114,24,7,520,718,198,12.905772622039523,3759
2a3d8583-33ca-48b4-9a3a-16b5a2d2b1dc,Educational,0.1519105137588641,17,2,525,675,150,54.665512604285624,3766
c75ea66f-1276-4f6d-8204-519dc39c6527,Healthcare,0.5004861111210996,47,44,243,352,109,83.6184734295072,4601
0a943f8e-2a93-4229-99c9-76962a0fa19d,Residental,0.28489006055268706,31,21,658,899,241,63.04777960400708,2372
922310b5-e0b5-4f33-b1ca-6cfb040f5928,Educational,0.19404739777760172,13,49,540,1389,849,60.429843481844166,4984
af73b899-743d-4067-9b9c-08e411a813bc,Residental,0.37153266871881585,40,41,338,1060,722,96.50125712900292,4044
8fb833b9-bb9e-43b3-8f22-49c860c8251f,Healthcare,0.7467427519323204,34,26,547,1312,765,47.69080251449328,9577
89a43348-1cf7-4bd8-8a23-6245637784fa,Commercial,0.6675668574339261,27,7,163,915,752,86.06871197915261,3988
559ba1b9-cf4a-41dd-8c36-056c80f45043,Educational,0.3434605454205799,29,6,543,754,211,50.43969718627418,5171
ab7a645b-486f-4eff-91f8-af178aabe062,Educational,0.4866990523678266,44,39,496,1078,582,95.46918978824812,8658
3c9e8142-3003-4a84-8fc6-b32482f732b7,Healthcare,0.2660362505701356,6,36,112,1026,914,32.376593710694834,4578
65f347bf-9989-4977-8b20-8b4323b4075a,Healthcare,0.1260455532282928,32,3,554,1086,532,80.01237771340745,7961
ea7eac87-283a-48c5-ab50-9ac986d11ade,Healthcare,0.13711558528247525,25,24,437,855,418,62.47352571545111,2472
3513e1fc-e69c-45ee-a985-fff1e004a8f7,Residental,0.5701074922065539,40,6,555,578,23,86.95861552569376,5684
ceb93d4d-d4b0-400d-988d-7168f75d236f,Commercial,0.09302592899736417,11,32,43,1311,1268,16.92847328608006,7818
a95cb0b2-d5ed-42c7-b0ea-267b127941d1,Educational,0.8705983836940637,36,2,125,231,106,53.67199308617247,4420
264bc028-71ee-4c20-be1e-3fa4fb04287c,Educational,0.374515780464881,35,1,411,632,221,99.88101728272684,1463
31bbf384-f98e-4019-80e6-2e6d13f1e8d0,Educational,0.2852028152914169,3,47,669,919,250,19.364401723702958,8103
66f5a3d3-d7c3-40fb-a9b8-d711b058a270,Healthcare,0.02988120033084707,23,23,496,1412,916,81.92291688628218,5425
7f677bb2-043e-4d17-9c64-ed91748db7df,Healthcare,0.46321077288474344,13,3,499,666,167,18.8464984620675,6641
f1fe42af-925b-4d2c-97d8-2c41e8f69769,Commercial,0.43280467051380866,7,43,472,996,524,76.24407585489028,3052
509f9548-07e4-49d5-b6d6-50eeb15d3dd2,Healthcare,0.4068927968098456,10,25,12,1371,1359,23.945338267302198,8315
15afdb85-e0f7-40fb-9db4-07b67670af93,Residental,0.7878591676358331,20,37,477,1173,696,27.77548223122725,2643
28595937-4fdb-41d2-a315-62cb4cbbe3f7,Educational,0.8212499655006994,43,28,363,1217,854,50.23169156769832,5180
2dd0fd30-67e2-419f-9b8c-40db6435b88d,Commercial,0.6446780387106272,13,13,560,963,403,23.104523715771457,5165
197670e2-9717-4bbc-a05f-a21e837fd519,Residental,0.9014452222001703,21,36,477,970,493,68.35377360556771,1997
1f40bf73-6048-4f1e-b3c5-2ecf64abd44e,Commercial,0.6679520503329883,19,5,627,1437,810,71.85408041208365,9697
b36cb081-2acd-427b-8d85-e63f50b7367a,Healthcare,0.851243893664348,14,33,594,1191,597,10.414722411468919,3675
0761e1e0-78b7-4102-9a9c-9091665ec9b0,Residental,0.651364950741924,2,12,703,1054,351,48.07785466184062,5972
9a7c483b-74d1-42d7-aa7a-db96f7124865,Educational,0.5140746608725686,28,1,72,262,190,43.1104265442394,7161
1ab3a7d3-579c-4c16-b199-26f54fbe1078,Educational,0.7377647489030262,3,6,418,1396,978,89.85831787167443,4613
d1177457-d5b5-461c-86f4-9cbdbd57cf3a,Residental,0.6614550009954238,9,19,332,587,255,71.00615918614537,6804
159cc203-756a-4661-904b-81b6dac8a456,Healthcare,0.9822213561829645,38,44,264,1278,1014,26.73373796439799,9150
e8eae42c-0c87-40f6-a9d7-69841b25bc32,Commercial,0.19692362006628428,36,23,77,963,886,93.07021082584981,5946
7b3e71f9-de54-48e4-ab39-36d8179f92e8,Commercial,0.7726387237996121,37,12,716,1425,709,75.90504734441781,5148
a853fa95-8bf9-4a4c-a9fb-e51e27c2406a,Educational,0.1644309945837935,17,31,647,1196,549,96.58807879233807,5845
cdd33b77-f17a-4297-80f9-4f1b68039a77,Commercial,0.35805456976654926,39,32,75,1322,1247,90.2806800747276,9690
3628429b-29ca-49ef-b45f-3865c8fb2464,Residental,0.8078308335408478,46,9,155,981,826,70.75804964812528,7250
1eb9a3fa-8bcd-4385-b17b-235bf2cd6ea4,Residental,0.9863663196035665,17,23,439,1339,900,76.01052042927095,3130
cda6fbbb-7b43-4b0a-8271-5ce061c02f5b,Residental,0.7630365935879669,35,50,579,1135,556,83.26624128506117,1902
7b189f6c-bdb6-484f-b1f7-3da878365f05,Healthcare,0.5916511817179366,23,45,164,308,144,52.64625440652766,8319
ed07a060-752c-493e-afac-dd72ce7488c7,Educational,0.905089901812199,1,15,367,662,295,43.23464687075456,9855
7395ddd2-8ddf-44eb-96a8-20a39ce7cd9b,Commercial,0.5198098141270757,27,23,525,570,45,71.92792034049153,1923
1eb40a13-0a68-4a6e-91bd-4dc98f4383f9,Commercial,0.19099786547798625,47,39,102,1354,1252,45.073283866770474,1451
37f45972-ac51-4191-b839-c123e9739b62,Residental,0.754300443316996,38,27,661,1069,408,83.49990407403463,3102
637c3482-a774-437a-ab69-4f1634619a3e,Educational,0.20698453106658532,42,45,600,799,199,22.45540545931859,1803
c7349ec1-fab7-4ee9-994f-f8b97f00efed,Residental,0.8921643827321255,9,23,541,890,349,24.350739443214614,7783
66e0479a-ed35-4e67-baff-f6c15cefe484,Healthcare,0.6443240053766369,43,7,603,1078,475,82.3301575012935,4618
19dd5089-7563-47f9-bdea-0783adec284b,Healthcare,0.19959510817267456,13,11,667,774,107,71.51235220302338,8422
499cb0c8-34e0-4955-8ab6-b6f29e0bea3a,Commercial,0.002208629214563107,36,33,557,1229,672,36.832696530503256,4543
e1c94d31-2cec-4595-a0e0-7d33c76cf763,Commercial,0.4402627943201224,39,31,144,1282,1138,56.59891704235536,4375
f1ef41d6-fba7-4338-820d-4344aab99c3f,Educational,0.22620488326766364,3,32,235,666,431,59.06444776254068,8390
df68ddc9-c590-456b-8d65-4b3de78d7d7d,Commercial,0.5496864978556808,32,11,203,215,12,12.028577326045406,5045
68551a36-a464-4112-a7fd-b699c3a0ec57,Educational,0.7882135372461709,16,2,239,913,674,81.900801395152,7297
6fcd04f0-c32f-41c4-b571-3519fb75b7e7,Commercial,0.2072908415605914,9,5,319,559,240,21.331377429294967,3159
2789b196-ae95-4b46-aded-4bc1744a438c,Healthcare,0.041363907864446436,33,44,416,1414,998,61.961224739095364,8927
a565c45c-e028-43a2-a3cf-b5ae89cf5486,Educational,0.6752220293358614,28,3,48,136,88,10.477071219838244,9606
ae5658c5-ebb6-428d-8b40-63027cf9a5d4,Residental,0.6530771021528817,25,30,247,726,479,58.91860594540554,4319
1ef4ac3a-d00e-472a-8055-033a5199716c,Residental,0.7963411449003648,47,2,116,267,151,22.73483740177577,8077
baf7e648-27f7-4c84-83b5-81ec6eb76803,Healthcare,0.45326237207568,35,8,285,999,714,93.92526426805246,2956
c834adb5-176f-4ac6-9359-e671b66d87af,Residental,0.6737767613122861,13,22,581,592,11,95.06396466213504,3011
f1384a83-1a18-4bc8-aacb-5fd399c732f2,Residental,0.35392936320162083,14,48,698,1126,428,54.14538595067553,3044
314bcc76-528c-4304-9bca-3224ab5d6b16,Healthcare,0.7472440281835182,49,45,216,465,249,22.85863105999487,2933
0d526f8b-1e45-43fc-a15f-b471938ed956,Educational,0.23762340706797958,23,45,211,1166,955,98.14934556415315,2430
38556c87-0e7b-4ed8-81ec-4da3437b8b57,Educational,0.06734683254573792,6,11,518,1309,791,35.63789720807928,4264
547ea413-3f32-450e-8856-098783edec34,Educational,0.7434212955148244,35,30,631,908,277,61.546085081794075,6670
ade2fce8-5ae8-4006-9c32-a94ba6b48ba0,Educational,0.36655225042913253,29,6,219,280,61,72.35491115432967,8826
af331ddb-9188-4288-ba19-57b810747fc9,Healthcare,0.7909125330548712,13,23,153,657,504,98.03020562841522,9452
dd3012cb-2818-48f1-ab0a-20c669f11c90,Healthcare,0.032261864842557886,47,2,93,137,44,21.450947085374537,1396
81bdfbd3-16ac-4087-9427-b6de440ab3b7,Educational,0.12004295924594921,46,46,89,1258,1169,49.38435646769874,9934
0bd3bf9f-be4f-47b5-91b4-18a8925d33f0,Commercial,0.5065995394968567,50,8,122,380,258,36.69376678892134,3633
0210935d-2012-4f43-9472-b5d0678697ac,Educational,0.9724164646179023,37,22,295,885,590,20.08469508002812,2409
f4239338-4dff-4bee-81ab-607796f222c7,Healthcare,0.9550668176433492,38,23,343,423,80,45.663017473194,8557
2175f253-caf0-4328-9f28-bbef39242845,Educational,0.8708563879603802,26,36,499,970,471,53.09787696710459,7880
960d88de-f5e3-4506-8005-55c1ae8881c4,Healthcare,0.9784731646244624,11,8,595,902,307,82.3910657276375,9894
cfb0f34c-4d51-4aa2-8981-1cd7bc27dd2a,Residental,0.6912445861798556,44,6,441,948,507,24.956841879896785,4002
679d570a-7d8f-496e-8ba4-3725e5efbdfc,Healthcare,0.8474986442641079,16,37,676,1235,559,66.17786680244066,6464
bdd3fa75-8abe-464e-9011-baede34a6330,Residental,0.02704610807710317,31,48,41,360,319,57.29376323676985,5344
14ad5732-4b62-4d03-b4f9-1674296da6d9,Educational,0.2221180616508892,18,29,351,1345,994,61.24594630859832,4517
3925ef0b-d8ac-4e26-920b-827926901a33,Educational,0.24134312497203547,41,45,665,1048,383,69.58142074552885,2755
5bc3f523-210b-4141-8b10-d5bbbd445c61,Healthcare,0.08635943147678471,49,8,533,1140,607,74.67977680505916,7363
80ec4b7d-2520-4ba5-a7b4-df02b11f3539,Commercial,0.48268174253635965,29,45,111,966,855,69.95623650152423,9443
91e05e3c-47fb-41d7-a8ab-a91fb53651fc,Healthcare,0.822141914150339,23,29,88,1114,1026,88.5117400158011,2214
a5524a48-fba9-4256-9cab-b824cddd95f6,Educational,0.07172660244412032,19,24,202,288,86,16.078485442826786,3112
39f9f11a-5829-4e02-96b8-4258275fb070,Commercial,0.7483395162301102,16,1,493,745,252,30.661054913778578,3024
4dc9b4ff-d6ee-46f6-a2b1-bc664eeb6eb7,Educational,0.5526519426362057,13,13,16,1006,990,19.653552987219605,1100
20373d73-3c9c-4012-9265-bcbc9c07a237,Healthcare,0.47260087097661274,33,15,491,976,485,12.123064547991202,7928
f883022e-8aa5-4a5f-b0ca-0266120a7cf4,Residental,0.5079997539682816,16,14,537,638,101,43.604398115453016,4250
a76598c7-8e4e-49a8-9c75-e0fb3a1be281,Residental,0.27189879689027563,16,29,173,764,591,94.19144713427946,4746
457ed704-abd9-4420-a4c0-412b23948119,Commercial,0.4343039744073609,20,26,491,714,223,49.74020835796311,7533
3874b1ed-6a4a-4f09-a747-e07e98c34f06,Residental,0.0719204956093451,40,14,379,538,159,65.46481011234812,5415
b23c669e-88bf-4996-bfb1-3f05f514d051,Residental,0.22111683359771828,7,48,678,1289,611,84.23399489353933,3376
9efdd7d8-bd49-4cbb-8008-e3ef0837e968,Commercial,0.06679360854423144,20,23,165,919,754,51.01893272768212,4252
aa161020-ca32-4a90-a61a-ab7bb99b487a,Healthcare,0.49987724498208674,34,16,47,540,493,59.52099558556687,6252
2e99b192-fd08-43a4-94af-1f6a204260df,Educational,0.7535862087374438,36,40,534,907,373,71.00716951120256,2469
6186e26a-8151-4fa0-93bf-61aa06bdb349,Educational,0.8827641002588974,20,12,491,630,139,78.80293323250011,4182
68218e9a-a75f-46dd-adb9-2a9ea18c0b6e,Healthcare,0.4385582709605452,21,38,599,1270,671,40.254875295805064,2408
e1e94077-7009-4149-8702-c403f88da6c8,Healthcare,0.2714277257812703,37,21,522,708,186,11.840411461616982,7989
2a091dff-32df-4d7b-b95e-b49559b4dae4,Healthcare,0.05616984688902038,2,16,2,818,816,74.0923756445446,8502
85694f60-6766-49d0-8d3b-8da4022f107b,Healthcare,0.2156918438083546,30,28,438,439,1,10.112531707703111,1664
819b9440-cd40-4f81-ac84-2121d68bfec0,Commercial,0.7828258659216822,24,31,644,1118,474,63.42846742607852,2840
b9ec2eda-dc24-446e-9eb0-b786a6698cab,Educational,0.42985723850198254,29,44,555,1251,696,75.77476900923939,6732
5cde6178-129b-4bf1-bbb1-f4810fee3b9b,Residental,0.8792127362054993,19,22,69,1146,1077,29.405973896656416,5613
7b8b3e4a-069e-478d-9443-b8bcf9d148ac,Educational,0.5200282976171615,24,9,691,899,208,26.772384945857084,1873
3ddb1780-4f67-446e-90f6-2d4b401d65bd,Residental,0.7836771561077032,6,31,570,1439,869,26.863100873050016,5013
d4456fd2-4540-48e5-bd54-7ca8185cdf15,Healthcare,0.1836521959294627,49,11,357,1041,684,63.09659093549715,8155
8e760ddd-a7fb-415e-990e-1b9e660d224f,Residental,0.6532048768858144,23,26,484,755,271,81.12636474826203,6971
12f80af0-0678-45e7-b6b6-3efb8db77670,Educational,0.8559567059957917,22,26,218,827,609,28.088654476131794,1941
e940b955-c05d-48a7-a0ec-57aabe71da50,Residental,0.5382333649688618,25,40,146,170,24,65.10619184229316,8958
a1a85d27-4a70-4b91-944c-1a2b08f7abb1,Residental,0.7397942366117115,14,11,664,672,8,25.09060063841988,6966
ca977010-12a1-482c-8782-c547f1e7e986,Healthcare,0.8776260552818408,35,43,207,914,707,99.58906391146881,8595
8e13bf9e-13c6-41e1-b431-554fa24b40d6,Commercial,0.916415041028236,6,30,503,1177,674,22.29509233141855,6593
5399d600-b812-4639-8495-b6f1ccd43146,Residental,0.410890972227974,1,2,17,1137,1120,35.43557873173348,9599
37dffa4f-f885-4dbf-809b-0c54dd10baa8,Residental,0.592184383440967,20,38,568,1133,565,57.53885321260239,9964
d883cafc-c1d1-4235-8996-4852ed6dee8e,Educational,0.8876035667532506,34,33,388,688,300,93.8766181001862,6558
30db4bf1-c085-498c-9aa4-82a970a48202,Residental,0.7059779960215077,33,36,567,1187,620,34.60456646562609,5136
6abb7083-795f-4d66-98ab-7baef25288a4,Healthcare,0.07062258351330553,29,37,650,1341,691,95.12567407428581,2265
8dcef644-aedc-4a1a-bdb8-5b7eae80f72c,Educational,0.21177460752474997,13,12,179,335,156,73.47071563332173,8145
ba1299ea-c9c2-4a3b-a48b-b2696b9fe4be,Residental,0.2412474147688226,13,40,454,1400,946,60.44155869076132,4430
45449d85-d404-4409-8753-332e3cef7c4c,Healthcare,0.025657697844500338,15,8,683,706,23,32.918222478754984,8954
b2632af9-6b9e-4f3b-aafa-82599269ea68,Healthcare,0.422950007310089,42,23,204,440,236,27.335479359107225,9651
c57cbaac-eacd-44ef-8f9d-f70443e7af08,Educational,0.08604787988325469,46,4,610,773,163,60.07435514157481,1571
b914b779-f51f-456d-90d0-79a9e125868a,Healthcare,0.0014386140853813734,39,49,347,427,80,87.59562637136986,2849
ca3b416e-8c52-43ee-ac62-dfdc7c9ffcb0,Educational,0.9093695571634364,21,25,396,630,234,76.08002005495784,4713
70314382-550f-451f-b50e-38f4ed21dd7c,Residental,0.278248327707894,45,41,682,1115,433,38.870948654984815,8241
be1aa7f0-bb10-4424-8b27-285af8ac2940,Educational,0.06386407124579674,48,48,441,722,281,45.9037662407637,4405
32e52a38-f815-4fe7-b50e-146ffe7f165e,Residental,0.20503928036961516,47,13,93,265,172,16.18574579346225,9024
d9f75cc7-4659-4df6-ac53-61fd8ab9cbe4,Educational,0.49542137292550625,38,4,462,814,352,54.61051802059785,3190
e36fc4f2-79df-4369-94ea-bf4c73345e4c,Healthcare,0.01448266821301425,3,15,687,1085,398,53.980252131473335,4692
028f76ba-621f-4764-a637-838071f5c8da,Residental,0.5413153476453934,8,43,121,1413,1292,19.97519437514369,3180
d8d88f96-0b9e-46b6-a1ab-aa2e5335a81f,Commercial,0.9784837696500193,42,50,102,1024,922,61.02760251481423,1786
c9864815-5aec-48b5-8d11-78e5c8f4cb1f,Healthcare,0.5173969083126377,3,18,189,1024,835,18.856763570520606,3224
af97209e-404d-4601-94ea-cf2555c46f9e,Healthcare,0.3308738099703945,38,36,495,606,111,87.53666529483345,7219
03b6a678-1979-4281-bc90-ac974704e9c0,Residental,0.5942772757048745,40,19,96,1244,1148,65.4954910564723,4064
8d9524f3-067f-49c6-87f6-afc203314ead,Educational,0.2063185562175267,30,47,396,1217,821,82.57054968249304,9480
cdd5c4ee-429e-44e7-8094-31e7b8b82576,Commercial,0.2733143120680379,33,14,75,244,169,35.2895693820947,5298
f6be8a18-e2de-40e0-8290-a150ea519aa3,Commercial,0.800382839394304,19,38,386,562,176,16.56382701945241,1123
6505c8da-9d76-476b-b3df-6000a7c4d532,Residental,0.3041760277357205,39,8,325,982,657,60.121523107608525,8021
b9fe476d-66e7-4da1-87a9-64390ae662e9,Commercial,0.9820424696120768,47,31,709,762,53,19.24725500049118,8048
1f56c7b1-3957-450c-aeba-f1f292a5b813,Commercial,0.041844700223001685,30,18,627,1159,532,59.97060619540947,3193
66c03ffe-75a1-4e75-b725-a09f2cf0050a,Healthcare,0.038922286479560975,21,45,536,1149,613,61.30373582432042,5305
e9953779-62fc-4b70-9ff7-b6694aa36008,Healthcare,0.8352707402835673,13,24,6,647,641,98.280728547228,4494
20512e85-9273-45c1-a7c3-671d51659115,Commercial,0.4319078727888811,32,42,556,929,373,26.335301735010756,1981
8095c086-baac-4e54-8bd6-d311aff46c47,Residental,0.2756560687438774,37,20,619,1312,693,29.247003330744743,6188
daf0dd2b-51cb-4171-a867-b697870e0861,Commercial,0.6751011569886423,40,15,353,1073,720,67.6841506614194,1306
04abc8ae-c395-4262-9083-372b58a121f7,Educational,0.24697259333093735,2,48,494,862,368,19.505958728265163,1628
18268e9d-f5c0-40f1-bbd8-6953b8525528,Healthcare,0.1805423110157317,43,47,63,967,904,70.11086285816678,8687
3b381cbf-9d64-494b-b599-addedb865f16,Educational,0.5809922284531199,45,49,385,486,101,34.28308785828345,2845
d270bf7b-f9d6-490f-ae38-2ef42a474374,Healthcare,0.9189658289463346,47,9,365,705,340,74.20261788007694,4400
c631d8ec-cece-4899-a506-912fcd8362f7,Commercial,0.510097569610811,10,6,95,1333,1238,25.06976707883539,4848
87a4e863-35b4-46d3-855c-71c28697c6e9,Educational,0.8493944882865269,35,32,581,1049,468,82.77673909223427,7246
40b86287-3ecf-40b8-a45b-c0b37717ea09,Healthcare,0.13720802136157217,29,10,643,1169,526,87.93831977293354,9508
9b249370-9131-4d02-9857-398fd914ed40,Educational,0.24748121660481115,21,8,243,1402,1159,93.1906044820746,3212
3150b226-a604-455c-a371-a7619033d6d7,Commercial,0.18090005890067062,5,24,551,843,292,54.28845510214342,9874
b587c3c4-b2e2-47ec-9827-5df5e6d46eb5,Educational,0.10728919312966467,11,16,21,1256,1235,63.584090806116436,7161
938348c5-705c-4e0e-aa18-f0ef12a3e3d2,Residental,0.8268890221909124,27,3,689,1015,326,25.41604306487454,4538
04d38c84-8122-4721-8266-ddfb104a769d,Educational,0.5520339392621691,26,37,121,1436,1315,14.000685683091382,8149
fc501210-c6db-45d5-9095-cbc3b54e06db,Educational,0.34940536032522196,24,16,289,411,122,31.259704875331305,8664
e688afcc-e2bd-4ac3-9a1f-f444ef0efdcf,Commercial,0.1499627032903058,42,27,704,749,45,21.089658277574244,5739
62544235-e324-408c-81ac-77c7c4657cfe,Commercial,0.4338523922567612,46,5,400,1041,641,84.95469135663588,2176
d03abbd6-0da6-454e-9ccb-ac78e21a901c,Residental,0.5260873226901561,29,33,357,1093,736,84.86709801656646,1174
dd08ead5-97d1-4027-a1d8-1a49313f1260,Educational,0.416304870755018,33,40,30,1016,986,72.52296207718064,9617
6274e98c-9f4c-47ae-85ee-62205bece40f,Commercial,0.8894315056405651,13,8,669,960,291,59.91032516428939,8956
ad6246df-66cd-468f-baa9-5b4fd15f86c3,Educational,0.009117523220799728,40,44,428,1094,666,30.19261445180981,7316
62dabab7-fec9-4b93-9f68-ded10cc4eeb8,Commercial,0.7971882510072472,31,43,591,945,354,72.26726532914009,6232
ed13af20-ce29-4f90-9c2e-381898edbb01,Residental,0.19128428688938326,19,21,424,888,464,32.109538302805156,1436
741e2b21-57cc-47c5-93f6-7a9e0c0e710e,Healthcare,0.38182994132064474,25,1,700,1095,395,70.99645275809745,1861
7bec7ac1-8744-426e-9e0c-f06e203ae7f4,Residental,0.8060101051564799,31,1,702,965,263,76.13034212897577,6103
7db7136e-80c4-45e4-9337-125e0a4007af,Healthcare,0.3278413733928902,1,20,174,1406,1232,75.56004882865717,5339
8c9a9814-ec2c-4094-bc75-4d4dba252655,Healthcare,0.08770245471949889,36,19,138,999,861,22.920974111156326,9234
90504cde-5fb6-4db6-9106-adbe5ccc7161,Commercial,0.8768892528360165,49,11,464,650,186,24.583851026773385,8969
213d6cf8-0fe1-462e-9320-98f781db9242,Educational,0.058684484095677836,43,8,648,965,317,16.51131881945197,8860
184f8811-8043-4973-bbaf-bb480bab456c,Commercial,0.747608728049465,8,2,599,1040,441,96.15605237219567,2018
1020bc72-a835-41e1-afee-2d0cc337ee1c,Educational,0.9185610401935553,35,11,508,774,266,68.85910538934864,3584
1ba85912-bada-4f6a-bd3e-7b3f7232c92a,Educational,0.8694986410044659,13,2,163,1131,968,61.531368247020175,8716
d4a71654-46e6-454e-ad85-cbd600f2a8b4,Healthcare,0.856556414003785,27,26,253,989,736,36.53118912133764,1615
a1c2fa28-cb50-405f-b473-5c4f6538977c,Healthcare,0.07033261421524739,17,17,533,602,69,14.086058701455197,7912
c73307a5-a76e-4bb6-b99a-90bcb842e7fc,Healthcare,0.6937797261851997,41,19,178,1233,1055,92.7935421273659,7879
46b6bdc5-889a-4489-8891-0776510c491d,Commercial,0.19358379024219163,5,39,230,756,526,37.12034346823216,2509
205d6f55-152d-4f3f-ae8e-4fbf148e1d8e,Educational,0.441917012561183,31,25,397,1411,1014,10.555829528876489,6681
a6146191-ed31-45e4-accf-ea56e1e2c608,Commercial,0.8857733973295893,3,30,475,721,246,86.5131437775806,6121
b86b9f3f-8427-4755-8eea-ad55f5bea53f,Commercial,0.5561559705365817,34,10,481,697,216,67.44387499888559,1216
35242499-8c42-4f6c-ab0d-28e5a5d5994e,Educational,0.5980974821532563,19,24,432,1084,652,48.964604167750615,5715
76dbc3a0-c28f-4c12-9d7b-1a9a763786f7,Residental,0.739980076645882,14,20,607,897,290,92.59044485191447,3988
19bb5139-b43a-42bf-b645-5ddd24f04edb,Educational,0.464538726091846,10,18,484,813,329,72.46165321742967,6648
d6edabf9-b63c-408a-aa67-804274dd8b99,Residental,0.7251436894878514,40,41,470,487,17,50.429710758541745,7896
56105c7a-e657-41b4-8864-c341c59662a9,Commercial,0.8132139253584386,21,12,329,730,401,60.91661616908619,8715
685719a0-012f-4fd4-a149-05338c9cc1b3,Commercial,0.5386340249003837,28,46,99,1125,1026,25.03497452078448,4194
6b3a2f8d-7e16-4a73-8594-dface9a8f0e9,Commercial,0.005599542186451645,10,9,560,1091,531,98.46755025286018,4426
5b923a91-62da-4973-9452-cb4f0d66acf5,Educational,0.12968050875038462,1,31,610,885,275,78.86635470513929,7310
218fe858-44ae-44e5-a189-dc7bf328ea93,Healthcare,0.41367615139315317,46,13,151,1139,988,55.44819027971752,4836
2cbb337a-e5b3-4b45-b1ab-2284d7084828,Healthcare,0.6612150353566095,30,2,301,646,345,35.97302504866474,9954
37c50901-90e1-434d-bcfa-a3974eadbc6c,Healthcare,0.8263458132052552,22,44,210,1104,894,62.70543923647693,3746
e405ae36-fe96-4a09-97cb-7d39c93c4fb0,Healthcare,0.03510353110870956,14,49,219,531,312,37.98173569492583,4207
0cf1000e-1348-4e9a-b95c-8ba024e1757c,Commercial,0.30123400658952737,27,3,3,1408,1405,28.20964288230182,7212
c2d0580a-5fab-4124-a571-941c1981e279,Residental,0.34765600881535286,4,16,427,728,301,45.04404220236613,5129
22de8418-e810-4383-a943-ef8300a24631,Healthcare,0.7584359702116943,39,35,513,1210,697,83.10801116438351,9447
f1e8987e-94f9-46c4-bc10-afe5902ccb2f,Commercial,0.12779491180559,22,43,138,1005,867,92.74761761468665,7491
e7503d3e-f445-4055-8d3b-c9ab1dad40af,Residental,0.13367101086310085,21,37,552,1200,648,36.682611721611146,7249
d818d687-bc7c-4c6b-ab34-99555176ed4c,Educational,0.149304711594898,32,44,514,786,272,62.63379254328348,1984
576a5e3c-9a4b-4a9e-a4c5-6c42b15197f1,Healthcare,0.6438288388797069,45,5,430,768,338,28.48223940752537,4116
ec001f12-2cda-45f5-8c56-33c88b48c4e6,Residental,0.21605950853174272,1,40,641,1368,727,81.57173536983899,4736
2de3e9bb-e4ee-4f79-b1fd-bcd8282eac0f,Healthcare,0.2177032847799788,50,18,183,673,490,72.86388928134078,9970
092c1aa2-25ed-4fbd-bbba-6c2da081197c,Healthcare,0.5259769290198564,18,33,420,928,508,54.029511123598866,3269
3430572a-8437-4711-9350-2f9d8ae386bd,Healthcare,0.03523193729713836,9,35,447,1103,656,42.840348440650686,2125
95f258b8-33d8-4428-bcad-8d33dd3b1127,Healthcare,0.9978988754429181,6,44,703,1168,465,77.54244255549355,2048
e0be4bf6-3931-4767-ac3c-16691b5842be,Educational,0.9956804127015217,10,19,283,1225,942,55.49459235274212,5465
c5e671a4-69fb-4c87-9932-4d9c225fbc6a,Educational,0.2567579474275169,48,36,108,435,327,26.67490037751164,8161
b6cd12f3-8217-446d-a370-4f4cfe3f0f9c,Educational,0.985465316607647,30,15,237,540,303,63.71724765649887,4109
1e18044f-9747-4de2-80ed-421710152786,Residental,0.3808442071892597,34,1,124,322,198,20.950464931608586,8634
ee2e75bb-d743-4119-9a33-5d4869eb3e00,Residental,0.6385510202750602,50,48,113,387,274,10.04209783514449,1972
61cf4ed6-1c19-4de7-8c3a-3a03c44d009d,Healthcare,0.3524010446676442,39,35,691,1208,517,89.41713904378263,5894
e1de8463-5a32-4bb5-956e-23f43f632cdd,Commercial,0.3479793917818055,23,18,108,1185,1077,24.46938909876955,1467
c4dd8335-acdf-437c-a0ec-22b9208c6532,Residental,0.806351330532645,48,47,247,696,449,44.413002964788284,4282
b070b19d-7c96-4966-b0fb-6f4282cb8847,Commercial,0.2560155052607468,45,50,459,752,293,21.13750722672701,2174
baa81dad-ef9a-4d80-ae15-9472bf03ab3f,Educational,0.9375565590056893,24,37,392,540,148,43.599235490452365,8610
416f1d9b-3541-42b1-9eb5-9ef1474da5f6,Commercial,0.4764129061593534,11,2,320,1408,1088,78.47446430382563,7951
435d836c-e6a3-44b9-9f11-af7fc13e8966,Healthcare,0.9315692923112243,24,24,60,535,475,85.92202169228104,5464
bc1076dc-d68e-43c1-925c-16390ae75983,Residental,0.06007473878582481,15,49,321,1003,682,26.614346360035043,1928
7d9dbcf8-6d42-40f5-9057-55815671fc89,Educational,0.5682141895833995,35,50,141,1407,1266,55.703892307088054,3827
48e258a7-36fc-4282-9007-8e5320245ea0,Residental,0.1772166741912664,11,1,337,636,299,48.25790684146965,9501
f2e3639b-bd79-4880-aed6-e1c9c8c97489,Educational,0.19763439324333,22,36,54,142,88,11.119170695156816,3346
99413bf2-3f6c-4f3c-9724-44267105bf32,Commercial,0.08527110761872403,42,11,167,493,326,83.96467133648761,4998
4606492c-0e38-4233-ac07-cdcff6c69167,Residental,0.3159232724185447,11,16,526,1155,629,38.22368226499371,1110
7e2695d2-5610-4f50-8d90-9cbec3817153,Educational,0.05928441057745115,19,25,97,779,682,51.96135845678426,8824
b25a11a7-1698-4005-94e3-823e0fb5106d,Educational,0.2932486069909215,49,16,613,868,255,92.16896834257423,6297
14b71537-6126-4482-94a0-34d71ed9cfce,Educational,0.8502823722643799,36,26,558,1353,795,24.161455286705863,5440
97b71c71-1aaf-47d2-a0fe-857f4eec05b8,Educational,0.5981797105218947,8,4,347,1217,870,70.71317808372585,8970
fc060890-95ee-43a7-bd59-7bff00ab748b,Healthcare,0.25974422858412205,23,7,155,591,436,53.089713364607995,5073
5c739fde-6482-4ae1-ad87-97901b0e762c,Commercial,0.3969972724035489,18,18,543,719,176,87.88864540271462,4143
5efc03ee-c41c-4c55-a88c-2ab97f76a97c,Healthcare,0.09151028051261256,6,25,609,965,356,49.92367248069901,9223
7df660b4-e9a1-4a8f-aebc-9945151f8e61,Healthcare,0.722341328182786,41,2,547,1359,812,21.601818016963975,5175
199a8bc3-fdc9-4842-a169-4bd1a3de6b68,Healthcare,0.8488148471418531,26,25,412,1275,863,33.21327954452431,4199
3236788b-e148-4110-9c9a-e7c0a8d40e7d,Residental,0.1427169824649568,29,13,251,412,161,69.16835377853911,2970
7320ba86-708c-42a4-880c-dcbb04e2cc57,Residental,0.09423151081837067,38,30,148,687,539,96.57908334813055,3715
740bc1d0-8c32-46fc-adda-4221d95e7ff4,Educational,0.9857263586914727,14,49,102,727,625,40.29576318963238,1650
fcda241d-df28-46dc-94df-444f97754b08,Commercial,0.33020997537568275,41,19,703,747,44,46.17073527658999,9876
9553e021-7d81-4f27-94b6-891d77775467,Healthcare,0.6330634084533416,40,14,374,1044,670,90.62179517072273,9583
500169df-489b-42b9-bfc6-7c629d07cff5,Educational,0.950353705702654,14,41,75,1254,1179,38.767740138802885,2805
74f23f94-d761-4c19-8a1e-685ffe401788,Commercial,0.3551808018325109,3,50,333,725,392,72.1931886845561,5020
1ca95937-d7d0-4b76-9c7f-d25eab3e7308,Commercial,0.964319502117094,1,23,549,861,312,30.601712199885664,1533
f9d6e6d4-1c7f-4e95-9382-64ad3a7911cd,Commercial,0.09199513902213807,42,8,578,1266,688,72.19213417648862,5935
f7c911c2-8be7-4a1c-8de6-1de31a8c185e,Commercial,0.25207470627756734,17,25,522,1108,586,91.03511191651951,9746
977e2cd6-33ac-4156-badf-480f2e97a8d8,Commercial,0.480020119301773,13,43,241,1049,808,61.851492940351186,1555
99300852-4425-44da-8356-e28a7a7c1f64,Educational,0.5297523697352634,9,20,19,527,508,49.81055167015323,5329
35d7205d-cf8a-44bd-bd29-fc122f65615c,Residental,0.2958286867009564,16,29,367,1309,942,57.477214147268,4294
91c52497-c459-4420-b582-1ab4b06e44ff,Educational,0.20078262571502603,3,41,385,1136,751,72.27282431701798,4421
e9153d88-7d09-43d1-b0ed-61a30395094a,Healthcare,0.43693437510793076,43,44,143,181,38,17.951273895045375,1326
b54f9440-0cbe-4ffd-9f62-5e0d62189ab4,Educational,0.2800561315060003,20,32,14,1236,1222,66.0200870255222,7093
da82f1f5-b232-4751-ac30-2c7915de37ea,Educational,0.3876583853337041,12,44,648,765,117,45.83394550652877,9021
010dbb88-2ed9-42d2-ab1e-1c68fed77a10,Healthcare,0.822384096236922,30,33,678,1312,634,44.524285556405154,2000
f29510b6-59c0-413d-9599-7128ede6728a,Healthcare,0.6737941382968439,11,37,494,820,326,24.281774584898624,9267
12625c6e-b3e5-44a3-82c9-6ee711d83cef,Commercial,0.1575038031400262,9,2,253,546,293,78.63267613412619,8228
a4dd65aa-1b95-4d71-a174-8772fc8664ca,Healthcare,0.5719600770413392,20,40,359,1423,1064,88.82184427690794,1852
3648cc9f-de30-46cd-a888-17f14bc33f62,Residental,0.2167017159746799,20,30,100,465,365,30.07811884826629,6328
92e8c138-eb37-4dc6-bfff-25021296dacd,Healthcare,0.5817777377306406,4,39,527,1037,510,86.3834812032465,3900
8f0b0d7c-d5f4-439a-b835-85405dd6eb86,Residental,0.32922232086096304,5,29,413,796,383,54.38271335279202,6358
d1dfa7bf-4ec0-434c-bb07-0ba932882652,Healthcare,0.14719001186459857,9,22,66,1429,1363,10.161225471538696,4377
609b3911-4dab-4f3c-97bd-730692a661d1,Healthcare,0.36965634252116364,7,49,172,419,247,99.61636516447872,1435
8e381667-5ec0-40ae-92e5-70c3c94b249f,Healthcare,0.9945128322852187,34,28,624,1282,658,52.11724366541788,4284
c83a8caa-0b4b-4b48-8650-d227934bd39f,Healthcare,0.3177557969380759,11,44,362,948,586,21.53368502462591,9255
2a1a40d0-0c31-4fab-ad71-6b576b6da65b,Healthcare,0.1852508874214598,30,49,53,210,157,61.45192694744191,6430
847f2c2b-58a0-4d74-ad63-8e3326d6de1a,Residental,0.7220525261044806,16,39,8,638,630,98.80157386538856,2144
109355e4-e65d-4304-9779-bb65848de9a0,Residental,0.760679479188368,40,39,78,527,449,31.592537539378924,2384
402a1d71-afe1-4e0d-b71e-3639ea11cd49,Healthcare,0.6573583470237907,46,45,431,1167,736,50.801562128238075,7864
2e2387db-3752-4d5b-9164-2c46e0418e42,Healthcare,0.4541060079730612,48,27,668,749,81,70.93357069141386,6921
8fff6826-f69e-4384-9794-e4c0f5b0f492,Healthcare,0.18343439597323385,10,46,227,474,247,65.63475671979853,7491
f6a05c98-6c14-4317-91f5-54cf102461b3,Commercial,0.972982457649112,16,47,290,493,203,82.89387084294171,1335
3de1e450-c8fa-4281-8911-78f9a4ce7c11,Educational,0.12018912207344423,28,3,307,727,420,77.03600578636056,2454
8d6b1214-5a4f-4410-8b38-0e5f6d864790,Healthcare,0.5975955730491438,10,23,295,975,680,67.40238725295504,2812
e8c99034-a632-4408-827c-c106b779494d,Educational,0.7569952104276018,7,28,430,683,253,21.810597260150338,8807
07ffd9cb-9d48-4db6-9bb2-df40494ea607,Commercial,0.6035750755458659,19,41,704,951,247,24.55555208640934,5460
50691778-a099-4798-8299-5b646093fa7a,Commercial,0.53770463530924,1,12,296,514,218,78.52323006269306,5588
0499f4bd-1a2d-409d-b87b-6a4f5716fa30,Commercial,0.359670403663335,27,44,699,704,5,65.42219696081173,1773
4d7200b1-e2fe-466e-aeee-dc320e43bfc6,Residental,0.7976932597124909,19,43,618,1259,641,89.55256743104312,1323
c7c7503d-4c43-4e49-b712-86181598246d,Educational,0.4647282317046805,36,1,218,1296,1078,24.285239717159,3944
babd1a9e-c33f-4ceb-ba2c-b6735f446e55,Healthcare,0.1695526647038028,16,30,556,973,417,53.56861242447368,4587
929104cb-5af9-442e-960d-08c8d4f1c2a0,Educational,0.44638706632655367,15,20,520,859,339,83.14342716851819,2391
598dc46a-fe51-4b05-acb5-d8aa1edf0a21,Educational,0.4490348887650416,4,47,621,646,25,45.03341727869551,9727
24578654-7a3f-4d8c-977d-9549ad99ae48,Healthcare,0.4875013421190658,35,4,449,1171,722,33.315045469424234,6514
7b1f8c77-3278-4422-8a81-95ca60184998,Commercial,0.38625093930720444,11,49,444,486,42,46.97835946803561,5784
48595261-729c-4465-94f4-69fc0cc24290,Residental,0.6965153992030695,30,33,183,765,582,25.122871168775212,9037
3e4ed551-16a4-4267-a730-1a577811ca69,Educational,0.8115633459512327,1,8,481,1075,594,63.360779468362246,7072
db544401-8c96-4d8a-ab20-d3888fcabca7,Residental,0.18790703912845608,49,8,501,889,388,72.45172167731707,6166
71337992-71d1-4aeb-9675-89577c9fa3a4,Commercial,0.4528357164316882,36,5,401,1433,1032,19.62275765435513,4364
ffa83407-2467-4601-9d0b-108020068bc3,Healthcare,0.786230258231971,18,12,694,1304,610,64.3467445348509,8104
92ce13b9-b6f8-400d-8da7-c671dcbd762b,Educational,0.3013585057867977,26,41,152,1125,973,81.13939376394866,6011
49d2a942-fa3e-4105-93e3-4bf614a65600,Residental,0.8228746359590795,20,47,399,770,371,87.09235773414528,4364
60448874-125f-429d-a990-e93a2f1737a5,Residental,0.48720875700921074,6,13,142,539,397,78.48340362294522,5572
e4982296-8f99-4f84-9c2b-17ad7ed78fab,Commercial,0.28027868149178303,23,12,225,297,72,54.73402347302386,7880
ed32ce1b-6433-421f-9f66-9c0963fce986,Educational,0.3000002379745179,12,18,263,394,131,16.305933463617123,3168
8fbfd541-9d1c-4b65-b89c-6f3523d0fc3f,Commercial,0.04060054732446938,25,32,316,616,300,32.366470076664456,4224
a6138eae-617d-492e-8d66-c52f8e65e3bf,Educational,0.8943172229709584,2,16,204,665,461,58.76462063250695,2577
5f8c7b62-365b-43f7-9346-bf3335cfc7f9,Residental,0.5890442941122529,4,46,308,1329,1021,63.88846946358863,5000
35789b79-b346-41f8-8528-9147e538922b,Healthcare,0.2834932792777528,49,14,679,848,169,86.07683987203882,5947
c32b4750-2fbd-40db-8da2-19d75c9c0f68,Commercial,0.14070760125307502,38,1,264,1110,846,90.18981884099661,6237
986e3cb3-66a8-4daf-a752-fdd66562a623,Residental,0.5463760300776634,21,23,53,680,627,99.38988221237432,3860
7b827b37-d08d-4bd6-9441-69e3def456a1,Commercial,0.6746081983892142,47,4,598,1328,730,11.502231813543629,3161
f50df5d4-e053-4d14-89ac-5fd26b60eaca,Residental,0.6959042396410793,15,49,712,1427,715,62.33079062984842,3552
4699c9b4-e487-4841-ae8f-04e46121132f,Healthcare,0.14902624261122543,49,49,488,573,85,43.55063308539705,9886
919e6e48-9637-44ab-b856-8ce97574a99d,Healthcare,0.42351770008809697,35,12,686,1437,751,85.8008540244717,7511
7dac95b4-c7f1-483d-a03b-34a434b00d74,Residental,0.24439212949377365,24,49,439,942,503,71.55239756235035,3099
80caefd6-31b1-409f-b02d-7b718a7215e7,Commercial,0.8815439851013818,24,8,179,536,357,47.073129979210584,5441
85c14751-110d-4c2b-8054-a59a0601a825,Educational,0.672281910746502,25,38,448,1122,674,16.623921467649048,6900
a45b2424-9c6b-4a9e-afd9-8d23ade61f5c,Healthcare,0.5382546883398669,8,26,711,728,17,70.24957283934094,3094
5f0ba0bd-78f6-4c3d-9aec-60487b3f817e,Healthcare,0.2254471309928986,48,44,351,785,434,13.629582519745723,7339
0a683e6e-7beb-4529-905a-1a426efa0479,Residental,0.21202352192415896,25,45,616,1004,388,44.69789084060615,4616
c5f9daa8-1352-4ae4-b60c-8e5772503924,Educational,0.9481893347346559,8,42,270,382,112,32.91861713982952,8040
8abe44b6-56a9-4f9c-bae5-dcb50b39423c,Residental,0.5653860528795038,25,28,413,723,310,93.62019086834631,5275
0af3465a-eb56-4714-8950-32fd70698ee8,Healthcare,0.0036966401795257564,1,39,48,1183,1135,69.9519903150537,9580
22274fc2-69e2-4b4f-b326-fbb761437145,Educational,0.13755891132659626,31,27,146,1324,1178,53.479574236661996,3033
a4fd8758-4b14-4927-858a-bac53afa3d9d,Commercial,0.48241738004537493,30,39,500,1260,760,49.199979150378454,2694
0546e4d2-2630-4f40-810c-539784a0e947,Commercial,0.6403376381065985,11,40,312,652,340,94.29860865062493,5801
e1eb9d77-a9f7-42b0-a03f-f5007041ac3b,Educational,0.1441671446949503,43,10,325,691,366,85.58705528150318,8665
45da2002-8857-4667-8b5d-6355c1119dac,Educational,0.44817939974698395,18,4,57,1031,974,56.270781618310345,6475
ed9a8d2e-1ad4-4976-995f-2e4ee0c93ce7,Residental,0.8518790692235915,25,5,201,1126,925,66.42226678209647,2513
e3cce45f-c251-4e8b-8b3e-91eb69d4ae58,Commercial,0.5466036186389744,23,49,48,1349,1301,27.451660168811582,8269
85008943-d584-43f3-99e8-7a251313f985,Residental,0.1619359613045388,27,2,580,1130,550,65.71653718868562,8896
66392e27-8997-46c1-a8d1-e57456023b1b,Commercial,0.705542467532374,49,32,604,1218,614,26.09082031382675,2625
15f984b2-a8b0-4e74-96b2-264127c52a2f,Commercial,0.46960414183719523,30,42,679,1045,366,91.43300480090801,3644
ce5a5231-a768-47a4-9469-4c943b02b0a6,Educational,0.4419761165065246,43,27,18,493,475,21.671450299545572,9319
80b3a362-f424-46fe-8798-7272e51f388c,Residental,0.7587816583984631,4,14,570,946,376,17.960717456330524,5536
641fd89f-ed59-4086-9381-4cc6fff3125a,Commercial,0.8792480003418534,50,42,339,400,61,34.11483841921506,3386
10c212d0-a678-46af-b7d6-5978e678a6c0,Residental,0.5848273350485608,37,14,616,861,245,57.35654002216667,5293
2dfdb7d5-0570-432a-9e4c-54041e1087e4,Commercial,0.2854174021714734,23,28,347,649,302,68.19335257966938,2686
dc5ac9d9-d715-4a5a-b7b9-f86b1d4ffaa6,Educational,0.7909482810863202,45,11,518,648,130,93.6746092511116,1855
768c06d4-47a9-45c0-b16a-9105781cf576,Commercial,0.9323751666270278,49,11,104,385,281,23.97914604996931,8132
5c7dbbd6-b3e9-44cb-b3a6-3c3f2e1f6466,Educational,0.6187697302213823,35,19,544,1084,540,82.6143015378415,1205
601957fe-5434-4638-ba00-6acdc7ceb0b2,Healthcare,0.9603785097640263,42,39,430,1287,857,50.600878661464286,4324
cc94fe37-0338-4f9f-9edb-48c0796cecce,Residental,0.2718325114203638,36,39,270,963,693,44.76008057649385,5177
587d3bdb-912e-4132-970e-f44d1a743c47,Educational,0.1552973201961917,1,21,431,1035,604,48.395057330565926,8143
1b3fa9d2-54a7-4fdf-bd29-7d111fc5faff,Residental,0.7074234363633093,17,2,131,1002,871,83.32635804296925,4029
84519b55-b2c0-42a8-8080-45f34913e132,Commercial,0.636003715578167,50,1,352,805,453,42.88741967163746,3902
6d37906b-dce0-4fc4-8ab6-3876c2730b69,Educational,0.17276181585780515,21,28,222,532,310,24.545046193406655,3911
0d759d8b-01dc-4aa7-961d-12a68f2e86c3,Healthcare,0.16256261675226547,33,43,28,63,35,33.313978328234484,3986
64be4673-8642-462b-bced-cb722ea3cdb1,Residental,0.38412004801553135,27,37,110,1403,1293,78.08322642475716,1309
d77f77c4-aef6-4cc7-bbb9-1ad215cfe782,Healthcare,0.4533479412212872,32,10,293,1072,779,20.49038942353089,4867
e1bdba2a-2f6d-47ec-83f4-68cb788e2c35,Commercial,0.647471780036143,43,34,214,857,643,73.9400684161844,6351
7792719d-9c9e-4121-8968-247dfda8a24a,Residental,0.7033072802094315,3,10,433,868,435,16.38340218027445,8977
f951397d-8068-40b9-9dbd-fb52ef39d3b9,Healthcare,0.8381154419991151,26,43,633,1160,527,28.194964192759922,4955
a63eddb7-7bef-4ed6-a1b1-140aa390adfd,Residental,0.852433541513943,4,10,225,643,418,95.6321378074947,1381
367553cb-9c7b-4820-9852-2c2e56f2aaff,Educational,0.45697428907956206,18,14,47,364,317,17.504564891277084,9042
0ed5da6c-95f2-4e96-bdad-662106fe8bcc,Educational,0.9387741568274731,3,23,63,658,595,71.88310798368167,1621
9be92d35-009c-486e-9b28-851c7234b393,Commercial,0.38520607267977036,18,28,629,1110,481,70.8020290026901,2415
dfd55622-a235-4bcf-a454-814d98276d71,Healthcare,0.09149280810601179,7,40,354,1017,663,88.67706594225201,4791
b25405ef-740c-433a-b8a5-bc49980f4fdf,Commercial,0.8651141418259872,45,24,184,1052,868,30.309880044255284,7079
0da0c945-8feb-4c9b-a672-9c3633ee6b9f,Residental,0.19370546910349784,44,44,593,693,100,79.46179712427288,2171
d48ca882-d07c-4c4e-98c8-9c891546883d,Healthcare,0.4643980095376057,45,24,161,341,180,98.50251439040927,4954
077c19c2-f998-4d45-b3b9-f9e96dfc7d60,Educational,0.6661185931651026,11,24,159,533,374,19.102658122763263,1773
516e60ab-e13b-402d-83ff-5eec09b3bcbf,Commercial,0.7045267552052952,18,48,618,639,21,45.10606872780064,2541
5ca8a029-48c2-4868-9da2-5787df76c6f6,Residental,0.5053706268397845,3,9,579,1026,447,26.34963440462738,3405
7a5e09e5-8b51-42e6-b699-090c5d58ed11,Commercial,0.8912717903683954,47,14,257,1153,896,66.75552946267482,4591
1b933b0d-6434-471e-89f0-f19fe8c237d7,Residental,0.3844674530051685,30,12,126,1435,1309,91.43856666369082,1797
12db3f6e-83c3-4260-b5f0-f973439cebae,Healthcare,0.5967798455339874,12,23,421,779,358,42.6570562870152,9359
10d77e8d-4ed1-408d-a63d-8b1c0e4fa896,Residental,0.992217722198667,6,9,595,800,205,73.05526843001017,4250
25c4bb1d-ef5a-41ed-b31e-4b9cdb7fcce1,Residental,0.9130228304568808,24,5,647,906,259,99.20664529163002,1857
430125e7-4145-4f63-ab81-6aa8c020f2c6,Healthcare,0.05325145772664064,14,17,236,526,290,94.13616548688522,1744
c013d362-9528-4798-ab40-cce5b03d0961,Healthcare,0.4211535449127849,21,14,5,259,254,55.354151905207694,7452
7fdc43ae-c742-4fbe-89f7-fc1b7b82be43,Commercial,0.2852009397217574,46,21,532,853,321,39.48165218893479,4231
42276f64-3610-4261-8a2e-fe0b54cee242,Healthcare,0.798751563214465,27,14,586,823,237,96.2153678043502,3898
1b3b00dd-3f8a-4738-bf77-fb2a5abd79fa,Residental,0.36080510405254973,29,29,278,987,709,45.56999835553011,7154
fcda3423-52e5-4122-b8d1-a137bb916889,Residental,0.2076949098794575,21,37,274,1423,1149,58.78982357488877,9827
8eb78049-e7ff-46e6-b3aa-eb487c8ef801,Educational,0.7766025869582941,25,34,216,1153,937,75.68167508065042,5138
52dc096c-ace5-4e54-9c10-e7b86bf28af7,Healthcare,0.7757840610896957,22,16,335,1366,1031,49.06053969352066,2066
2108eefe-a59b-4acc-b58a-f11adafe6930,Commercial,0.3131356102293703,49,37,336,1037,701,68.74961450716452,8453
fe8810d5-c6fb-4bc6-ba60-55b4bae4150b,Healthcare,0.8164057466262025,11,46,140,623,483,36.97987520266867,1240
2ae56dbd-c570-4198-af3c-352c132486e8,Residental,0.2535258977498912,28,16,709,1108,399,75.50563999337655,7014
0532128c-0daf-45c4-bf49-54213fb72237,Educational,0.2817417076718959,4,1,512,987,475,43.34451997670025,1834
bce6dff5-635d-4331-9b0b-2ef841613a3e,Healthcare,0.37741948146930626,45,39,329,1158,829,31.708780952100433,5646
dba50bb8-9516-4a6d-9e50-fe4410ab3c59,Educational,0.7726708232551768,27,29,381,1292,911,27.479554478562854,5463
03b993e5-a29b-48b5-9ede-f0440ff15b96,Commercial,0.08643289724103365,40,50,462,911,449,72.96879675075543,6013
2da0c0ed-fbcb-4f8b-a94c-bea3bb01cbf5,Educational,0.45388271450362716,29,37,590,1190,600,17.251135707407602,2391
5fcd160c-9af5-4e6f-85aa-d6de754b477e,Healthcare,0.7955841704260141,31,40,264,1163,899,67.74618166837678,8919
8f67bc2c-7d61-4091-890d-9d7e02f5e0c1,Educational,0.5030346037513727,29,48,165,1259,1094,87.27961720208438,1136
e086a6d1-5b18-4aad-b9a3-58efc9bcfefa,Educational,0.9381074231362041,50,18,534,1057,523,32.345412206904626,4564
cff5b552-21fc-49df-b39e-bef02e3f5c22,Residental,0.009367714656196346,28,6,508,1403,895,62.838041005552576,8288
e3c40bf7-cd88-4938-8b4b-60b5c42c5e63,Educational,0.490347679996356,11,32,535,1321,786,81.27601251941155,4655
7324b1c1-3039-453c-89e5-98492d42e637,Healthcare,0.9888562470146683,4,36,273,406,133,66.98543299331183,9523
2a8cc9de-25e0-488d-b84d-e07d11040494,Healthcare,0.16810581744634412,24,46,663,1092,429,66.5889399435712,7048
aa2716dd-1cf6-4f20-b14d-eb9c4a7b95ad,Commercial,0.04812032300179114,35,12,606,1189,583,28.185091762957793,7986
0e528eb3-05d4-4e7c-8d05-c330487a9cf8,Healthcare,0.9808991938193488,34,21,287,773,486,72.49993558536593,8900
aa70de79-2823-4dba-aeae-91bd09f734f2,Healthcare,0.8861183236075884,43,11,403,451,48,12.985625048187789,9160
60b0f4de-a1cc-40ad-b77a-1a0c678d4710,Educational,0.2821091429888154,46,7,73,289,216,47.33921068173216,2231
cc0831ab-47d2-4f48-b0cc-1350c693d99c,Residental,0.17487441171090568,18,10,637,887,250,34.50952482181553,6366
408761b2-fb18-46da-a198-badc531cdb1e,Commercial,0.35935176270623037,25,40,589,788,199,80.18597665374313,1758
4544658b-ff05-460b-bf6c-c997c3573534,Commercial,0.31943330149360405,24,29,440,652,212,66.4162942601678,5905
4d186223-8946-48e2-adc2-0f23458e03a7,Residental,0.5155788566206856,15,50,620,961,341,31.116907435019773,2798
fdfddd07-c476-460c-ba37-9a845032d46e,Residental,0.5129873233965685,45,31,633,1388,755,54.7657542227266,1029
55524905-aa29-4189-89d8-c04ae0c349ea,Educational,0.6377265586301175,4,45,226,581,355,78.2035589487918,2352
d2ffcb8f-cba6-4824-9615-8ada63d86df6,Healthcare,0.507855717878107,11,20,463,1253,790,59.56746548899235,8887
c6330eea-a203-441c-b4fa-984bf6928b0a,Commercial,0.7060534783242484,48,46,464,502,38,12.096127855652957,4804
a746db44-1ca7-4ca0-a2f2-849f5ad2e9cb,Educational,0.9906325471115636,44,21,442,698,256,89.97953169704907,5573
f1c66dc0-6f0b-4403-a0fb-de39217c1c07,Commercial,0.5627614600036628,4,34,160,869,709,95.42904755923168,7780
eb7233c2-785a-4e1a-aff4-7538e7b38f55,Healthcare,0.9316812663230699,40,31,92,238,146,57.36080147681756,3289
595e8869-288b-455f-8a88-92116a5ee703,Residental,0.34766655809398095,21,9,13,389,376,77.71032323316751,5566
1395ed60-90ff-4415-afca-f769897f8be3,Educational,0.6942239262713822,10,19,98,1333,1235,28.79892881908777,2794
99a88408-e623-4578-a28c-def9d75f63f5,Residental,0.9448483241986232,48,3,706,955,249,44.80056457315704,5823
a7dd56ac-83db-4a7e-bf6a-bbc4870191f4,Healthcare,0.3540807733836958,16,21,672,863,191,96.94025451913845,8129
f6ea0629-114f-42ad-8150-f91a77800418,Residental,0.4757567341517327,19,35,59,1354,1295,32.83263015420955,2698
ceb193f6-88bc-4b05-9139-3aa44eb2bb63,Healthcare,0.3298985485854733,26,1,395,1142,747,80.43567471619497,7303
76a74aad-fc95-4008-924c-33a397ff989a,Commercial,0.5351402059431047,45,41,12,1323,1311,37.502639884999674,3694
06ec577f-2a2b-48a1-a90f-2d602ec467f9,Commercial,0.7665054110692958,37,14,126,251,125,42.674264598521766,4066
10508abf-4c34-4c70-85a3-c3292f11d388,Healthcare,0.8126151428689982,19,39,383,1098,715,10.426732896482845,8726
126851bf-4ba4-479b-8c7f-a7ee1d5aec00,Healthcare,0.9293995429934124,22,29,393,816,423,65.37456811873844,7277
eebe8cea-c546-4d37-a276-d82c6f892ef1,Educational,0.27941987239054533,49,37,589,999,410,89.46763334100149,8057
3224a8a2-13dc-4238-b34a-c8099bb66c25,Residental,0.7536620576445486,20,46,557,989,432,26.200476669201393,6813
5bcf6b36-d82f-4f30-a76d-45430bf0518b,Healthcare,0.1348987971052703,30,14,554,1306,752,87.00051555489927,2729
b1906f71-4850-4cdf-a9d8-8e9350b9be6a,Educational,0.7200991041007759,31,45,189,193,4,11.645020815221322,4094
982e2e33-5558-4188-958f-3318e2ccdb16,Healthcare,0.6660319388382309,28,42,106,817,711,87.19712379996629,4250
cb148462-73e3-4b2c-825a-f9a2257e6a4f,Healthcare,0.9760991657523953,47,27,425,1430,1005,53.403690196095134,3654
33b3d1fd-4d05-4665-aa38-aa190e3ecfa9,Commercial,0.6429562757162547,28,35,494,705,211,36.897984865474754,6133
e066495d-b2e9-46c6-a8b9-dc1086a2f355,Commercial,0.20573683390827768,31,31,449,1134,685,39.2879192434516,8188
fa53fd2d-07c2-4b93-907f-a0ea7d5801f6,Residental,0.9256832461392146,35,6,654,918,264,39.77534389201841,4326
6b1bafc5-ecca-4b48-8fe6-ddacfadc2353,Healthcare,0.7503939211695714,26,4,6,662,656,45.4280580098549,9279
422744db-6a30-48bf-95af-f6517fa2a274,Healthcare,0.4614035971540187,17,22,714,746,32,32.96368084365765,7859
7f17960f-87c8-4d9a-b27f-106cd4b942bc,Educational,0.6209153022882099,10,14,624,758,134,57.95922894393354,1362
5bd6ba7d-3d3a-4559-8b07-71987f3689d6,Commercial,0.6179472674905429,48,19,70,648,578,87.05660677308356,9003
832f78fc-e4b4-4dfb-87c3-4a62f84442ff,Educational,0.12892203472339647,26,28,61,628,567,15.061037601630442,6286
9f025b1b-bdac-41ba-8924-3446fbcb50a9,Educational,0.6211413043525781,36,23,200,724,524,80.70639537061793,1016
07018491-53b0-45f6-a0cf-4acc19b837b9,Residental,0.6891813454004704,43,22,337,504,167,66.02722433688726,9256
219a956b-1484-4a0c-89d1-3fa9e3be6291,Residental,0.188824000003457,36,17,677,775,98,95.78122307440795,7398
097ac6d1-b66e-45a0-95a2-33eaa08c53bd,Residental,0.14846017044387905,2,30,223,911,688,40.38898553063545,4886
b187499f-307f-43fa-92e1-5c6bbea5efe4,Residental,0.08768747933925047,1,45,515,1357,842,51.29108324493644,1285
ea807ec8-d863-41e8-ba79-386b02519ac8,Healthcare,0.6423183283622027,26,21,662,1294,632,78.11792306720665,2034
3de4b39c-26df-4bf6-a228-a69eb18e4ee0,Educational,0.7172473887733236,18,17,340,917,577,71.30173861837399,7517
af9d57fa-858c-4cb0-a692-43410b1d1aef,Healthcare,0.1839100726798517,30,18,348,787,439,67.37767207857304,5881
143080d1-6f03-4aec-a08b-e1a7b1567df0,Educational,0.7427502042940837,9,30,213,533,320,80.27478025510852,2800
55a283e9-78a8-4a49-9042-8bd1cdaee285,Healthcare,0.5933329053811697,43,8,594,745,151,95.39410363056965,6650
1fac9510-1b6d-4515-8c0f-de246fda913e,Commercial,0.47250624591993506,27,33,32,1168,1136,26.79378307077166,8876
d8d64e3c-a301-4ba2-b9f1-fa8d316a37bf,Commercial,0.8582201283568258,38,7,296,728,432,94.38608439979994,4432
c6331a39-c22b-4c65-8983-fb15fbd4f17d,Commercial,0.13045573882829176,18,20,609,978,369,17.850746612994705,1383
7455e095-10ad-4dd9-8e60-2eb87e14b19a,Commercial,0.9344809082579483,26,5,124,1213,1089,82.66894996485128,6073
9d927c4c-d084-4a11-b96f-a1897d836a86,Residental,0.5761545326676473,42,49,343,763,420,49.73188345564144,7510
ffa28f6a-566b-44c7-ab1c-83333ab6dc0c,Educational,0.3787843361815926,14,31,654,1257,603,37.953201466132015,4064
ca0c682c-8781-4a17-a5d3-5b8276d55342,Residental,0.8981905243662758,50,44,150,377,227,99.76190860862712,4229
4bddab27-6b0b-4d78-85f2-139eb3312273,Residental,0.8821072606398921,9,30,61,1316,1255,43.69457515644988,2558
0086c4f8-1ea7-4b56-a968-7a30b736a615,Residental,0.14056952460051364,29,43,248,826,578,65.91952852634489,9316
d700dd90-a6ca-441f-91e9-c7a7ea614f87,Commercial,0.6914230305497727,4,38,1,328,327,33.8541005321655,5042
5eda0d18-9ed3-4e56-85d0-08e767242943,Educational,0.10980392261106531,42,3,475,1155,680,23.37228065720472,5186
52609775-b41e-41f2-bef9-afc5b28001d5,Commercial,0.0654827701249141,40,24,595,1114,519,48.05148162737501,9526
d1c7abff-24e0-4716-9cf6-863c2b1f8239,Healthcare,0.8844966960168941,13,27,525,1264,739,41.35901908405837,7260
295defa5-5982-423a-b2e4-b1dffd750e46,Commercial,0.9680525736992442,46,10,45,936,891,17.80412155001605,8658
1b21ae17-c977-47eb-959c-dfe5761c1298,Residental,0.40623680141511964,37,41,305,1392,1087,19.141016365480144,5518
039fb7c0-8ec3-4b02-b9d7-4f492d590313,Educational,0.10882740828337878,44,47,392,1332,940,21.26075488260537,2717
8c9ebdd0-6002-409a-ae84-e779981dff0c,Educational,0.5682674056729751,8,15,409,866,457,82.79632100303819,5536
fbddaf8f-026b-4ded-9efc-b7e9aa5f21e3,Educational,0.21533151460353372,5,12,183,609,426,46.00070295636324,2898
c2dfbd05-26f6-4b92-8ade-64ba8dd006bf,Commercial,0.9325839624244441,50,25,707,1148,441,10.676982531834675,4777
e27d9393-d1f9-4493-b838-aa911dcc49fd,Healthcare,0.9991021567874666,46,37,582,717,135,83.4743065419216,8738
badcaf4e-6e19-4760-8247-51082d7bc104,Healthcare,0.13454466300631007,9,19,513,1358,845,32.91405843628559,1628
37c2a446-a914-4fa4-a23a-f3ffaa36eedd,Commercial,0.5266118393037341,29,44,720,855,135,23.334010492933185,9353
cba81780-3eed-449b-b79d-9b28ffac265e,Residental,0.9367561716501027,49,35,369,1438,1069,69.07791387268108,4655
73e3ca9a-62f5-4370-9aa5-1020423605eb,Commercial,0.5377853670315856,40,20,554,1323,769,81.92944196868899,1672
3d9121c7-51b5-4d62-bf8e-b700cea2f2ce,Healthcare,0.8875946476525343,48,26,144,1103,959,36.636364407965345,2433
1af12073-cdc0-4a82-b7d1-efdb23922965,Educational,0.2035712744779289,32,49,257,1133,876,86.22454615860623,4089
1029e1cb-2ef6-46f9-9cf6-feaf9fcf52e7,Commercial,0.4937972929168316,12,43,681,1217,536,19.15221363589304,6365
e598f58d-32e6-4c14-be1d-d3b3667e03cb,Healthcare,0.42022840591503086,49,8,430,1024,594,41.927741669045645,6760
2b74e414-b337-48f5-94d4-ef8179420baa,Educational,0.4913045774500169,19,29,125,479,354,40.34541901039306,4912
90b67090-9006-459a-aef1-7f8030dddb7a,Residental,0.4933129727781942,17,47,529,1395,866,46.31875667091894,7352
24a842ec-1218-45c7-a990-174bdbcd259a,Residental,0.0508212656197814,2,21,718,728,10,77.57581830867174,4068
74d1fc6a-b7e2-4ffa-9558-6bba138e1298,Residental,0.8944622632089235,48,23,584,760,176,20.478820818068304,7496
ebc3a671-4bb3-4eaf-9dd9-6111553ee63a,Commercial,0.2493052127691222,42,28,242,831,589,71.99966617655375,8777
60f2dc96-6503-49ae-914e-6590ea3d795d,Residental,0.44535079706580083,47,3,594,828,234,26.09310595490915,9367
3785fdd4-3841-4b04-a1cc-ebb47bd0bd39,Residental,0.19160391940382804,19,47,394,522,128,99.34018464998059,5879
8dc4302d-65aa-45a9-8931-395b6f802b3a,Healthcare,0.05987476021344107,9,14,318,602,284,91.78032620741003,5624
59eebc43-dd2c-4a61-86be-29d5d4cee27c,Commercial,0.871926574571318,24,43,326,386,60,34.235599918265905,5036
89be7da8-20a5-49f5-83d9-19d22b0af2e2,Commercial,0.6843861297406224,7,39,320,1140,820,85.48175456648411,9888
16615a71-7983-4fac-9c5c-434bd494ff89,Residental,0.9467688328492374,50,16,96,338,242,31.477954638651422,6209
a24b002c-68a8-4891-8cf9-2c236efbf9b8,Residental,0.7887168958301537,35,22,715,985,270,28.240606258244068,4882
19144ba3-9296-4d5a-b6a6-a9f3c39446b5,Educational,0.1811753762248537,44,31,21,702,681,62.67271018270529,9686
be9da857-fd06-456c-9cc9-53029a7c4590,Residental,0.8905274407430122,18,41,685,727,42,86.64481879454783,2379
6245e4db-6293-4914-b25a-9af9eeefb448,Commercial,0.8479182136558175,40,27,168,1246,1078,21.51847451257692,2037
00f6f423-db3b-4ff3-8303-05bbf03eb3e8,Educational,0.6366859137628597,31,9,231,1432,1201,43.12465946988896,1607
98dbd08b-0c7b-46ce-a1fc-f25df6de9e72,Residental,0.6306894417231743,21,49,573,1045,472,35.33844428937389,4689
c81f29a6-c6db-4597-bde5-f958077e7368,Healthcare,0.25578121449288105,39,45,339,550,211,88.95990351188541,1831
e1c00d45-6fac-4505-9c5c-4697ff2aec91,Residental,0.9774829174188303,49,30,491,1200,709,47.22972034039647,4315
e05e7c66-b686-437e-ba10-34f3917aa560,Educational,0.46659200728972283,35,11,110,634,524,17.11045154568511,9073
27119790-b6b6-4aa8-a0ce-ba1e1d32445a,Residental,0.2675566815323812,26,32,263,1429,1166,56.358651635971675,1553
e767ff50-8139-4ce9-8344-11413f6e274f,Commercial,0.6300157598788293,35,45,256,1339,1083,94.01444352543845,7802
d0f302f9-51a4-4d4c-9c35-b38b00054eb3,Healthcare,0.016944782990725327,22,45,162,558,396,26.103766896559556,3262
98edd9d0-8ff6-4995-a1b4-9e330233f243,Residental,0.14498211888246149,25,26,542,687,145,14.365457774336226,7279
f0553420-014f-455d-9a60-8172524af5e8,Healthcare,0.7223259040527009,18,38,624,1277,653,83.58837923825452,5755
cdc1ad9a-7dd9-4e4f-bea2-0d23fac63cdf,Educational,0.7207130359804474,32,23,354,650,296,94.7565106929393,5860
0e3c6c6a-3029-4196-80c7-a7fcfcaab158,Educational,0.701149797375739,35,38,525,584,59,88.02092263198877,2121
0770e28d-093c-47f2-a3f5-6f7c38862596,Commercial,0.2642560098868604,30,3,270,1048,778,40.407556260724974,3191
fcee0548-ebd5-45a3-b395-991a56d64f69,Healthcare,0.4699631087981684,22,32,377,601,224,82.7280991825179,5126
f58ad62b-a84d-4b0d-ac8c-952ad81e63d0,Residental,0.9811324033835996,41,32,313,1180,867,74.5181588777748,2691
1d1df388-cfa7-4310-92a6-12407ccd056f,Educational,0.014986302178185196,4,5,431,689,258,93.64438059246021,2528
1e76270d-18ef-4892-a370-80535ccfda51,Residental,0.32240291330441095,50,23,186,1271,1085,32.84924100542419,4723
db9608d0-b011-4c48-8a26-d9b52faf3edb,Commercial,0.06007117127216732,48,12,84,371,287,44.03873921831181,1239
f3016661-a1db-4d6f-89da-9bf9c27a62cb,Commercial,0.9297992240584533,7,11,475,977,502,60.89290834248625,5982
62ae1b66-39d5-4631-8032-06c559301574,Educational,0.8067616941499548,9,39,211,548,337,69.13542355738036,3856
11b93cc1-a711-40fb-aa2b-0c54f4cfa197,Commercial,0.3903256912636557,33,28,687,855,168,60.721827167851394,6620
4b780d6d-9d5b-4468-90b6-a94c37e66639,Residental,0.4778251426983636,4,36,585,696,111,16.893857175397756,5630
e5b1773a-9513-41c7-bf87-bb7af1b7d91f,Residental,0.26090432784020234,26,8,409,678,269,47.74077758885077,3418
0a99aa71-0c08-44f7-a4a5-570f7c890614,Residental,0.5651904681624664,31,24,481,1109,628,42.49115909052644,6295
6df4c94c-1ee8-498e-8208-2d02ea31a8fa,Healthcare,0.465378112919534,49,32,97,945,848,46.528694413639045,3746
0f3f003a-d48d-482d-972a-56cf6f7564c5,Residental,0.3253722104509933,27,40,274,600,326,26.87385495765239,5451
34c6acad-506d-4e9a-9d4f-b3849eb64bff,Healthcare,0.5172519568622752,35,12,483,1357,874,32.933369734940364,8272
f40576cd-d92f-484b-ac79-776e3d5cac0b,Residental,0.20788421268426782,4,34,603,1035,432,91.82666473914026,7773
a3651090-6d06-4238-9fbb-b19f02e03d52,Educational,0.23944639907415466,49,28,578,1270,692,25.991050217567107,3531
972ec293-9872-43c2-ab85-c4085095b734,Healthcare,0.51856710180595,34,37,413,1169,756,70.15630191477271,4152
f408d88f-4a8d-4e29-bd30-d933da415000,Healthcare,0.9904536345606632,15,44,390,894,504,32.375623240825405,1398
2812a97b-b2a7-44d8-9e1f-21a098630d6e,Residental,0.07050675183030641,10,25,147,296,149,62.64278827128249,1711
86265e54-143d-4b7f-8cab-12866eaa71d8,Commercial,0.6347651419690696,25,34,69,1371,1302,58.8503140313995,8660
aaedc0c0-5eb3-4cf2-9cd9-67c8a7eff5e6,Educational,0.48642580608119745,10,22,3,584,581,97.67462320010382,3674
f9cc464e-6357-40e3-bc0d-beb4e731d1b7,Commercial,0.1497666647106437,10,11,710,1417,707,68.19994345571072,2014
8c3f9a05-edc1-46a1-9653-5af24ad16631,Educational,0.026804648835004552,50,6,191,739,548,18.412998141235498,7639
b764c994-b3fc-41ce-9d02-975ad50a63d1,Healthcare,0.06063798016017763,19,20,664,750,86,32.323079896571414,4462
1adb5a4a-1f4a-4300-ad70-1a7dc54468e8,Healthcare,0.09059095322350141,10,17,592,1086,494,11.164340990408121,1930
78e5175f-af0c-40d8-b720-a49c4c690e81,Healthcare,0.30991416667435456,50,5,89,1000,911,52.6956520393623,3899
78e58dfd-75fc-4602-8401-48a8f0ca41da,Healthcare,0.10731754246154401,18,22,17,31,14,94.37592659614418,2135
8c9a0ca0-1715-4329-b9c0-404a13c2f2ce,Commercial,0.7857813335986599,14,35,515,853,338,47.36592530064288,2967
e4849e14-cdea-4ca3-bf1f-523022088670,Commercial,0.15056008046030667,1,8,222,996,774,54.07830214101074,8362
ddc84e0d-d271-4a0e-bdc1-090947fddd58,Healthcare,0.5415258073485368,34,28,499,581,82,32.024360928648804,4333
256bbb74-8a11-446a-af60-67655948011c,Educational,0.3243159725657835,21,33,563,1318,755,96.63166048330834,7217
18851499-ffca-4f00-a129-ec648a2a5012,Residental,0.5345368563121125,20,16,626,1290,664,30.92979315731191,4904
b483d608-56da-41d0-9117-118c29fda6a3,Educational,0.6764140125631897,25,28,192,1228,1036,89.5237305065801,8973
d12e0eef-f810-41d6-8c6d-b2453c1b2f36,Residental,0.6368848484711791,34,29,545,608,63,31.839280278283947,4666
60941d4c-4d8b-4ca2-9d18-22acf5b25f66,Educational,0.2585223506763641,49,11,377,408,31,22.419734192055138,1276
135e2651-e81a-459c-9b50-0d4b1d61fb1c,Commercial,0.902392425700538,40,49,431,668,237,92.58433592944151,6127
d3b8f9af-bb98-4907-9c4c-6ec6bb2690fd,Educational,0.8880048402249541,39,5,203,598,395,39.90247065356979,9179
66abd910-92e8-4519-9492-f556e03b5ed6,Residental,0.8739949114245371,23,46,470,1403,933,65.3170899335395,6249
552d1009-1c42-4fdb-8bc5-63fdf6132659,Commercial,0.4153166770925133,24,12,195,1062,867,20.82686956442223,8923
4a44c515-9d95-4014-8d9c-6ea739455186,Commercial,0.7878677754047241,21,12,134,919,785,89.49561810786544,9005
0a7bcd8e-01ff-4825-9162-2bcd65c0ffd4,Educational,0.4518291237860893,3,41,406,1120,714,19.341223279409466,9963
e4489e4c-414a-400c-9559-da5b64fe3c47,Commercial,0.6286551232111037,10,34,121,565,444,86.68460682551144,2099
cd5ce90a-b627-4183-b8dd-684805f8b255,Commercial,0.6494250611428141,28,15,264,408,144,93.02690993563806,7129
c804bfa1-2af7-4e15-bb9f-f5bc65925897,Healthcare,0.14129686317664258,39,27,232,1203,971,34.360835665925705,1848
5ca2b0da-26b8-4d86-9927-befde903f5d4,Residental,0.8666650577744568,17,31,500,588,88,81.04970998221803,4937
eb4a885a-0fc9-45db-9335-e6768f19280e,Educational,0.413935318698891,30,15,15,407,392,16.344386596492704,8037
bd45c441-d5b0-41c4-b936-88d015402b4d,Commercial,0.8693234413044567,16,34,125,300,175,83.76515274949537,9391
b35c173b-ff0b-493e-a8c2-3cfca57a344f,Healthcare,0.8675444307906142,17,45,399,1293,894,39.69848034856972,8475
7fd2e52c-b109-41d7-a328-0f11c9f2ef4c,Commercial,0.1483833588998248,46,42,253,1379,1126,38.50736838232646,6061
e2b9136e-4769-4478-89c7-6dfdf06b586e,Healthcare,0.5802253689634701,29,6,97,1155,1058,94.39177207141708,6108
8b0edcfe-6f72-4b93-8a3c-211eacdf1fc9,Commercial,0.0035906817534632207,15,6,45,497,452,68.78524184615506,9431
048628d4-30f9-452e-be16-a1562ebd0de2,Healthcare,0.46358109631280586,8,25,393,764,371,61.15340453299292,8641
6d840d4d-07b1-45c8-bb30-486fdc6ea2ff,Educational,0.9491284359269981,25,30,485,1288,803,32.862383006666576,8230
8a132d54-d03e-47ec-a897-e00667654711,Educational,0.8751336661661002,33,43,238,999,761,59.627706633155434,2992
b2ae507a-1057-48ab-93c1-c4a943701088,Educational,0.37434978955464127,7,15,527,1090,563,34.68898582419974,7946
349e65fe-755e-4040-925a-4283dc5fa8df,Educational,0.7953726251986566,10,46,678,1076,398,14.28160271598349,1553
c5376ba0-8604-4584-a500-26b1e02eb8af,Educational,0.18936792389233115,36,33,412,800,388,69.85367475040671,1019
54544c8f-f2fb-45a5-b0df-5003ed961498,Commercial,0.12184695955960001,46,19,236,1351,1115,28.919657428230547,7517
a3ced854-69a5-4183-87aa-4acc41831f1b,Healthcare,0.21997350546746208,17,26,323,657,334,43.55028483035793,3816
033250ed-1051-473e-b464-319ad5d89030,Healthcare,0.36509123629206386,2,31,242,887,645,30.007069748756077,4200
ce47aa0d-d7f1-406d-8e44-81349739cfd6,Residental,0.2741111181234186,18,34,466,778,312,74.43433139527873,1220
dff9c298-9a4d-41d4-879a-f61d23e6afea,Healthcare,0.19725987040537307,18,38,48,1139,1091,20.452785766584586,6596
bc1e3d89-db40-4a6d-8d63-e7046db37ea3,Commercial,0.18574881647572283,19,48,573,1355,782,94.73647638485139,4424
f9ab26e7-e876-4649-86cf-fc1bea822748,Healthcare,0.22873435301391343,9,19,235,740,505,42.39918814186604,1969
bfe8557c-3c56-45c2-8d69-54f22680febe,Residental,0.0666754449743957,43,22,86,266,180,15.326778935321403,2653
b33331eb-2bd3-45c3-9769-9f0384b747bb,Residental,0.5398505455291045,30,45,532,1060,528,94.78154495297198,5397
1379242a-2f8e-4477-8b56-fa2d5ce847e7,Commercial,0.56387983704049,46,37,314,1154,840,44.80321104345199,8960
c27080bc-c07f-418f-8d9c-f79c624d9104,Educational,0.3938941189542774,19,47,642,1269,627,21.210835930353255,8324
e3bd2aea-b8cc-4706-8b5d-615488aa987c,Commercial,0.9209199661140266,5,12,439,1189,750,17.125485710977124,2220
c3c0ed05-e85e-474e-9b32-8ede22a0e031,Educational,0.8375658165348414,14,25,69,903,834,29.799101942295827,6321
92137bff-3e85-474e-b641-c1af35cfcc42,Commercial,0.9083267645766003,7,37,108,595,487,62.56302889883294,2763
fadf15ee-1ec0-4780-849f-bacd06f1945c,Commercial,0.27365816605439897,35,38,373,625,252,65.34280915080276,1762
4a85b43b-0c84-433f-9955-525831817a80,Healthcare,0.045588084587601996,15,24,418,957,539,92.71230392741904,4241
f03596f3-a5cb-4035-99e6-d98a343ba8da,Educational,0.7735573532239118,45,48,153,917,764,75.07402681295562,5517
c4a09ae3-2035-450b-b79b-e8be442777b2,Commercial,0.17207452382934407,3,5,675,1155,480,84.46441996328167,8686
50f6ba31-c377-4c9a-8790-18cf22a0cc14,Healthcare,0.45177584413289196,37,6,385,466,81,13.958748018628679,9756
dcaacf4f-492f-42de-9620-1afeb545f7cc,Residental,0.5881269322695636,36,43,347,987,640,51.85220471173494,9619
29dce108-16e8-4e1f-8e72-c53ef18d2041,Commercial,0.7111202312910289,47,28,465,1158,693,52.01022266128581,8604
1f051346-12e8-407d-8eb9-36f997b2416e,Commercial,0.4873819197258574,46,17,143,538,395,18.356980571832096,1508
84181640-4946-4e46-921f-59b78981ca56,Healthcare,0.34892883284490117,25,39,599,1254,655,90.0638050610824,4738
142e7ee0-e900-43d2-809c-1e1492933fff,Commercial,0.7863083080266114,6,21,138,776,638,75.60747197891418,3289
5dd151db-b8c7-4173-8c71-3115aa5e2e67,Healthcare,0.9308376657747489,48,28,321,1306,985,60.68591484313223,8377
5a8a170b-26d5-43ea-a8dd-95a21a5b77fc,Commercial,0.6019614043533651,49,2,64,570,506,63.300102428257034,7661
c0df7c43-8eb9-408c-9406-1c38e4bcfa01,Healthcare,0.6659386447612958,49,27,658,1378,720,71.52153169630786,2291
6f8dee0e-7d7a-4f87-bf81-f983e0debf50,Commercial,0.6137531590063214,4,37,22,51,29,30.19797583904274,6662
085bd397-40e9-4e0d-b189-44c4228531d4,Commercial,0.570923403273893,9,23,392,624,232,10.954405254935894,7572
15917204-a98a-4278-8cd7-4d51838463ec,Educational,0.21752545472234008,20,13,275,764,489,55.44607211422103,7951
29af481c-3a74-4101-a12c-41640cd7b9da,Educational,0.9559054899344509,30,29,674,1367,693,43.03749731863573,2794
037531c6-1108-4b37-8ab0-b2204d08cd80,Residental,0.7391672265368352,36,22,682,1428,746,32.05515304127363,8770
6149c85c-1573-4bb3-910c-b141ef811de8,Commercial,0.2498550370611805,26,5,242,1163,921,74.24513193414393,1613
11220fa1-37dd-47f3-94a2-d5ec3956f7a6,Healthcare,0.18422511330272806,45,4,422,1100,678,98.1496343424934,6422
e31e7720-8e31-452d-ab9b-c9105a1f4eb7,Educational,0.058630498988092694,32,25,563,1269,706,85.89809782326884,1083
a2ff745a-22eb-402c-a364-fc27e17e994a,Healthcare,0.30696431536436686,11,42,4,447,443,26.435198981517157,2240
4712fd0b-fb46-47db-a3f8-c52f5cc76d64,Residental,0.5070486555979169,49,29,515,1200,685,58.841801987109044,1535
3edcc455-7f40-4f43-b02c-c2c84044dabf,Healthcare,0.1359013318604666,14,9,252,1406,1154,79.4186900535468,5465
8d75c3ed-fa86-40aa-9f39-3c1c79fcc8f9,Residental,0.43213243161781323,13,50,617,1109,492,99.6782792755467,7350
51524841-4c68-4eaf-8d57-b512b7da6abb,Commercial,0.4163878604145851,46,43,653,1255,602,31.848783225085914,2333
8ad6aa6c-cdad-4cf4-9092-c13b0d7b4445,Residental,0.2568409519181537,15,17,25,875,850,93.16572235980193,5302
f109caaf-f06d-4fe3-ad73-02f63c46d7f2,Educational,0.7347703419738797,23,44,455,638,183,55.27974151750991,5484
d40f9bd6-9dbb-491c-a048-16e483d0a234,Residental,0.9387115663082147,17,16,350,601,251,25.884347865824548,9652
427fc058-998b-4331-8dc8-a89c2d75f560,Educational,0.24557818645758323,3,50,583,744,161,31.237087250810276,9208
3ce349b4-fcd6-4b26-a11d-cd6896169c46,Residental,0.14699834963884129,3,7,404,1303,899,80.15489307012741,8770
ba51d80b-4c67-4e6e-833c-a5c46ef80dca,Healthcare,0.562440438160662,30,32,660,918,258,12.094150380330177,9601
a5d59f0f-1133-4bf0-8acf-1e3708ae0fe6,Residental,0.7700651794763272,16,23,612,1170,558,83.3305194449984,1970
1bc40a78-8a92-430a-af08-f3e211f05fa2,Educational,0.7653742437689932,40,40,138,158,20,99.75705777876375,1102
d7d586cd-1c10-4165-8eef-d17a82451eb1,Healthcare,0.20478720464105726,22,22,14,1208,1194,43.09359853296888,1808
3e57032c-0cfa-4c46-b65f-fb8c670feefd,Commercial,0.5957862944191208,8,7,294,1367,1073,56.195050380264725,9356
9681b2bc-efaf-4ad6-9e47-1631d68a2871,Educational,0.7773405201269349,19,22,375,1218,843,44.23434401602682,2455
c4eac3f4-e313-4d52-9123-0ee871fc7bd2,Residental,0.6861663659164071,49,31,396,481,85,31.31775842135811,5641
dd4801cb-be8a-425b-b19d-c6d2c900558d,Residental,0.7925999433060864,47,42,550,901,351,99.06153847498187,8129
0f572187-2732-4bbf-a505-a5326b5caf9c,Educational,0.3672645229715993,49,4,280,657,377,89.82703442048248,5966
63aa7825-c20f-4d4a-aa1f-7a038e1550f3,Educational,0.357913801888292,7,35,20,730,710,15.973624436462938,5854
2fb8c087-b8a3-484c-9d21-dc6ecf5f459f,Educational,0.18242447737911416,31,6,460,709,249,69.33677019994161,2038
8d16ca6d-cacc-4fc1-883c-b802af42300f,Healthcare,0.2762606267712705,48,6,430,1097,667,59.70807451639589,4570
b29ad65e-a952-49ca-971f-b1d27ca772c0,Commercial,0.1789336747714605,28,11,121,603,482,95.72303178455013,5391
b6cb646a-3d3a-4a61-bb32-d132c88a7858,Healthcare,0.7464763686419874,46,21,630,1278,648,26.290152185088054,6128
a5d60c17-6dea-4af5-bb9d-71ee1fc5bf5e,Commercial,0.38855679864140547,38,25,418,1259,841,22.941718308851286,6112
a3b6a082-220e-4535-aa02-13ae450501bf,Residental,0.05383447239498795,49,31,311,1427,1116,74.63297629860772,8694
e7863c03-6b55-4057-8364-6e6f601744ad,Commercial,0.7999733780151395,34,28,469,1217,748,88.20357150948492,6056
880d3371-6b89-4ff8-905e-5336ba800040,Residental,0.19888412247201204,26,14,304,808,504,44.17892331593086,2174
d8656c49-6c66-4139-a724-dd1d9857aa10,Commercial,0.8158279003848271,14,43,340,737,397,93.15609390954435,6981
46576927-1a33-474c-a72e-886507eacd8c,Commercial,0.6653959479046844,4,12,588,630,42,78.93666953594241,3757
08da9def-c42a-4b1b-a959-c711d2c95cd4,Healthcare,0.5083570041948184,47,27,528,1342,814,14.043462733416323,7870
92ec3e52-a9e2-44bf-a148-7f97f591301c,Healthcare,0.5013483985632231,42,4,532,1170,638,29.27967863853736,7004
df3247a9-9c5e-4df2-9b79-ba4d52b281fd,Healthcare,0.816963678468561,4,50,125,459,334,10.631891930164763,3549
806a9bdc-a171-42cd-ae15-02e40936e2c4,Educational,0.3050259702721858,37,3,91,454,363,40.35264771085025,5346
4838014e-02dc-4c59-b65c-162c084339b3,Healthcare,0.43871993002009235,29,13,20,1410,1390,71.8889434391072,2043
65e94904-c087-47ac-892e-7f31ae6826de,Commercial,0.005698058037250653,36,27,677,1359,682,24.456054211028746,3934
ee8f8bb9-d0c2-43e8-8a60-f4def1034f08,Healthcare,0.2567906482781934,41,47,420,1069,649,68.65697204183203,6258
c4989cd9-207f-41da-9abd-1a3c3aaa6a8b,Educational,0.7219333402887322,26,11,61,198,137,29.63285760590192,3114
17b07eef-c60a-4750-bf8e-eb6d53bad6a0,Residental,0.8708649274121539,45,20,200,841,641,47.958695945107955,2538
9c82267a-31ba-4dad-afb6-a6c21a328472,Residental,0.8778428881556656,26,45,168,775,607,57.40344333673135,5682
2092a6c9-4990-413e-961c-4aaa6a3702f2,Educational,0.7796915943793497,20,40,156,497,341,57.07879359522616,4466
9e3597a3-08ea-45ed-9170-0e323026f959,Educational,0.07427644036184144,28,23,319,1208,889,94.88216080102049,9408
9a984b4b-1373-4045-86f6-920fe94fce01,Educational,0.9869844699913466,43,33,247,612,365,14.505667859770144,3881
1e4019de-8596-4756-9767-aaed8dce6716,Residental,0.8788148661164428,13,16,50,838,788,41.17741282110651,6025
ef7cca36-be4b-4327-876a-ebe411752e39,Educational,0.5067889621289727,22,45,697,970,273,56.9669943566891,1022
4858b270-e6ce-4748-b344-50543b72c3bf,Residental,0.20711958843122769,31,36,76,422,346,75.20731280661221,8808
756c2e24-072c-42bb-9e3f-bec94219d776,Commercial,0.6205798475994113,38,43,119,380,261,56.22249008580113,4039
b0785c95-323d-4e4a-bdb5-f2c73cfff140,Residental,0.7147678105160084,32,37,480,951,471,91.6441918722151,5635
5e8c5c62-4ca1-4550-80c7-e2aac4a78fe4,Residental,0.8644524639510707,37,40,42,509,467,21.955344859687827,4006
cf83c919-09f6-4f8a-a52a-a7dff9dedbc5,Educational,0.7363464111343381,46,12,480,683,203,24.44494375108662,9074
4e5a6e4b-16a0-45fe-b93f-73a81df290a9,Educational,0.35130265943911176,38,39,339,811,472,48.18725121546707,1876
be81e84a-0322-419a-a516-98d2393bdab3,Commercial,0.018724323425843847,24,43,21,289,268,10.446770061764049,2393
08b2e17c-9f0e-4dd0-a151-8ade18bd1387,Healthcare,0.1043278213226031,25,33,606,1374,768,98.41720796592885,2242
648238c2-4e91-4211-bad9-c17c0df504a1,Healthcare,0.4244919427675907,10,10,78,278,200,15.079685932203738,2581
88bac9e7-eaaa-4232-b71b-1656b3b98fa1,Residental,0.028906840344893103,15,23,518,1235,717,99.14316207887245,7343
ce48a902-b9ef-4438-8364-21a9224fd1cd,Commercial,0.11818528213429003,39,33,587,1232,645,49.00354061230648,3401
ac96fcd3-4a58-4794-81ce-908ee195eccf,Healthcare,0.7128099848984355,9,14,93,288,195,75.53812231714024,7417
2b828791-d524-433e-8661-b241558fae79,Commercial,0.917475016361779,44,50,100,1384,1284,36.03979180395153,1311
16277498-0824-4399-af34-c9ccc48c721d,Commercial,0.5275742877313274,27,23,69,73,4,83.394659689717,2264
ac1b24c0-2df8-48f7-a7e0-da2c81ecc470,Healthcare,0.6040382915330127,47,41,463,1429,966,96.54785741301205,5080
62d71a1e-9f34-4795-897a-53e35614e787,Commercial,0.2734786344193809,3,39,560,655,95,58.12282773409303,8649
8ee7cf35-88ec-4127-9d9f-f763fb9f1b58,Educational,0.017777149796765257,42,16,563,1303,740,93.32728833154407,8527
affb3749-98d3-44d1-be7b-2e964a53e80e,Residental,0.19095126403332996,5,8,213,1289,1076,24.891745365649793,9136
4455129c-1f0e-4361-8b36-f4c8b3795ff9,Educational,0.09606297868977764,34,24,186,1030,844,17.066290762970578,4036
9a8281a0-09ed-48ae-b86e-d7b4e85a38c2,Commercial,0.804455041477911,22,35,164,995,831,75.66793211026484,7137
49e0e310-9c58-45b0-ab5a-91f9ea04e62a,Commercial,0.09180353284513476,7,23,716,1365,649,24.878839251850422,9696
7d61d18d-3609-43d4-9321-118341073c1e,Commercial,0.02762844057456393,31,21,158,715,557,95.65382657348256,7771
f9ec7ecd-ed22-4369-b199-a236b21c44dc,Educational,0.07526452083298507,42,21,580,1184,604,67.48384907515928,7255
df68b86b-7179-4a0b-8514-e3bc8f9a2ebd,Commercial,0.7966350783519371,42,2,366,952,586,53.82583348130419,7279
a576ad98-7acf-490a-917a-0aaaa01aea83,Educational,0.572044077772272,17,23,619,1276,657,10.540654344438243,9197
1d4a45f6-0e95-43cd-9c5e-d4cd6aad58ef,Healthcare,0.6795353949295992,44,29,270,648,378,77.31997336848222,2387
84e169a9-a306-4af4-be42-3e68245ca1ae,Residental,0.097979688372139,14,44,368,1158,790,13.451481879747101,3071
53b3f822-4745-4001-a6a0-2359fd922551,Educational,0.9651507923062266,17,1,321,372,51,23.615453447548177,5141
fb2f2843-7575-4c6f-a793-887db3717f20,Educational,0.07433045675191063,13,26,497,852,355,66.98694197049294,9179
e589ec49-6541-4f2d-9562-8c7011fec56d,Residental,0.7350447975291823,21,26,624,1092,468,91.31343936255061,8153
76017be1-68a5-478b-82fc-4ee120080135,Commercial,0.38742432354875256,10,23,561,936,375,56.421748333033385,3031
6ffe4ad2-3d72-4a9a-bf01-014699430c4b,Commercial,0.839247529068936,49,10,238,1246,1008,68.53744375745333,2995
7449ddf4-a462-453e-b08f-4c5a00a0cedd,Educational,0.6750670949955576,50,15,183,1190,1007,77.1697834738266,5441
2eeb239a-8363-406a-b4e0-87f2be34fba6,Educational,0.03491420336012163,38,43,151,330,179,48.49270171339116,5536
7ec90340-565e-4fd9-9cff-32e821239802,Residental,0.7894056781767176,9,15,37,844,807,42.24102146423892,4768
ac531065-4570-4b98-9fba-9ce0ff59fac0,Commercial,0.07008603965074067,45,50,712,936,224,72.10539357346948,1940
606bf21e-520e-4e85-87a1-7266f9ca0eaf,Commercial,0.4636738213390956,42,24,440,1231,791,76.17907164725972,6360
e2e6750e-0c62-4400-a935-faaf6863a55a,Educational,0.6370753365382871,41,45,386,1346,960,43.74287318436312,9591
c736563b-ee6d-4baa-9989-ce6339be055a,Residental,0.037565658696988025,41,31,219,964,745,41.7693049772851,4808
ec60f0a8-b619-4d0e-b412-94d572585bde,Commercial,0.4646356415707774,50,7,579,1010,431,67.2417786855628,3299
0b8f3e91-990a-4c86-93ab-1e65c3525664,Healthcare,0.36330327571211474,31,1,556,1017,461,84.4653401574029,3170
8660ca0d-5214-4524-af85-499ed5b4d48c,Educational,0.22993496467889196,34,46,643,1183,540,29.49049392337962,7364
3f1dd4fc-bac0-4d11-bd33-8fa2f7a6d68a,Residental,0.551623227412984,41,17,389,1010,621,63.12555835236331,9081
2542acbb-69f8-4754-b8f2-7330e37e58ef,Educational,0.39871915845442585,42,38,269,1211,942,48.75199657949646,5639
344e74de-6c70-4a7b-8d23-b292e206bfb5,Commercial,0.26838570681761276,17,5,252,997,745,65.48048073622607,4692
f6c61b8b-5ced-4364-a1a3-0ec2badbcde0,Healthcare,0.5821236835952506,32,35,146,605,459,31.130938864599774,9921
f5ffd3eb-fccc-475b-8b84-0eb8e7380816,Residental,0.5769368930438113,36,50,566,599,33,65.18389257107414,7031
ee955a00-a997-46fe-9265-69f91343969b,Commercial,0.39249641087124687,19,3,566,619,53,45.07072001113568,5610
5dda3e1f-8f8a-42a8-a52f-4162be8c8f3b,Healthcare,0.0484986505888888,46,1,161,642,481,31.254403038561005,6525
477c9bef-d3f9-41b5-a786-19b53d0b96df,Commercial,0.40243431557240983,49,14,417,1317,900,34.57447397552747,1206
5edfb801-4728-4400-87b7-2eaa98860265,Commercial,0.8969745686144736,50,3,537,1257,720,92.39380247122654,5714
0943e35c-5005-41e3-b25b-2cb42165cc84,Commercial,0.8325464126552912,11,5,665,1243,578,49.49575196415623,3665
e4d29f7c-40eb-4720-a892-13a497dd6840,Residental,0.20512690973770575,17,30,51,988,937,82.4217876681786,9493
2c7386e6-d02a-4660-b9ab-efdc36e36afd,Residental,0.09619664961335217,19,49,453,782,329,17.98088989152231,4168
3024f5eb-d717-4acc-b83b-5069deb38de1,Residental,0.6708694093892219,21,47,619,1327,708,69.40903426073535,8277
bd86d6d8-146c-48a5-99ae-bdb2334f97b3,Healthcare,0.6705466968419238,15,29,415,946,531,82.0233981835911,8948
6a7982d9-bdb4-4be8-a7bb-320b270801da,Residental,0.5658758850815526,36,15,704,1260,556,83.12697077135273,8649
8873de03-1be4-40ef-b3d8-6e90e1979b30,Educational,0.9963384147394382,36,26,456,892,436,24.700761592087623,7426
75e872ae-1bb9-47a6-87a6-9861a40008a5,Educational,0.37404344948940016,8,23,230,1327,1097,61.68348544655388,9940
1a902840-fddb-4cb9-a7c5-cf663e7e56e6,Commercial,0.5258219288391515,2,29,421,1132,711,32.39557722610549,7327
05b5cab5-0f6d-41cb-9acb-bd36c0f22dc6,Educational,0.473099203442805,19,46,544,972,428,38.4669849924505,6629
196872b1-6ed2-4c04-975c-2c42846f890a,Commercial,0.8975916795753333,28,9,683,788,105,19.608039803704138,3479
eeeb07a1-8945-4e55-b95c-e12a6d025888,Residental,0.447478202655498,50,26,137,649,512,66.77534258964462,3230
2a8a3ff7-3d63-4147-a458-2c4a06c322dd,Commercial,0.5956347345473852,31,4,636,1144,508,28.562851466400417,8628
c4f13fae-b8db-4214-8033-003ce1ac9625,Residental,0.4314416670223047,22,23,634,1301,667,60.83565725108528,9006
bcccf2cb-03e6-4406-b3d1-0f3bed7dffca,Commercial,0.6816804241017417,22,20,127,1421,1294,95.83840063774747,9031
c0fe3ee2-9c1e-445b-95bc-8857bdcd1155,Commercial,0.8188538327600188,37,23,701,1129,428,86.27546108101075,9583
4e454be4-248d-4f0c-b6c5-16c59344d3a5,Commercial,0.4821649647893722,8,48,102,1189,1087,24.351739085770106,8673
bdac2baf-e1d6-43f9-a91b-096fa40bf421,Residental,0.17260859912276905,37,39,421,1234,813,94.06699714017269,5087
5f8a538b-81b1-4448-9ea1-e4ed90fb7a9b,Residental,0.7922002391728654,14,35,457,1059,602,77.96226313627189,9044
8f96cdd4-d114-48d2-8c57-17ab3ea05f20,Residental,0.7402790694821618,9,25,414,916,502,96.27984261025128,2181
77de4b5a-cf7e-4eea-bc1e-0a38049935fa,Residental,0.7299965920298324,44,25,593,1399,806,25.13255105135587,2690
a54bf1a9-7504-4e22-9030-461e196227ff,Residental,0.8998755064440219,20,33,34,1274,1240,29.39627299391742,9807
e33dd5f0-ff21-472a-98da-3f8982280ffb,Commercial,0.12076556447043951,2,24,172,1327,1155,81.06185581306856,3190
f97bbfa7-e5b9-4191-b85e-ec402eb435ea,Residental,0.3585829431226314,24,42,686,1275,589,79.06260143936156,8323
50d50021-f5b5-4e3c-9a1c-ab8f95826362,Commercial,0.4818299642097854,15,26,719,1101,382,55.700998176999256,9659
6e1dca21-8788-4920-a930-64ad466df63e,Residental,0.9717077620887983,11,31,381,1292,911,51.04972798902523,2388
b2f01cc0-bf66-4f0b-9f20-35e8ff0a6420,Commercial,0.0562535743058995,4,2,102,898,796,73.58988223835249,4981
7639ceaa-bdc7-4fce-85ed-de454ccef965,Educational,0.3687915326288277,31,1,601,819,218,79.11769633169797,6021
4be5caad-d57c-4d9e-a935-9fc941c21aa9,Commercial,0.9459846171731189,23,9,637,1417,780,58.55878545177186,6319
97fa3c01-2505-4b68-9fec-d0adde023b93,Healthcare,0.9835928560660026,34,27,642,1337,695,18.587454426142948,5850
5906bbd5-f9fd-40f9-8c60-410dae3c3236,Residental,0.6573267812341183,47,20,592,636,44,52.23133426642714,5446
82096333-5a40-40d2-ab06-2d108bb36ed7,Healthcare,0.7741623879844949,1,8,361,1184,823,80.33630637479881,4406
6d834f15-eb6c-49e7-bc2f-96fec52da607,Healthcare,0.7966664070784767,15,27,605,1108,503,20.078694394278713,2343
adfc5390-3f38-4a5c-a0a8-a845af70c377,Educational,0.5917467568161565,7,35,11,347,336,55.74904615789314,3872
83424b73-3ca7-4dbf-883a-efbacefdb68d,Educational,0.27928909898169274,44,32,663,1185,522,22.30135533357347,5223
c84995a9-ac4e-452f-9872-7e2fc2b1e4ef,Healthcare,0.2055805558631838,41,39,232,415,183,83.66542227845751,5810
c6ab4b55-0c19-477b-9845-9b5b2d21338c,Commercial,0.04375983415446283,16,8,542,778,236,73.22970330001633,5652
39e2db97-be18-4760-bf13-168d48da7eb7,Healthcare,0.9144484091650497,33,19,538,1346,808,48.089661338561775,9885
cfc4cc61-be41-4d3e-8ca3-1836c00b1121,Healthcare,0.8376588700576086,38,12,121,675,554,90.92397750841168,3070
c64aef23-2898-4080-b379-8f603447002c,Residental,0.8940628520528517,49,38,122,238,116,79.79861302970708,8883
15f0e985-68c5-406c-b9aa-ed9c28d5b067,Residental,0.9101513257645205,5,8,145,1131,986,10.691840620767056,8521
730ce5ca-b716-4e71-a3c3-91bd681332b3,Educational,0.17547986954869965,9,22,355,862,507,40.179918065388776,7613
d337e498-e672-4f4e-a84f-70f86778adba,Educational,0.33445312166770735,20,43,360,1313,953,28.074606248807576,9242
5997f082-229c-43b1-99f0-97ca3da9655b,Healthcare,0.943595989409892,5,36,139,608,469,61.61531989641171,3941
9003da48-93c2-466d-8826-fecf70f7beef,Residental,0.3034654344797165,38,39,284,1333,1049,20.376787074444888,3563
c8d847f2-cfb6-4aaa-b44f-ef203138806b,Educational,0.38955127902741027,47,26,675,1124,449,20.263313309234736,2507
a0b319fb-87f0-48b8-8bcc-a25aef6fc9de,Residental,0.17571781695368083,41,19,490,1336,846,41.39811459972141,3000
19e448f2-02be-4b48-962d-826b0f5fb471,Residental,0.3435134630245873,9,48,22,528,506,95.99960764567007,1971
7ad909bb-5656-4d22-8d7a-71a5bfee2b7a,Residental,0.24479948649941807,25,28,47,421,374,77.71902123886989,5772
9194019b-03f3-40d2-9ba1-7e759d89b07c,Healthcare,0.09739425504684418,20,22,218,659,441,58.07523578424142,7215
948d74df-a2df-404e-9ce4-350d35081b6b,Residental,0.21248436561720296,38,16,662,1338,676,21.432100583033105,6535
9197649f-2cd9-4b43-b5f1-b1bc8a700e97,Commercial,0.19228427755646926,1,20,153,200,47,70.2501314437625,3661
3832d0b6-3347-4c75-9830-ca8ea67244b2,Healthcare,0.5123628604062141,12,2,37,1101,1064,44.78435363016606,1813
bb9d9781-2f90-489a-9b7f-89f0dbb56011,Commercial,0.2488180811191415,50,48,71,1316,1245,57.93454548169691,8101
769f603b-c5e9-46b8-be1f-fc68453ecf66,Residental,0.8588863439190795,20,19,249,993,744,85.02650085542327,4407
dfe3c5c0-c006-437c-bc78-d01bbf94a0ce,Educational,0.7339594554194468,34,38,412,590,178,82.64055857011452,3872
b04f3387-771b-40aa-92b3-981b6fda6252,Residental,0.4511018655254887,4,4,695,1036,341,86.19683083689232,8663
5e16d37c-d970-466c-8a06-2774b75f23aa,Healthcare,0.4520560850459121,11,30,537,899,362,57.61955204815508,1286
442ea050-6e6d-44ee-8de7-d1c216290d51,Healthcare,0.714593072431323,44,24,527,673,146,20.814307155819712,5411
de335366-8bfa-4b4b-8fde-0fc8f291ffae,Educational,0.4463385436488597,25,21,613,1034,421,40.01382309542339,3602
9889f45f-8897-4d65-b4b3-c70aa8269f5e,Healthcare,0.21064382793913283,8,39,546,1169,623,30.315747272018047,6972
59cdcbc9-4ff2-4c99-85a6-0abe415a2b5c,Commercial,0.7279673915945486,14,39,225,1232,1007,20.59452183051147,9039
a6dde555-0930-4690-8648-52108d16c334,Commercial,0.6832536313888634,36,3,514,1262,748,15.42701300797257,2969
8d678f3a-d46c-4307-abdc-e302add1c3dc,Residental,0.987544979325273,12,6,207,567,360,92.39683134920314,3591
19a1afdc-692c-4674-9c62-4e2596f90996,Commercial,0.9764486405417291,32,5,113,167,54,20.764935352201675,2779
b9a56539-8811-4f1f-85d1-b074fdd0646e,Educational,0.7090414815000801,8,4,639,822,183,62.15696317945174,3138
0745218f-61af-4fe0-9dd4-014be88253ea,Healthcare,0.2505456879173531,45,34,674,1216,542,93.29519889617809,6035
49469291-4a62-45dd-b227-e10927b60da9,Residental,0.7875027908535024,44,5,173,1398,1225,45.8430329349402,7655
4351a710-7ae2-42f2-9cd2-05752b5568b0,Commercial,0.6672029633335878,45,25,464,914,450,68.24859896017398,4576
59d6bdd6-4893-4fbc-8ee5-9b023bc12e41,Residental,0.8766143067031198,29,49,188,451,263,90.58329406950836,9318
c7d92e3b-ca55-43ff-b8bc-933f5a49019e,Healthcare,0.1959045262793403,29,46,538,1325,787,92.53645349319683,7675
70a04a0e-f59f-4bb8-8926-e28b3c8a4fdd,Healthcare,0.665276202537904,30,15,438,1407,969,12.054273238843868,5255
2bd6bc27-5379-424d-97e3-fdc8a01b4985,Educational,0.19842105252771058,34,23,575,1064,489,16.623469350217746,6130
8dd9f113-6057-45b5-a638-d54064693968,Commercial,0.27322858291498275,15,9,688,1124,436,98.99644781247649,8014
bb31f5d3-4e5b-4018-81a3-67937410820d,Residental,0.29800679823471454,37,4,715,886,171,80.69857229929937,1541
7c857197-082a-459c-a620-e0835eb970d3,Residental,0.07778239180882118,9,1,48,988,940,57.53496289417245,6501
b330386a-8241-45e7-9423-212e0d13b59c,Residental,0.20729197880055694,28,29,409,1162,753,34.981740796602736,9731
523bdf52-a7f3-44e6-83d5-b68102f06569,Educational,0.051159684041882314,9,43,97,1078,981,46.12875447063541,6691
96021f66-8499-47d4-9302-d1f2676843d0,Educational,0.44944537764789705,37,12,681,1039,358,49.151571273829695,5661
acb8125b-2702-437f-8e31-2ea37f6c58d6,Educational,0.20449272087565418,1,49,144,508,364,18.09260175340486,4916
06822052-e64d-4174-be9b-ab73f3778ab5,Commercial,0.9009051771586584,15,46,661,1242,581,94.61405847364107,6003
b0a20689-6a11-4141-9be1-47d7917f3978,Commercial,0.6474637919178399,3,14,229,254,25,49.3950272298445,2941
7e99742d-8be6-4119-bcf9-96e14f88c447,Residental,0.06477169860981591,12,3,181,866,685,99.85166691446685,5848
36eed52d-71a0-4723-bcc2-167c3d82dd42,Residental,0.41887708792152156,24,14,453,603,150,83.27135241022154,3398
113d6542-3ba6-46d3-b59a-bb53b51e5eb4,Commercial,0.16423840087878794,28,27,227,710,483,67.28185310913085,3716
2dfd6efe-4192-4205-86c7-72d59543f98c,Residental,0.2660206052189732,38,37,268,684,416,34.60306624921665,4125
26384d48-ea69-439e-a2c0-03ec1543c583,Educational,0.7495527459935212,25,45,502,756,254,39.79866480621443,8912
b50cf4b6-9b5a-4991-969b-a2b203031f12,Residental,0.5488064644743655,25,46,194,688,494,72.1902203229019,8006
f6f96d0c-ba40-4df1-93a5-4783945d9262,Educational,0.38115859420752585,41,6,83,1116,1033,87.48200016753168,6651
8df94ebf-08ff-480b-a26b-6be049035f9e,Commercial,0.9475908816954899,39,31,51,833,782,32.05289782693404,2140
fc099768-63e3-4c29-a46b-7eeaf08bd007,Commercial,0.5652239549299849,14,14,649,1086,437,63.81803565930893,9324
5ad049d3-c95a-4099-9b84-c5896d56d793,Residental,0.8016683850075075,24,47,601,1205,604,45.38363967052725,2446
d824d593-a62f-4df4-aa9c-4a64a79128b1,Residental,0.5928774855892354,16,35,472,806,334,55.37038474452697,9960
e1ba2bb0-bf4c-43bf-98bb-45ca03793cd1,Healthcare,0.6691388988202706,29,38,336,359,23,67.23497926016714,7119
46049a66-3660-4d9e-9172-8c04f194d51b,Educational,0.20032076489203632,41,20,603,656,53,98.83672694399345,1726
9d2e9330-5ba3-4429-ba6d-a766ec0ed607,Healthcare,0.5014970027129371,24,21,250,861,611,22.21823365565449,8775
cce20ae7-8e39-4633-9f07-681ab15dff54,Residental,0.32755011490087393,10,3,329,744,415,85.26450897394133,9554
f10295fa-d2f1-4fb9-99c3-7642d66e79f0,Residental,0.7122132731397381,7,29,521,636,115,50.828295754185746,7555
2686afe7-77dd-4d36-9a0f-627535e672c3,Healthcare,0.1871577780740703,24,50,711,1288,577,64.69358898419787,6917
31c0f28f-4181-4d8f-8e82-4094bf23e8e4,Residental,0.20332156197324025,7,50,392,841,449,50.097066736064946,1014
09356a0a-a022-4007-bb14-c1f1c6bbd681,Commercial,0.3407648998150544,23,49,81,875,794,27.88596207310762,4527
019d8854-4f18-4ab4-9e68-ee1444cf288b,Commercial,0.5092451640546912,44,31,326,401,75,59.00974115243281,9710
413fbe99-2f36-48d9-a56b-5ca5a559a6df,Commercial,0.8989362936721644,1,26,425,1189,764,44.04553884994039,7420
140fe707-2f74-4466-8a7b-10dea1019582,Residental,0.6318142538462357,24,2,409,943,534,56.22243128096304,9553
9e094a84-ad38-475e-ba71-4f7c42e9f99b,Healthcare,0.05882087218718879,4,15,397,681,284,22.604137169750885,9355
42512077-709c-4b59-bec9-54c7345503f0,Educational,0.06940488023330671,12,6,454,951,497,21.495914754452144,1295
0a955519-6899-4eb3-bc86-76e46e077df1,Educational,0.43386413390879064,34,1,5,599,594,76.42999237658333,4216
62ab1659-1a41-42b4-85c6-4da3f5f1a726,Healthcare,0.3983977994906407,4,28,248,954,706,25.45145711864759,5362
82d978d1-2042-45a8-a302-0d0630825ce1,Commercial,0.8335397991150162,43,30,169,952,783,71.75594536231566,9413
05494df3-be16-4ede-9a46-323d7fcebb51,Residental,0.4621825505983027,41,48,189,293,104,85.49247085734129,2338
aa4ace5d-c393-4261-aea4-d0b7c78a91e2,Healthcare,0.6684650316268885,4,49,595,1297,702,69.40133795504227,6933
e9c2d93c-5217-477b-b1fe-c19f2247d9c3,Commercial,0.012272038234745097,16,28,490,1184,694,22.70975725751622,7270
04731479-aa89-4bae-8605-5d7e9d1b1e9e,Residental,0.9746807817061718,27,45,578,902,324,44.5291642340468,3403
14a46b75-2af4-4b90-b978-f3314bdee9b6,Educational,0.12784316528130935,33,47,542,1406,864,40.37747529354746,3712
48060d1f-ff4f-4b32-be9a-b5b0cc79f7d2,Residental,0.16244048775699527,15,2,484,684,200,88.5943002802152,2887
01383f0c-81d8-4eea-a111-c88a20737639,Residental,0.4267259856068927,33,22,497,657,160,46.73719942121763,1808
3d979175-a4f3-4959-845c-495b1a4083ea,Educational,0.03223291407989193,42,28,516,806,290,17.745789553091875,9646
2e106e3f-5811-4d38-8d5e-f3bc87e36164,Commercial,0.4173272802470862,11,44,154,291,137,45.737746932550465,5143
666f866b-3318-41c2-90df-4a18eea0b876,Healthcare,0.03497756218424142,25,42,712,818,106,30.8646141439473,5982
d53d0bd2-7846-41b1-8e50-8d32d635050a,Educational,0.9284563996941033,48,45,123,544,421,20.541797139108006,6552
a7e9e087-bf05-4c56-ad0c-b2b227a1df1f,Commercial,0.8064202706257484,36,46,691,1152,461,22.014437344162225,4331
fb68e646-8686-402d-9448-c01d64b6d1c9,Educational,0.7476370932965403,41,34,712,911,199,73.34865496205006,6535
f6f35d27-e936-42ac-84ba-92c1fc8f8ac8,Healthcare,0.5083870603688949,43,7,504,570,66,77.19530652702123,3834
be3b2140-51df-4efa-86e0-387f4d6225c7,Educational,0.616755758640845,30,9,124,398,274,26.780699494206186,7521
bac75cfd-1b61-4af5-9460-674dbec85481,Residental,0.44939380075985236,17,4,597,1090,493,58.06069794736275,3542
c759b1e1-3e94-4d58-994f-5de5130c3a6c,Residental,0.008364944846940392,38,36,639,1153,514,76.86053836717777,1742
55c31cc6-1e15-4c1f-be33-478225ba7abe,Residental,0.013662358853349654,50,23,341,1303,962,35.451124609810236,2758
31c6ece9-5860-482f-a2d9-ef14bec18b9d,Healthcare,0.34449229524648606,24,22,108,1178,1070,53.99709170374972,8190
6505f46c-e637-46fb-af39-ed2ee755f049,Residental,0.047176250805021636,19,5,528,557,29,70.45796388917776,8416
3cefe40f-8d8a-4726-a9e9-80a95df86dd7,Healthcare,0.8190142414192229,37,29,479,970,491,68.54587923214626,3175
3085449f-398f-4427-a3ab-b533b4cdfdf0,Residental,0.15401387008269574,50,16,673,990,317,52.06511455013907,8084
484e1166-20a1-4c00-bceb-12bec86b2a13,Commercial,0.28646336222141977,45,26,203,394,191,65.45342778421221,4764
c4d79047-68d6-4254-97d7-07c0941a912e,Commercial,0.9383456149116063,43,16,305,820,515,49.1371355143801,3700
b0a48b6f-ca47-48a9-8c5c-87449e92885f,Educational,0.8047877666806394,43,24,463,817,354,55.57985763650321,7642
50451e4b-0f71-4533-bb83-4594e4f4fb9a,Commercial,0.3131242252390488,31,21,635,969,334,31.778725677106973,8082
0ce5d13f-50c0-4a55-8819-2d75b7fa2ae5,Residental,0.9708430730292419,5,12,42,655,613,47.45821971377827,5150
f9e10765-2603-47ea-90b5-12506736cd0f,Healthcare,0.569975927494327,15,14,238,1053,815,40.813660631226355,8341
87d0ca42-70a6-41d8-a3f7-b8c70a976edd,Educational,0.8190141489565697,35,35,440,1273,833,33.04698146161563,4059
e07d5720-399d-40f6-a6f4-84807d59836f,Commercial,0.1689674516650348,1,17,427,561,134,41.42376981104513,1903
4a6a6e9f-e10a-44ab-9c4c-2821e40f71f7,Residental,0.8781931732629259,11,29,404,548,144,90.62709480487743,8173
b7025bd2-8d4d-409c-ab23-1707f44ac4f8,Educational,0.25542132611855883,36,37,456,512,56,17.55110405405785,9102
f3e4b463-236a-4464-b20e-fed7e41a9b92,Commercial,0.20062640456696212,37,31,67,1102,1035,62.78213853502632,8580
d7dff790-3154-43ae-9016-524556945e45,Commercial,0.4297872973613456,18,44,443,1279,836,69.49146322116012,1288
4023a127-f59d-47d4-91f6-9651c6da32d8,Residental,0.344158990215349,36,15,328,1154,826,54.59007628592919,3967
af61a505-c2ca-492a-980a-507c33ea2029,Educational,0.5706583674141996,11,10,51,362,311,85.08816476982011,6755
a24dc6f2-cd91-4b43-8591-b7d3be7c0915,Healthcare,0.08484513961970785,45,43,18,858,840,15.026894707015089,1594
eeef078a-50bd-44a3-b01f-e52a754d6119,Educational,0.14243264837241043,14,42,311,1217,906,70.87369032040857,6398
84a3cc78-b489-4378-a230-f418ae3d2567,Educational,0.16190990753181433,28,6,37,673,636,32.91599329501438,3975
ee5c9a67-6000-4926-8c37-c6d0698e7afc,Healthcare,0.6602929342756246,3,32,175,1106,931,14.48881540800857,8504
027135a7-939a-4a87-a4b0-b78820975008,Commercial,0.10700794506400935,9,32,38,48,10,85.76191248392165,7411
ed31e6e1-fe9a-4d91-9a2a-eec5385ea5db,Commercial,0.07018769313992557,40,27,619,1200,581,56.39103930685883,5280
311ee28b-54fe-4967-a8de-a5b26211cbe9,Educational,0.7774820799335344,11,40,18,141,123,71.13644265056848,4246
25fbda3b-a764-4321-a2f9-fee91604dc5b,Healthcare,0.7541277990903036,25,12,403,655,252,65.60380737404198,5075
71193d9d-678e-4cf9-94f9-86c98e6192ff,Educational,0.2757759846182717,37,14,507,1082,575,17.750160154935138,5523
4291180c-a828-4032-82af-0d1f96f64371,Educational,0.7236845986951772,17,20,98,461,363,79.14704904591221,9175
e9fbf302-7d2f-445e-98d6-1faa280e0f14,Healthcare,0.9876848189249847,27,46,409,1056,647,17.636346750980483,9915
1c73a111-ba0f-40c7-9472-6e0594fdbe7c,Healthcare,0.9076381500454429,20,26,548,1380,832,39.94361404138287,1649
ce3cbd77-15d8-4ac5-ba92-b25af6e29f9b,Residental,0.3882587426708567,12,5,521,1129,608,43.69995536657379,4422
f61f7921-10e8-4139-81ec-98917b02cd60,Commercial,0.7737866094909487,19,5,693,1027,334,13.20841823401922,8559
476490fd-a94b-4810-b615-a91b6757fbea,Commercial,0.7896747235763398,23,42,47,341,294,93.32863333098179,1569
6a25362f-4a39-4506-9297-d55c731969d7,Residental,0.0483283715423648,30,12,553,1425,872,28.410921299386334,7024
4277aaa3-596a-4fe5-9c7e-72cf416e81df,Commercial,0.25814735854788173,49,45,169,987,818,94.2715940366429,3992
31747a16-6422-459b-9f01-8db0cb7c312e,Commercial,0.5226617920878368,27,7,564,1208,644,43.60802395900426,9043
4d331896-a908-4a3c-8042-58503bca1170,Healthcare,0.638601776340795,6,38,317,588,271,43.853013481056884,1809
75f0e392-3522-43b2-8f67-c12f522686f3,Residental,0.26012218803974596,24,37,274,296,22,45.265403762328226,7829
cf616935-6e62-44b0-84b6-97eb550733f1,Educational,0.35936239373000123,33,7,542,633,91,93.32414334798246,9968
fca4d397-7ad0-4b72-86aa-9366b43f248d,Healthcare,0.08311228858562836,40,45,17,1136,1119,36.039448466217564,3484
2f620d07-8f18-4866-8b28-23413c161720,Residental,0.1755274012365795,20,16,636,722,86,74.69476385089546,9512
59a70376-5fc0-4102-b073-93a0fb7eec25,Educational,0.7729485872291224,36,27,564,1019,455,26.369351518669966,7387
a043ed7d-66ec-4f11-8b4d-bffd4a051db5,Healthcare,0.27728937506595364,28,42,219,870,651,12.744730644749403,8907
3147ba06-b842-49fa-9b43-001670e79157,Healthcare,0.8041388340245643,46,26,189,838,649,94.29784465900549,1035
ff56f565-bc99-4978-a23a-d1af218302bc,Healthcare,0.4688424163708109,18,17,539,1014,475,18.961944070447608,2802
25b9f5fb-92b7-4c5e-8bb4-23ba1f5a9307,Commercial,0.0780927629513336,7,17,668,925,257,52.000063519039216,5196
13feb66b-843c-485d-bfab-b82c3dce46cf,Commercial,0.9017256692088181,36,31,309,797,488,37.768129061914216,1462
971e0d54-7603-4062-b11f-b322753e5eac,Healthcare,0.8773511811496187,6,33,661,920,259,37.650896007244526,5830
1ce2b31a-ec9f-4d29-9fd8-5274f3d1ddca,Healthcare,0.18607559330244183,1,16,105,403,298,42.37658299135123,7222
1a4d76b1-c676-4122-8787-eadf9354db50,Commercial,0.03263064869686072,40,21,279,1284,1005,66.3262075097927,1514
f9ea38cf-31ee-4795-bde8-0fe43e9f7e13,Healthcare,0.6598201664690105,49,36,578,628,50,97.77726626436062,3583
7dbbcae1-53ae-411b-822c-32798489c9ac,Educational,0.17941311991752906,21,11,119,168,49,26.499970098611865,8399
eaf6d3df-ffe5-422c-ba1c-15395c2ece55,Educational,0.5194995070564546,22,49,162,688,526,34.1612700551491,4122
5c93b61a-ec79-4d2f-9d18-42b0967297f8,Healthcare,0.17871159996250374,4,41,550,1237,687,43.70172341725851,1094
aa8c3aca-c32a-43c2-979d-8c41029762c4,Commercial,0.9887850750382638,8,13,286,352,66,28.551478094239236,9250
ce123df4-0e6e-4b17-890f-be3ddf8601d0,Healthcare,0.010921970422031024,40,26,621,1360,739,30.614194999219137,1539
06c4ce0c-77db-4f58-a4ec-1a5cfaad1df8,Educational,0.8491140989690036,10,50,517,1291,774,24.087425528440555,2578
88768693-f7b5-4508-b0b0-1e7b61ad65d4,Educational,0.6491524770366716,13,8,626,1319,693,49.10647992683552,8820
37167141-0487-41fa-9c27-411cd3a1600e,Residental,0.169583268814666,47,36,535,716,181,50.203587866817266,4795
1ae8509d-d718-489f-ba44-0791c0e4818a,Healthcare,0.6856781170268599,30,16,613,1248,635,53.61586748583272,4818
df36ccbd-2a38-4752-b9d6-04231c8fabd9,Healthcare,0.774216684690825,5,11,403,1119,716,73.8605226954197,7098
62c7a1ed-aaf4-44b3-b8b5-17bb897facb6,Commercial,0.7882407745926115,50,7,459,893,434,50.12827779870682,2749
36d500f8-4f64-4511-b370-e65cc98b64c0,Residental,0.06927936350711861,16,48,611,864,253,90.5563051664514,4489
4ac28455-7d64-4de8-917b-74b493c2c6db,Commercial,0.0874036839909822,15,42,566,875,309,93.89234310810167,9163
75378644-fa66-4ab6-9b99-76c44be8a1e8,Educational,0.049255418384214655,46,48,260,393,133,54.96492142922472,9174
d2e99ed3-910b-4c05-b815-7f4768378542,Educational,0.3347701796871674,30,44,539,611,72,92.21952673524713,8482
ae768b4c-bbce-4422-ae72-83ec592b70b9,Educational,0.06428075215145412,21,50,547,1128,581,91.59855053550925,9658
3f98c51b-fa6c-46a5-919d-0408b3f04c77,Commercial,0.8762581625175955,25,39,287,1433,1146,71.34485861865747,5607
614636fa-eac4-4941-888f-dacc84fd7cbf,Residental,0.5628855698799758,27,2,385,749,364,71.64506529004092,4974
24767f01-af3a-4b1d-b2bc-bff9b53fd8be,Educational,0.8808204412536459,38,11,254,825,571,12.746498785018932,3561
c19d2e14-1920-4248-a124-1e7702bdc413,Residental,0.5779058212305208,34,19,554,658,104,97.17678318622922,3402
571b9539-027e-49bc-b2b3-ac1fcac48aee,Healthcare,0.3046941446568254,19,24,450,883,433,96.798632006588,4789
b161496b-0edd-46af-9e7f-c1ee211d29fc,Educational,0.3444543235641164,50,31,107,1117,1010,55.72372609241622,5767
eac04adc-2435-44cc-8ab1-2dbda2dd0218,Healthcare,0.6113346963223021,26,43,2,906,904,55.92798075966521,5937
60a36915-6a44-4396-9f36-d5d9c1737f14,Commercial,0.7379897478227759,35,29,29,720,691,84.55048894687079,8303
5fe37fa4-c72c-492c-92ff-1e63021400fc,Educational,0.9944991708101258,18,21,569,671,102,48.01906432729467,8513
72d2d61f-fc77-4a60-9fe4-6da3be9f63ae,Educational,0.8988484156121075,36,34,413,664,251,86.42660415518766,1417
23000b1a-5b68-4331-b9e5-8d520fa128f6,Educational,0.15666688116474725,15,45,625,1083,458,79.53339990229593,5168
5ee9461a-9d6a-4ec8-9af6-4e23ade82003,Educational,0.5879967359303617,49,25,282,1293,1011,52.67260798204196,4878
b615c09d-3908-4714-aa6b-4fd98deb009a,Commercial,0.08999738964571935,29,4,159,1017,858,73.402696281928,9525
f2730d64-c5fe-402d-9b1e-c47786337347,Commercial,0.31198629405709855,37,12,541,1206,665,70.39330921138271,5583
1eef9e09-7798-4ae9-b8be-b2c50efe53c4,Commercial,0.8704490617023274,48,24,305,1425,1120,50.07354813545507,6060
4bb8f8a1-26da-4d94-bd7c-603b3e5f5ce9,Educational,0.07123864806659519,41,29,613,1235,622,58.2369892298875,5942
c5eefa80-a58a-407e-8a85-a9b6e673e6dd,Residental,0.79876382744562,34,49,235,541,306,22.900773653673074,2522
edd974c8-bbd5-4ea8-8621-6ab55a41b0cf,Commercial,0.6530069091160917,30,22,263,625,362,74.85043338391195,2613
00468cc8-0289-4a6d-93f3-4509a23a3cb2,Educational,0.9301100878617262,38,2,646,983,337,64.71002338699634,6261
c496330a-13c3-457d-b00c-4b9988a4e934,Residental,0.2577433902816465,40,41,245,860,615,25.176602163095367,5435
77c055ec-0b46-4fba-8909-8de09a714a65,Educational,0.41415357086188653,14,46,713,1096,383,27.912821215722662,8928
9828d97f-b220-46c2-8f50-5181f2751934,Residental,0.20633529280196805,35,12,286,1252,966,28.423629321620805,4256
d79777bc-1c51-4e35-a0af-5c90b1080943,Educational,0.18811624401799076,27,36,589,1264,675,67.90803306300205,6172
3c55aa69-ae10-4cc4-888f-0e9faee1ca45,Healthcare,0.7484499441297124,46,11,381,869,488,57.62761593808776,9906
817fa9a9-e52e-4fcd-b4be-9d9047576772,Commercial,0.7789233244520818,7,6,692,846,154,95.47040597370787,3302
53561128-f873-4303-b22b-9a3ebd4f9681,Educational,0.6230883908765494,10,4,384,1065,681,45.9772682814964,8461
1c2aff9c-62e4-436d-a324-9c88d1f5669b,Residental,0.4248771895863328,45,31,167,584,417,75.20130160059962,6344
20d9e25f-e3e3-4fb3-b29e-b5fc104664fb,Educational,0.25600390387491545,34,27,720,1351,631,30.465355259265063,3196
e096e364-1994-4eee-a971-c0b3fef194e3,Residental,0.1963366865812709,42,18,313,766,453,40.134650349882506,2127
41bc166e-5b7f-496f-a5cd-c48d95090bc3,Residental,0.8757894866160685,31,43,245,759,514,75.23091702742396,3682
8dee42d3-b532-4e75-b845-5ab9bcf215cb,Residental,0.11765896951107024,4,27,152,1179,1027,99.07368007830567,7315
a17944ed-d916-4b34-85fc-53b6762f2e4a,Healthcare,0.29207396843120814,23,39,583,644,61,83.461068657898,7045
af2b554c-34c8-49c3-88f9-9ee51cec882f,Healthcare,0.1811972143600281,3,48,386,593,207,66.71848478100392,5883
d9849f8a-466d-4fba-9e84-862ff1889f9d,Residental,0.49171268675378177,26,28,428,1389,961,55.018700095696154,2822
8f1541ba-04fc-414d-a9a8-13699c2e25ab,Commercial,0.01113892873506206,17,10,696,1260,564,76.44438105156281,9725
f6262177-10d9-4aa7-b6b1-baaf29020e0c,Healthcare,0.8996694077433719,49,13,196,994,798,38.102576816068506,6237
a8270dc7-86a1-46a5-86e2-4876f27690e5,Healthcare,0.8936738435075516,45,27,542,614,72,27.63742385171668,6136
09a436ce-0f75-4de7-a08f-25b55ef705b0,Educational,0.4115797147854652,9,6,376,407,31,73.8370267575707,6103
03e47ceb-60e6-4163-bc52-be04910728c9,Educational,0.4450023895339198,9,41,382,767,385,19.98211164594939,8378
6464af3c-c25b-4b9e-a6b7-23fa66a4f3d1,Healthcare,0.6481022243439007,37,47,4,524,520,22.024622528978583,2171
00f13a85-d762-4194-bce6-0837957fe342,Commercial,0.6050260326060962,39,12,328,1136,808,68.80255739636743,5480
76934486-d2c4-416d-9e16-06db962eba2c,Residental,0.6673238896121849,42,37,688,1161,473,58.34262615256442,4881
80337145-6c1e-4460-821a-0e6ed3e1e438,Residental,0.00933049636207317,46,37,681,760,79,45.09498339530393,3416
59a81c6f-d148-453e-a80d-8befe3facead,Commercial,0.8239268973471016,49,3,487,658,171,10.150483839604176,6496
c6ae17f9-9af2-44d8-8651-f894704d657d,Commercial,0.21405703638318718,27,25,481,1113,632,14.016564841594956,7786
fb8cd6a1-3044-4726-b6b9-f21f8d182c29,Commercial,0.18701171554541585,13,40,497,1344,847,16.00552839575969,1724
633b28ff-1292-435e-9673-696ed634f966,Commercial,0.8452351069550228,28,29,654,1129,475,56.44581816312469,7494
e4d9a38a-7587-4f4b-a61a-b16cbfe35dd7,Commercial,0.9069660989823746,13,5,576,874,298,57.64532332071094,5514
e14fcd6e-e9f1-49cc-98ff-c0a138e9fe7a,Healthcare,0.027433468132369687,39,4,316,1064,748,82.1852702181002,4793
aba2d7b6-e55a-469d-b095-27c871a2f759,Residental,0.6372844416863566,31,12,110,197,87,90.23362831347654,3219
7b54a65c-bbe2-4c15-b53c-e468957fbcea,Educational,0.04426048153134998,8,15,331,857,526,61.45068652072537,6251
ff8792b8-bdab-4a44-bbd5-d9f3521c7f66,Residental,0.09193747903727079,21,12,192,1150,958,32.261407677098504,3398
499f09e3-0eef-4eb6-b88f-9f8bad9f7263,Educational,0.2556483666416246,13,40,409,693,284,93.26053200854517,8143
7edfe408-aab1-4cd0-8d3f-c070c3c9d666,Healthcare,0.013691089921916255,2,30,668,1371,703,45.74310228298038,2884
512c1b8c-acf2-4171-a622-4f2f075f3c05,Educational,0.028557583294110067,27,22,427,691,264,39.90188170107848,9608
dd60c882-2ac1-4e69-b186-2659a98b489b,Healthcare,0.32482174075062187,7,17,274,1341,1067,85.41324046282166,8235
4ad8258b-ac6a-4132-a4c9-678453a276e1,Residental,0.1671871994763492,47,37,345,611,266,52.237607421887695,3476
18cb210f-04ba-4626-b7a3-682c342bef7e,Residental,0.6173635475971164,46,13,641,1271,630,72.25499988514586,8444
88c15910-656d-4ae0-83d9-000bf825c5ab,Educational,0.11797565975606261,42,32,84,982,898,39.92185868602871,6585
e6156010-cfa6-49eb-a629-a9c1ff5f558b,Residental,0.379829434279672,44,45,469,586,117,15.835186055436374,3046
b545dc33-701a-49a5-89fa-463c4daedc88,Commercial,0.9800277570650677,34,39,139,993,854,49.66883392908177,6179
544a6bc9-88da-409e-b49b-2c3bbc48c983,Commercial,0.13670722132867485,18,26,178,1006,828,80.98259496356694,5918
bd189dea-8cde-48f4-8e18-15f9e353c2c7,Healthcare,0.0962004385835612,39,8,483,681,198,28.198714407718626,9490
cb7d9d22-eef0-4fe2-8231-f7832a11aec0,Healthcare,0.5482908563178286,15,44,433,675,242,65.38591554200556,6223
31afa9ca-9bf0-4c18-9896-eb451c19f4ae,Commercial,0.6816674634043849,40,23,379,1224,845,51.79578320617021,1696
526951f6-821b-4833-969f-c16ff39d9a7e,Commercial,0.6648307642187902,11,36,518,1222,704,72.25509682988236,4768
50977110-4d5d-4ef7-a7c2-ce1cce2afb39,Commercial,0.40271895976357974,11,50,162,712,550,91.43518280913429,2341
76de1624-f528-4840-8a04-6e9e9b378090,Educational,0.9880814779985497,45,22,446,465,19,33.075290723666754,8228
291015a4-db95-41fb-ad69-e25aa1f7bb93,Commercial,0.37011206894432314,40,7,257,1111,854,28.25664963016147,9996
421a8f03-8dda-4831-b3d2-4de652528247,Healthcare,0.058783450460674014,17,34,32,1088,1056,13.852328190975632,6204
94c3906c-7149-4ec6-a0a2-d464ee6f361e,Educational,0.7796037337864128,36,18,679,1275,596,73.10072213754971,4036
cb985305-8451-467a-8249-1ecf26e1176c,Commercial,0.7463818573209663,17,33,594,775,181,60.91559375930464,7155
a383703c-a988-4d51-b6f3-1eaef14b3b56,Commercial,0.3822610616671047,47,11,31,135,104,58.11800154284819,4624
09fe255e-44bd-42ea-8c44-86062963a3ff,Residental,0.21872172465621154,12,43,694,953,259,81.31771773363646,8609
e68852a8-f1c0-4ace-97ca-74bfe30646f0,Healthcare,0.24903354374383224,38,9,486,703,217,26.965580479404423,8910
bf432295-48e2-4914-a305-c59085c91d2a,Residental,0.2815892388396922,12,41,428,872,444,95.81176240344045,8949
56bfb7d9-69ec-47a1-9967-84534ef65494,Residental,0.8414433886311724,17,3,562,875,313,57.11604649735736,6076
e6ce8804-005b-4f03-862d-216645913afe,Residental,0.8642381293055337,48,25,491,702,211,33.35334905334222,8836
0fac8117-fa3a-4344-b64c-8bf94d227900,Healthcare,0.7556353210165676,27,50,605,1076,471,19.27036535329203,5949
a0b47044-09c4-4ecc-8a2d-7cbc65fe6f82,Healthcare,0.967863790272072,31,39,701,1427,726,14.592201016170696,7437
96a3ac36-f4d3-4c73-b1e7-8fd4c8b91e5c,Healthcare,0.1146792171351464,46,44,536,1392,856,97.39498486293154,8183
44974310-f34a-401d-a832-c361e47778e7,Healthcare,0.22484426473215546,12,34,621,1342,721,76.32471808770394,6413
1d0d6893-61a8-4a20-b5e4-3259dd6a1781,Residental,0.8904157131631479,6,21,35,1403,1368,91.85568199601316,3788
46024d51-c713-4480-8f34-2e1bfe6868cf,Educational,0.34235470110165034,40,40,678,1139,461,29.771151007804647,9888
3886ea47-05b4-445c-997c-419cd76dfc26,Educational,0.9038377756010068,27,8,227,302,75,68.40596052943641,8995
966d53b1-a786-4403-a1f1-b394e23ce7f3,Commercial,0.7233440694837422,26,49,352,420,68,25.07438585658433,5237
ce97d706-7e67-4297-9819-cbc79cf63fee,Healthcare,0.8604106254938201,4,30,79,602,523,83.55609241817265,5603
d54e0a7c-4a25-4d39-a0ee-f6d6ff9beaa2,Educational,0.3833170327032741,38,27,103,354,251,58.987141672508805,3596
1af16ef3-2373-4a03-ad92-e1994a9e6c3f,Healthcare,0.7283234220131782,42,33,201,1159,958,84.18042413040051,7146
6d01c8af-f8e8-4ee2-b189-400014e4ed65,Healthcare,0.8815559673063736,49,34,31,992,961,91.53868087418891,8905
940f227c-343b-4be2-bd3c-c10d3e37caac,Educational,0.9968402237772412,6,43,568,1313,745,78.62148260746166,7780
1a63a5e3-58bf-43f2-8488-a78780c9c30d,Residental,0.6819449108411333,7,16,371,1363,992,24.04846030230962,4971
610ce649-01a0-4099-9b79-56bbbba74ed3,Residental,0.8255023611282591,4,17,492,701,209,58.67925786403111,4444
69d32ef5-bb8f-4361-ab5e-8b57565f946a,Residental,0.5376115301327073,15,12,161,1029,868,37.905835433928324,8738
6c2695ca-40ea-4989-b19c-486758bcbcb9,Residental,0.4320776774596312,31,39,173,1119,946,35.97979890896069,3929
b97a02da-1ba5-40bc-9343-a21b37b256d1,Healthcare,0.46966347953915955,6,37,193,549,356,47.94391562943016,8649
5990edc5-e5ed-4eaf-bfd9-d1dd6a176896,Healthcare,0.5488417569233892,16,32,260,545,285,36.40380051890305,7496
c4665c2c-7b48-4782-a5c4-daefc28346cd,Educational,0.04030136603321177,13,32,346,892,546,24.942194595871623,2957
9f0d9ece-3528-4790-9a8b-197732cd55b2,Commercial,0.000858715533525789,50,38,676,1106,430,35.34944658273423,5239
6f71e845-5d2c-4ef5-bfa0-84dfe2e0da4c,Residental,0.011131751472830964,27,38,131,1036,905,32.81649886620794,2039
57a86a72-3bfb-404a-88cc-8be887928f23,Healthcare,0.8891884982578053,42,14,181,1187,1006,62.32451337068105,6522
d1785b08-b9f4-464b-8050-d830c4d47253,Healthcare,0.2386127145716217,17,40,391,599,208,69.96361032470016,8723
690577ca-319f-454b-99ce-16cb86332d5a,Residental,0.24949565227510073,13,23,392,1079,687,27.10173470067914,8908
46cc59c8-b0e4-4da2-aa06-6215d7b4963c,Educational,0.8740120858164535,45,25,432,491,59,81.61498161060211,9116
7c05092f-d5da-4f1c-b09d-7659a571d259,Residental,0.48914680529246846,28,46,247,247,0,88.27781890486547,7429
abdf504f-f163-4829-b1d3-dffd5476d43d,Commercial,0.30373138277723877,21,18,262,697,435,21.615233512302815,4322
f318c02a-95a8-4989-8aa0-ee66ebe2f9e3,Commercial,0.748752166151547,11,38,502,1229,727,14.538572915926713,1151
d495f851-a608-4404-ba2e-163c724324b3,Residental,0.19725907217223215,21,23,318,841,523,50.002599890153306,9379
0eccc164-6bab-4cde-81a1-e2f08b44f2da,Educational,0.18498999339155076,31,38,86,678,592,58.15596063284437,3202
6fc765e8-8df2-4cfb-a67e-b05ea479adeb,Healthcare,0.47758729848863535,8,38,469,712,243,90.77849839188212,7861
d2ec364c-9cc1-4c28-bb5c-9d86d099e368,Commercial,0.23577679776698013,50,24,467,1194,727,26.539992854441127,4868
e305ac83-20ee-4eb7-a72b-743aa37f8b27,Commercial,0.27019733793284295,1,41,613,1100,487,13.381628605915997,6220
1d09287a-2800-4799-9ac6-4e6cfd8ccbdc,Healthcare,0.9999202761521382,18,34,413,894,481,45.130981334389695,4127
1d1caf1d-f3fa-4a57-81e6-fbd5491188da,Residental,0.31713218452635195,45,13,412,1301,889,35.68408778017769,2298
07ee9087-81ee-4756-8acc-95a04b7bbe43,Commercial,0.9580594827905581,11,7,73,825,752,34.42380666006281,8638
4a48cde1-508e-4b88-8b02-05b30a5e2c77,Residental,0.22400872902265734,31,40,602,787,185,17.25366366004968,3031
9f12250d-87d0-4053-a9f5-21e8780001c5,Residental,0.7451931457086876,31,34,366,1066,700,27.993813928577307,4503
d1739a85-eb53-4c9c-b123-ff8164acaa09,Commercial,0.038815830606696244,18,46,362,590,228,13.316892351257168,3465
98b6c379-01f2-435e-82e3-4c139814162d,Educational,0.03893496985841316,41,10,24,43,19,15.31649121363749,8362
2c7c6978-3991-4256-8d3f-188c2c162caf,Residental,0.16350777093682223,41,42,437,1141,704,74.97541765869057,2594
dfb06db6-4cd0-4a4d-9496-d70f94d24185,Commercial,0.5509165026528243,35,10,512,997,485,71.06859829213059,5093
e230b8d8-0d85-4179-8457-383430038577,Residental,0.6037331941281716,28,24,690,1313,623,89.60256205434636,4573
0a8d2705-ec0f-4eef-9ad6-3c240e9d2c4e,Residental,0.4312092852861785,14,4,290,810,520,31.370310959744646,9723
ee47387f-675a-4da0-a0e1-8b18411064e6,Commercial,0.030960854541822957,5,3,494,1415,921,95.46500512042928,7960
e748857f-cc95-4d5b-ba84-2598c4417f1c,Commercial,0.5638993070908617,17,7,293,824,531,50.67582706480889,9804
ab88de5e-6aff-465a-b754-474e8adec2e8,Commercial,0.3536582111391221,4,24,312,840,528,55.26058122453479,9774
38ab42a4-d7f3-4cd9-9a27-6a6278e7f821,Commercial,0.7337146727084678,25,4,718,1433,715,93.57803892395296,8618
f4eb6295-a5bc-4b3a-bed4-c826ebcd660a,Commercial,0.2947601857414154,47,11,490,824,334,29.26625091850548,3400
58584474-147e-46b7-85f4-3180a607373e,Healthcare,0.9541534001612029,4,16,87,367,280,70.98139486724321,9407
ae33c981-8671-4267-94ee-5a687e689162,Healthcare,0.7201297926705988,49,34,580,1322,742,20.354631697698643,1392
da0d3979-aad0-4df7-a880-f4935b037e14,Residental,0.6243019047134599,1,48,324,1416,1092,23.776039546852285,9932
cabc4da1-8b73-4841-88d0-07ce1c153bd7,Educational,0.28502069909078864,38,15,402,1432,1030,13.589211143571228,7854
094cd1d8-fe8b-4bd9-b1c6-42fb06e83a4a,Residental,0.7098655221606595,48,30,531,551,20,58.79914932004591,8459
20285edc-a5c9-4cd9-8e40-f1cd413da018,Commercial,0.7524442714632946,5,36,265,294,29,54.041840067275714,6820
98c4a9ff-525c-4e6c-9c56-c5d7a3a0c0a2,Commercial,0.33040321073563805,46,33,359,923,564,12.462170136828307,2288
0d04cd99-b5f6-4cbd-a177-36203d2e0445,Commercial,0.5017465007505886,16,4,182,994,812,50.985257640665836,6243
773d39bd-262a-424b-ad7a-e19c5babf955,Commercial,0.2916810416777763,45,47,180,297,117,31.04429943671207,3514
5800e2d7-e637-409e-98e3-964253f0379f,Healthcare,0.05696999644816747,11,46,467,918,451,40.069789806202024,7890
e611387a-e486-4265-b11f-44a590b2d6f3,Residental,0.28330299372274514,50,49,402,793,391,56.87193428286539,1117
747a9ec0-596e-4bba-a4e3-a69fe5425433,Residental,0.602062688579465,13,39,313,427,114,87.42055397139714,8402
36160dcf-6367-48f2-96c4-60c95d810734,Healthcare,0.9081968437628116,6,14,317,708,391,92.04078146443692,7781
61b12874-64be-4336-8791-fd3d9dee7c2d,Healthcare,0.26176235568526485,19,23,24,1170,1146,63.77687126011433,3058
593b2622-5261-4e28-a5c4-4885eecf741d,Educational,0.5075194618897991,27,27,271,1290,1019,58.71270173983358,4266
585c01ef-4004-47b1-b25a-6f2d67c4b38c,Educational,0.4857217553429579,40,40,537,1263,726,83.49134394296965,2451
d18577c0-2c62-4365-8001-3d82a918ca48,Residental,0.011624081129191666,33,13,83,273,190,37.13810241210999,6685
34dd85a8-8d0c-4ad7-a112-00df89337ab4,Healthcare,0.13929228560356988,5,9,673,945,272,38.999242188594124,3460
d8ffbc2f-a152-4a7d-8cbf-86e28938b1d4,Commercial,0.6050764343235491,48,22,366,1298,932,35.69557938982551,7565
402b0a49-bbe4-42e7-9b96-cddf0917683b,Healthcare,0.6161177556495102,48,9,569,897,328,32.06667127910967,9145
36285984-ea92-497b-b3c5-04a5e4233b92,Commercial,0.3666888376884858,28,50,464,842,378,87.33643622013143,3224
2da0a4f0-2b6a-40fd-86f2-578b809b073e,Healthcare,0.6448400109245874,1,49,288,945,657,32.03934357889281,6495
1940de8c-e75a-44c1-a2f0-d2d42636c4f7,Residental,0.8283342568099668,21,33,464,966,502,43.3152388362287,3517
a2e541e7-1d71-4066-a996-a01fb2b47a84,Commercial,0.56682828687546,14,16,131,1190,1059,64.08394398604659,9785
cb65af62-39ae-414d-a9b1-d88f20e86892,Healthcare,0.9964757270917066,20,17,264,700,436,13.45103990958866,4492
44d11771-4ac2-499f-b549-0ff224ca1d9f,Healthcare,0.4146506127786709,35,30,629,1260,631,37.73528666641633,7038
5f5621ad-5023-4953-8bd8-515520cdd320,Healthcare,0.5824416574085197,28,38,684,937,253,95.17630070920949,7647
9b595125-7802-42db-9e0c-f20164567253,Educational,0.38602333529706945,35,41,429,624,195,62.55639811499504,2277
0fec2fca-1be6-4d12-8e9f-4509ef8fdab7,Educational,0.7078001070031916,18,19,35,221,186,59.36742900370646,1261
41b8b728-07f7-4476-b26a-e166727a53ff,Educational,0.7633849724080682,33,20,604,1019,415,41.1840689274473,6327
1b7495a3-cf4a-42a6-8cd7-bbf6b36b52a9,Commercial,0.7906182611835696,48,48,603,869,266,73.81420330131131,9159
21cb66f3-3c0e-43b8-a155-313785e53930,Residental,0.8175941658299758,35,15,271,1404,1133,84.46769589316509,3120
b4f1c8c0-63b8-46ed-bf30-f798f12b96a1,Healthcare,0.2928330353334433,3,13,625,656,31,31.627418570949658,2465
7ec76070-57f3-4733-bfe5-a3ca7b74f9d2,Healthcare,0.48028725153243457,13,46,627,907,280,45.24522214260997,2112
67a7efbb-c630-4b2e-9634-bb2ac0df2488,Commercial,0.3541607446677635,31,5,463,1069,606,99.70865389248637,7793
d760b068-9a19-4c43-835c-3ac7f962c5ef,Healthcare,0.7307503156848816,42,1,287,418,131,94.09524740908915,8097
8c1e5b9d-d073-4195-8b88-0edce7cb92d1,Educational,0.9501628603816716,6,39,4,1261,1257,19.312163470324073,4806
fda0b5bf-091b-41e9-bdd1-1c67171cf33c,Healthcare,0.9909327989388216,18,9,530,792,262,39.39933277648461,2638
d23f73b9-bbfb-467e-a7cd-ed5294d6771a,Residental,0.3364900851033019,32,45,56,548,492,87.93999000209985,5867
9b6be544-4b3a-4dbf-b9f0-3691076203c4,Residental,0.7302732972067983,50,23,423,1189,766,91.79070368020079,9218
9c617cf5-6756-48e1-9aad-82071a14218d,Healthcare,0.9959090840672364,24,11,295,379,84,75.14903230317461,8509
70ee9d23-e257-4b7a-a9b0-0cab5374b5a8,Educational,0.28688897507400524,22,2,360,979,619,71.81385525751867,6048
0dbd6a28-9013-422b-acc5-7dd2ca53cfd5,Healthcare,0.48997934933594856,44,2,499,1289,790,38.38677777993908,1845
02f85d69-411f-4d5c-9996-87d46e64322c,Commercial,0.7553828835979141,36,15,570,893,323,37.2017257052664,4270
6a1905d6-6f1c-4c32-b4a5-0960a153a509,Educational,0.5956091351600745,24,47,424,653,229,72.20657591444191,2696
a9934945-1b2a-4790-bc2b-ad87a9403229,Educational,0.5751399831272523,24,7,162,448,286,29.31262041660532,2656
f1f1cdcd-ecb7-43a8-b3e8-1d268e892438,Healthcare,0.8737476493485893,5,10,615,1208,593,61.461606091019135,4539
b8369044-ea02-44f6-ba10-d97e1deed05d,Healthcare,0.02913778309216708,38,16,322,1362,1040,54.952841460712236,2271
968ff781-c43a-49ca-89b1-10e6ca47d15e,Healthcare,0.4232539960367673,23,38,470,1164,694,37.2305519678704,2934
0fe914bd-a1f8-474d-ae49-3cb26c7a1862,Educational,0.8412441454274607,45,35,341,814,473,81.91693883247308,5980
9b282c07-7c30-49c5-8c68-f232078bcf1f,Commercial,0.08309115296068315,41,16,123,1000,877,36.54141862225831,9809
d6f94039-850a-4f25-a526-a5c32d9d9844,Residental,0.652280913932027,17,20,260,650,390,51.948043293044975,3456
4617647a-9356-4ed0-8918-b4081c2e1f52,Educational,0.1958251280636969,31,33,100,860,760,15.167942286203651,8554
0d4dd466-3511-44f9-9138-7ec32ba915a5,Healthcare,0.1949756807276316,16,20,303,438,135,99.47639639853728,3433
0a3bc7a6-a7fe-4553-9e88-f3a88866812b,Educational,0.6193590249256332,35,5,251,1406,1155,65.69077483747563,6913
12a53af2-5638-43c1-b1cb-a6824c68c4fe,Residental,0.5664683619347126,11,39,129,1232,1103,66.41715857156805,8210
1824f2bf-0584-469c-b597-17cbe9656f65,Healthcare,0.610322487591625,28,2,134,1269,1135,14.865791964654123,1381
9ab125fb-7f7f-4332-880e-8c87399a1c8f,Residental,0.2579193023304145,30,6,503,1426,923,14.866997668619192,7963
0b62fc80-1a1d-43b9-866e-dca94853ac3e,Healthcare,0.0216445746852838,19,18,316,995,679,34.82732485133354,9236
d98a2d55-c7bd-4638-bb26-0ef4dc7452df,Healthcare,0.3673278375937864,13,37,564,821,257,98.42171226832697,8103
ad73b162-ee78-48d6-8cc7-42570122c153,Residental,0.02706821792770764,42,25,473,862,389,71.67248763174587,2759
ec70969f-d774-4cb9-87a9-4d6c259031ba,Residental,0.12056399953582675,28,44,533,999,466,25.96562324486713,8640
9350d511-7fea-4c0a-90ed-2a8530ae048a,Educational,0.6873300536788499,32,7,682,896,214,85.7244944239867,6359
d41238dd-bffe-4954-bc2b-48c3cbbb9f63,Educational,0.9234803044744632,17,45,622,840,218,47.07868606197672,6980
e0c8c65a-f0aa-4e21-98b4-85ae0508fb74,Healthcare,0.2331185967707451,47,5,22,1425,1403,38.91034551412476,1223
73c2bdcc-7d9e-4e43-a75a-ee3d35fcb6f9,Educational,0.17120730912756654,20,29,247,617,370,66.05546124216333,5896
8ba75bb8-d7d9-44f9-993a-b0228065ac01,Commercial,0.07717584953990142,32,18,561,644,83,85.92592732179283,7851
e36e66f8-60ee-467f-9d1b-c24ac63c0b73,Healthcare,0.5945405865515742,7,29,54,1311,1257,67.96370526277582,2611
b9af8912-e338-4c57-b321-b87e9a8af771,Educational,0.4597292692020397,31,3,122,1235,1113,73.82613399067523,6284
d0ce6675-fcd4-4613-a8f2-87508a63e5d8,Residental,0.4066510167271291,30,36,369,776,407,41.19682577769515,4475
df4a5d9a-0e25-4848-a98b-3a6f6254353a,Educational,0.9209224292266979,46,25,145,537,392,51.79417706795605,1454
4e823269-d486-4e55-87fe-e42a3ffc5586,Healthcare,0.3620857502585527,13,8,564,1238,674,57.90862755650868,5921
e1899f51-f2c4-4b18-958b-c1d36dc4ad48,Healthcare,0.2576161697613073,30,42,72,259,187,12.83028426779276,8207
dc66f109-ce24-4137-bc31-5d8eb69f971a,Residental,0.7827297663318726,44,14,256,1419,1163,80.31894721747496,3712
d1c3384b-e4e4-453f-a1a8-6232d1cb4c8a,Residental,0.15385159608184973,35,20,524,972,448,24.359697233596343,5589
c58df6bf-106e-4997-af17-3b47dfacbb3e,Residental,0.045069028517945586,27,12,182,1306,1124,96.1886775937321,8611
afaaf068-00a9-4253-aaf0-1db7c0e9633f,Commercial,0.8603674579157989,45,37,62,1243,1181,26.77554796135081,2116
782ee34b-6288-42fc-9039-ed6c8c9837a4,Educational,0.7440021799385214,13,42,214,1327,1113,73.41655331243811,1832
b832886c-ff25-4266-b4cb-27c94adaf7f8,Commercial,0.9442402186534938,20,1,405,611,206,90.54110085247777,9613
de2246ea-667c-4bb3-b985-a0c77ab1b4a7,Residental,0.5288228383573708,13,9,593,1135,542,55.16688887694357,2411
dd8758d8-85bc-4cda-9fc3-ced7363846bc,Healthcare,0.6124509473255583,9,10,56,742,686,25.21907302869787,4614
067dd60d-2660-4b49-98fc-29082548633c,Residental,0.9140884746600403,44,16,601,1376,775,96.80567117875552,3788
2799cbd5-065d-47d9-9792-a86efaed7a1f,Healthcare,0.6390093005007401,35,43,159,247,88,81.10621476372097,1380
3f651c15-f845-4d6b-b433-89725d4959e9,Healthcare,0.5977085426430399,27,49,544,1010,466,71.01649244434984,5345
b9360311-2b50-435d-8f4d-c1c95e4be22b,Commercial,0.3197694757897783,12,15,508,959,451,99.73711925623202,5271
1202ccf3-e18c-4937-bfc3-3a4458eefc86,Commercial,0.5235631856264593,49,50,164,425,261,50.19929296233067,8157
3f4ae366-974a-418d-b864-0891ef3f6fe3,Residental,0.6879505751801749,6,1,160,1218,1058,90.35600254460503,2249
13975bd1-7f4c-4a3f-8c29-bad3c3291ebc,Residental,0.019709715609244505,20,24,308,880,572,36.520147047315334,2785
6488d4de-bf7e-4106-9a33-3d23c75874ea,Healthcare,0.6540040810943941,10,43,171,877,706,55.65081126768471,4869
6c967cd7-a285-4b3f-8d35-fa196a844c4e,Commercial,0.950405572996902,48,1,485,999,514,25.4866479431071,8982
4eab9ee7-5d13-4d5b-a1b4-811b0b997df5,Residental,0.3787475489243042,21,42,591,1405,814,60.92247348349789,1347
aa8928dd-aa67-46c6-a880-9068922c34d3,Residental,0.4606712940164083,27,33,352,419,67,30.095834392841052,6457
f437466c-4b7b-4d90-bb59-1f3ffdaff2f8,Educational,0.260443648004974,37,24,344,496,152,83.64378766007624,6903
7eb93776-a8c1-4710-bcbf-34eb28980ca0,Educational,0.7191544257202688,44,36,577,797,220,43.86569890129696,9909
297622d7-f7c5-47ce-ab80-a0e024ba70a6,Healthcare,0.27147336275008593,13,50,289,1393,1104,93.60738778467895,2700
dd788b1a-0f4c-47e0-b345-90d72832481a,Residental,0.33229615443155824,25,32,181,219,38,45.14570989914906,6468
61713686-b551-4fd1-8305-6fec54edfd68,Healthcare,0.519228004759898,40,22,672,752,80,73.60422641751956,4252
bff901f1-5f90-4e55-8dec-04d5cd2afff0,Educational,0.16448870424566697,50,22,31,44,13,91.21095130968034,2838
5a81b627-e510-4578-a121-2e6466d73330,Healthcare,0.5418446039274101,11,47,301,823,522,26.269198811769066,4593
0b19f24f-1ae4-48ae-bc4f-20fec5f18fac,Healthcare,0.8638062328165802,7,8,510,774,264,44.9028093791057,4744
63760e78-6d76-491d-92d7-1fe06fbff44c,Educational,0.45931019331712264,18,38,190,570,380,89.01742387055478,5546
7d446181-65c3-4ece-9057-940abd6c7633,Commercial,0.08737130858374087,8,6,295,968,673,59.46253610598585,5064
1be91101-42a4-4219-b17d-54399f1d1adf,Educational,0.44276923735276286,30,20,156,374,218,57.13121874240214,5307
dbfcbc2c-1948-4ac2-ad97-ceea2a812df2,Healthcare,0.48342585880930655,11,22,627,641,14,78.67134213292263,6489
e138bda7-7369-4f6d-9a9d-7528be4d3423,Commercial,0.12867715899526455,34,32,368,1322,954,28.381345630919288,5164
7b3a4325-66b5-463e-a0c0-c876cdd626be,Educational,0.3135420220293037,5,35,353,1133,780,36.765936301631044,2258
3f6a5124-fef3-4a39-850e-7cff6baf7eb5,Commercial,0.3302718119650976,18,27,261,1208,947,46.91119800172216,4627
5297e907-f806-47d7-8375-93de4d905b81,Educational,0.7332128241636596,18,21,4,1239,1235,51.39409182377743,2822
b3057746-158a-4e5f-8cda-3d33447cc1b5,Educational,0.23361360681906196,7,31,405,552,147,31.129943653132408,7730
9bc1dae7-7230-4f03-9079-c209f7c8873c,Commercial,0.8740391141200972,9,15,127,1204,1077,20.362888642574774,6937
a3178e69-dc32-42eb-8616-06e485e9a06b,Residental,0.8349802443537592,27,47,371,595,224,68.99230111674935,8024
db0a9bb6-435f-4a07-9630-e001f9b8853e,Healthcare,0.579596196650363,17,7,456,911,455,91.37024549543634,4924
3313cde2-e8d7-44f8-b498-5ef1b6908051,Commercial,0.04604199835376388,24,42,473,527,54,60.30130969960274,7695
2c3a34f2-3c7b-4a22-978b-1ad3b0f06752,Residental,0.6484945214911692,20,33,450,561,111,44.740491205676264,3080
3d5479a7-81e8-4bdf-a9b5-39b6baf6ca22,Educational,0.7847284057492678,36,43,542,748,206,47.81917623576637,1887
03914ddc-afa5-418d-b6b4-d56a3d26d9fd,Residental,0.37343148520769665,26,29,98,436,338,54.99209648444572,1312
a511a818-8ce7-4cb3-8226-d22fa3f33963,Healthcare,0.013837825633592815,12,40,63,355,292,51.151144157886286,1568
1f5da687-1a8d-4e98-a0fa-3e7622074b6e,Commercial,0.8793209998633735,32,49,181,642,461,99.99050473532292,3563
8825a151-a601-421c-a1f6-da9bc91cc55c,Residental,0.9726842871820967,1,15,153,566,413,70.24282974293662,5193
b82a3f3f-303c-4819-983d-ff2c4f31792b,Residental,0.5900844071234376,13,22,690,1433,743,39.14216698009741,5506
5916832e-2434-4317-a63b-96f4320d1f5e,Healthcare,0.9137960569167305,18,26,456,1271,815,47.943235485219155,9423
b0a540df-6df3-445c-810d-1a44a832d43d,Residental,0.17747858733979027,37,13,329,1399,1070,57.24641980879146,6658
be483680-e5fc-4f66-830f-dba3180d6be2,Commercial,0.20344740184903465,35,7,72,282,210,63.574579512533056,2091
18ee053c-28ab-43d5-8946-7ddfe2858f0c,Commercial,0.806212162780962,4,18,442,655,213,32.091791773450794,3439
4f29016e-44ad-44ef-9dd6-779f5b8159c6,Educational,0.5368990369858707,49,32,473,619,146,28.390312645221535,7605
b6498515-450b-44f4-9a48-796d6b98140a,Educational,0.9719804395930961,1,22,550,1369,819,23.9623372897672,9576
f6178456-b00f-472e-a603-7ddba1b78077,Residental,0.0257443552286154,28,25,165,1411,1246,91.05306426530427,7222
e75f6793-3f40-457b-bded-d15d692fd59e,Healthcare,0.3394993783879371,22,45,136,963,827,13.598091300830056,4971
edd1f2ea-5e75-4363-8839-3c21333f4e57,Healthcare,0.4125560255942373,50,41,422,738,316,99.84040285933146,5894
d2f9f2a1-02ed-4f36-ae4d-ce1e3cdfb2da,Educational,0.9211176891297423,39,4,718,1158,440,52.80527741900236,2272
8d6c8bf1-1313-4873-9224-cc5192fd707d,Residental,0.16063346425096214,22,50,660,1173,513,99.29880302752362,6686
aad7ba45-bedd-42c5-a1f4-66fbfac0e35c,Educational,0.4916903446388041,37,26,318,448,130,27.457028019453034,8394
a32c2ae0-57d8-4103-b202-ceed4f7353a0,Commercial,0.9813748326979053,35,32,535,715,180,77.44168111903811,1929
c63fd5f5-8cea-465a-87ed-2e078b21e321,Healthcare,0.7847210637050447,24,17,124,369,245,11.315781236815571,5268
5eac1042-0bdf-48b0-8bd2-9142eeee0245,Commercial,0.4097481161867481,24,13,439,685,246,88.46181997805118,3972
99b564e9-645b-4f4d-9ad3-27dbb5014d06,Commercial,0.7314648612635942,27,37,693,1327,634,36.10090605375131,8513
6ee9cdd9-55bb-4da7-905d-00f4f01fe0e6,Residental,0.8183805867961886,29,30,295,513,218,57.770886076747,1756
2ebbd6f2-9ef1-484c-ab23-b9afa0e1fa8c,Healthcare,0.40410162383879766,19,20,277,612,335,57.06257731931927,6615
aff1943e-6210-4a46-a474-fa5bfade7608,Residental,0.29403605160618596,36,18,683,1321,638,22.72358732764183,4148
aa55d181-85f1-4e15-a2cd-d4ee8419a4ae,Residental,0.9363095315820364,15,27,77,1327,1250,45.47725593824948,9147
1d41b3e7-8847-4bbd-a247-dde7e7d82b25,Residental,0.7104979557107591,7,13,470,905,435,20.92619189185954,4919
1f2fb586-adac-4d7a-8f1e-915cf266592d,Commercial,0.23449395060613576,13,25,285,473,188,52.4021313934869,8514
5ae4c4fe-9865-4b19-9c5c-b029e304b785,Healthcare,0.12420871092489694,3,33,389,443,54,92.50144771447566,1019
b7f6afe7-169e-436c-95d7-52743cf95549,Educational,0.8493316176521224,9,48,576,587,11,85.44402961855047,3864
6ca6703a-2762-49aa-8b06-155ec11be10f,Educational,0.7387509425986294,30,1,146,878,732,43.89602446381378,9872
de29e976-4f5d-4eac-8041-f6591047e39f,Educational,0.23545716813588358,7,30,498,944,446,96.00131390471289,7590
d98fb240-c42e-4c82-b0c8-f0d95c91d296,Educational,0.4793841916431344,9,16,373,1382,1009,72.92967472593071,6564
f3c3a3f5-568a-46f3-8567-c90551c45630,Residental,0.5260571099439733,32,36,599,1418,819,59.43222385694078,8356
d3aa5ec3-d591-4b04-9aa2-20f52c72eff7,Commercial,0.3501515514819582,3,35,625,798,173,89.56983529329499,6233
db309d36-730c-4266-b95d-135bdaaf5ca7,Educational,0.281968382005402,44,14,69,116,47,90.06270177757769,5887
8d52fdaf-03c9-4f80-a4a4-dc6a4832a6df,Commercial,0.035446251481922264,36,10,211,275,64,94.0567002117042,6153
0d37280f-7a90-4443-8cb3-deee4711e577,Educational,0.5567364574907171,47,36,565,765,200,23.971699796468272,7686
a37d74cd-f10f-416a-be18-67de89373522,Commercial,0.8765972465195385,37,33,701,1026,325,96.88216916140104,9450
741d54fb-10df-4b08-99af-f6df62d92911,Educational,0.3028860908770119,13,29,204,393,189,81.78908821659545,6140
44baa6ee-2532-4e3b-8b5b-a72ebd7176f2,Healthcare,0.17774416223853962,27,45,391,900,509,89.67608298404963,1391
c32437fa-b6b0-49a1-9e37-19078c4d10c3,Educational,0.04552683000773272,6,50,9,57,48,72.72725730749022,3533
2df26b6a-aafe-473a-b908-41db7e148ff1,Healthcare,0.6506168564230466,3,31,367,816,449,27.432200090531385,6546
ddd6048a-880d-4f36-a125-b57b2aee56b0,Commercial,0.6168895454680862,14,36,400,866,466,75.7447181176421,8967
b91ede73-f651-4fec-bd38-8a22e596107e,Educational,0.42152921864765525,15,1,167,523,356,86.14968667778246,1957
1f67230a-f8e8-47d7-b791-06a08738122f,Commercial,0.874170794131431,22,35,171,634,463,65.6845862316627,1947
eaafaeba-f428-4fa9-a83d-3bbec3cf66d3,Educational,0.1081715019626609,3,11,653,1160,507,88.3296246408232,9872
d49f53d8-cc7d-45d0-a998-c4a2edec95a8,Healthcare,0.5857546504648866,40,22,640,747,107,68.96503423126867,2347
ce124cb6-bc08-4c01-9c1b-e671b7a8a784,Commercial,0.84846161800584,35,36,342,1304,962,49.90440549920501,8717
ee4d12a9-e9aa-464f-9d07-779498abb14c,Commercial,0.39181818389820366,18,20,447,976,529,33.60987259545806,3429
10ff3734-365f-43ba-a1d1-8f085b033a1b,Residental,0.5686934521758595,25,24,93,367,274,99.34628992313156,8394
2ad5441c-be68-44a5-87b4-344718e27bb6,Residental,0.1738641925401181,43,44,619,1066,447,49.27681928450607,5344
7e1cd760-0d99-4e5f-97b5-d86ccc708dc4,Educational,0.6274889698902828,8,20,346,885,539,98.42290157276265,9111
05f3df96-fb43-4b52-869d-c153fe22b19e,Commercial,0.09745311381532051,35,19,115,600,485,63.16911645991944,2086
5d71ec2a-1e9d-4bf4-a5a6-f1fa8f742ccc,Commercial,0.6158077643878126,7,39,385,707,322,37.72906676130479,3494
6e6f55fc-32f4-46c6-8888-c74c4006dbee,Residental,0.6874537058677737,8,24,583,1227,644,36.19166639107725,5072
ac952403-f3c8-4476-b461-14ba2f1ccdf3,Educational,0.004752990459250261,7,38,114,881,767,49.372229352757344,4329
f0e736bf-1f5c-4bce-ba3f-7cfab49831ac,Educational,0.5494493178981138,1,19,457,1158,701,18.246640972299772,7475
e269813f-e8ca-4e32-9072-55d3e8ab025a,Educational,0.9668073362004457,17,3,720,1307,587,57.934167503566556,2361
d7c3c627-fabb-4006-abb6-520492deb088,Healthcare,0.6086012511202332,32,42,374,488,114,60.704684016933335,4852
9fcee255-2b53-4e48-bc5c-47ac434f2080,Residental,0.7882871317888114,6,14,656,1032,376,80.11951193154624,3254
33d97ee2-b889-4df2-ae3d-516a1105c8fd,Commercial,0.16518640997748746,28,47,250,749,499,51.244759672542045,3734
bc561928-94f4-4a6c-8e6a-f01aa6ddc4ab,Healthcare,0.28444342112921805,17,5,530,1254,724,61.73128049009495,4070
1332304d-c65f-436c-a096-ec3517a2d093,Educational,0.403519949598264,3,44,711,822,111,39.620940690615534,8275
b2839dc6-8b98-4251-a6b3-6b9ead84e82c,Commercial,0.41869537410594093,27,21,448,462,14,57.952834137913335,2927
f74a1fd0-b2e7-4024-bc9b-769ad17f1652,Educational,0.046485300494951254,37,24,497,1272,775,29.927304938833654,4411
10b69313-75af-41e1-aba0-4ed8a7577c64,Healthcare,0.30047272420544535,15,13,580,763,183,30.442090521855448,1179
14e3b6fe-58d0-4458-8d3a-2226e375aa8e,Educational,0.49076467749730224,42,25,597,1206,609,20.056310739495807,8655
04cb77f7-92b6-41e3-9b6c-fcb8f4ab1228,Residental,0.7596550393996236,44,49,91,975,884,46.770708560959804,3411
7e85ef31-bdb9-4464-8ccf-17d5063bb3af,Commercial,0.04803749509259703,44,38,622,989,367,44.567091137658,2307
3d41c0e8-33e5-470c-aa8d-010cd7381a44,Educational,0.06946343116184661,8,40,335,616,281,58.24909396718784,8621
d8c1f5dd-2007-4c5c-99b0-1ba008c4364e,Residental,0.6702775827861598,15,29,418,1145,727,69.75803782898603,3211
b81297ac-20c1-4c8c-ae6f-35294507df8d,Healthcare,0.42072251858154197,10,50,481,911,430,82.18310845685671,6619
15d43d0a-66e5-4a83-a391-a3272cc648f4,Healthcare,0.538162425110016,41,17,457,733,276,68.37157234103745,3669
e20d0d7c-c55f-4a8c-bb78-208e036ef9b5,Residental,0.8599938470225356,9,30,51,880,829,83.19684654733935,9031
4cb64bf9-9f99-488b-8727-c821ed906ae0,Educational,0.3307931586121403,39,49,533,1300,767,12.658158260546076,8763
8db7f192-67b0-4bfa-89d3-947c3e520d8d,Educational,0.6656199257566225,26,41,340,1158,818,76.65876683591614,2401
55c5a1fa-6fe1-4143-8604-b9a256a3f90a,Healthcare,0.7841374527836045,10,9,123,583,460,12.368989539592153,8187
cebdaf9b-b1fa-458c-a28a-ec654cb3ebe8,Commercial,0.4449077688845632,37,27,15,1148,1133,10.471440399136796,4332
f4d6317a-5348-4b9d-acae-f81369b9eb98,Residental,0.9984256544391954,40,44,553,1301,748,16.928990624946206,3464
1226bcd7-71d0-4bd8-8d63-9b2665d2dcf8,Commercial,0.44316851458586537,48,13,383,1371,988,52.9579128508886,3847
8b3b67af-d8d1-4f05-b57f-d65ec347ceb9,Residental,0.9772598751668343,27,30,379,672,293,22.095460406899445,2453
2fa0bc7c-e246-4e66-98cf-bf35840ff9fc,Residental,0.029658936314549744,23,46,139,159,20,27.240093770128144,8000
c7ce9ff4-abb0-4201-9ad6-362f16f56947,Educational,0.6484307986622062,4,49,32,253,221,61.189857832870295,2704
54eb7181-acc4-4f89-9603-41cc77e49d49,Residental,0.7364356389172462,24,37,426,1235,809,34.273796632465775,1394
a3cd920b-b600-4923-b3b0-303d0d9fb7bc,Commercial,0.37494635617044514,18,39,689,857,168,44.124997389418816,1690
8e1e9b7d-8a5f-4a66-a66c-82bd167c9a7f,Healthcare,0.4195504379851007,40,50,556,941,385,83.92790735114914,7914
7de62e64-14df-41e5-9d03-47275ef49dbf,Residental,0.23884446493563516,22,38,12,1159,1147,87.6947066932904,8642
3e18b9f5-586a-4ed1-be1a-ab4e6fb7466e,Commercial,0.5587195597711619,42,10,714,755,41,24.061474375135113,1856
bb5507a6-b6ce-42b8-bed3-7c923b150159,Educational,0.0008407719357516052,4,43,150,1297,1147,57.499423479384426,6642
994c9dc9-bb86-4a67-833f-6902abb9cb84,Residental,0.4867617579366086,48,34,380,400,20,35.06312569009498,5939
487f4bb5-500f-4f63-a1c9-58e3a8bdf708,Commercial,0.4910404545315852,38,22,578,983,405,38.093928461664206,3950
da95f340-8b66-41eb-bdd9-f2e04836de34,Educational,0.19399989573357312,27,40,484,1214,730,17.33729608767748,6118
98b1dce8-c60e-405e-b804-e7b5658984d3,Educational,0.9670626725112061,41,17,14,190,176,95.48778190671386,3212
a1b74202-8c06-4dce-b779-05d019a66cb2,Healthcare,0.16289549771876932,5,48,82,1250,1168,78.01832793740051,8907
0c7b4f42-373a-4127-aa49-074b6ffd36bd,Healthcare,0.39121804440642916,12,38,71,310,239,76.55081773065812,6959
069ee2b3-c010-466a-9979-d1a0d7f915ed,Healthcare,0.5643878624784593,7,10,141,587,446,57.78718794762989,7889
ce03520b-08b9-451c-9137-e534108d8b24,Commercial,0.32271474945136824,23,21,287,1117,830,24.811480214172324,3071
58e50f4b-fea4-4e97-89c7-eea60d94ec1f,Residental,0.6313090807482538,19,3,464,1230,766,39.42939067002206,1971
27159758-3b9a-43c1-a7a7-6f0580222f19,Residental,0.13343763987217083,14,30,623,739,116,22.23502711511515,7675
c780b806-b9c7-4a2c-9503-f61fbaba7e2c,Residental,0.08201833195637809,13,12,147,276,129,47.234896240976205,7330
e3aca507-ece7-4b6d-89c2-ac7953ac8098,Residental,0.33853747605262563,8,32,201,820,619,46.73072121262528,9274
23534576-7ce6-46ac-b37f-1fb55577eeff,Commercial,0.8470943401021158,43,1,96,1386,1290,28.61327486859366,3202
7f76ed3c-af91-477e-8808-8bb5ad941600,Residental,0.023017279942085356,30,2,701,1065,364,93.84911641805846,6249
33f9c68d-d4e5-4ccd-8992-b608018f9d5a,Residental,0.7588544881302661,47,28,532,1305,773,92.41008055571207,5129
573bf272-78ca-44d9-a7d1-e3758ab816e7,Educational,0.1486280387781067,46,4,7,303,296,36.90941873531543,2446
5c25d781-b86f-4464-81b7-b98ae599ddc1,Educational,0.6873279859630146,38,45,668,708,40,51.84265995731478,7851
73d63caa-7885-4708-a33e-cda1bbfca0ff,Commercial,0.7470034036511204,39,45,276,1060,784,68.64158333883928,2597
6695c807-c1c4-46ae-b7ea-c6e29aa09967,Residental,0.8816586187685965,27,11,21,561,540,61.80618445557838,3296
26d8d09a-50de-42c8-b415-7dad4f9f569b,Healthcare,0.4751172355186589,23,35,386,601,215,59.994514875255476,3752
f84bb7c2-85a3-4d76-af8e-d250f83bf0cf,Educational,0.7476987664298688,15,28,435,1078,643,75.81734105990078,7293
3d62f217-b8e3-48a5-9173-eadabd5e8dbc,Residental,0.25698750599095777,4,13,590,839,249,84.94296570501969,7319
d3705fe1-01aa-4abf-a8c3-affd539c6d4e,Educational,0.7430554260572667,43,40,284,1113,829,96.1135261061244,3285
455b89dc-e37e-4c60-b52c-bc5cf7116491,Educational,0.711928687914312,19,34,647,1398,751,91.94172035244958,8033
184cbc9a-49b9-4e04-a315-8af0e93a744c,Educational,0.2905123527105935,45,26,105,1321,1216,90.39090632762075,5118
db9ea20e-9efe-4457-9408-35e71ca74e86,Educational,0.0616252034723932,23,36,331,1151,820,70.55940774756797,8206
8c6b123c-c7c8-4569-b4f1-8cfc95fa3f19,Educational,0.6045538076365541,30,7,569,771,202,75.61902657834926,6192
9b68da4a-847b-4c7f-a3a4-c7340b3fdaa0,Healthcare,0.47132759382793554,3,2,12,132,120,70.24062653749323,4175
5f39ee63-357b-4ede-ac29-d46909a521b7,Educational,0.07909343417980186,1,1,52,1308,1256,19.40756227316908,3708
625048a4-f736-4088-932b-4672192def0a,Educational,0.25575536417149325,14,3,712,967,255,36.72603147629005,7374
93664e5b-3405-4d01-b33a-3ff0e74bc3e0,Healthcare,0.7198280608527379,4,2,519,1021,502,44.26042501010651,5852
87e68c24-6cd2-45ff-b69a-71811cd50611,Healthcare,0.9081059092593314,43,9,160,402,242,21.807385258588475,8545
bb42576a-fadf-41c5-bf74-5b154878f935,Educational,0.4166319455628459,14,27,171,450,279,14.266099923707019,1986
81266b67-5e1c-44e2-b2d5-775815204b92,Educational,0.8865859828172604,5,7,119,439,320,43.45077405751168,8823
c6464da7-68bf-4804-99e5-4767ab08f522,Educational,0.8400768283144648,37,15,46,1018,972,12.821062640830588,9768
624334d3-cb38-4870-8720-5fd54be6554b,Educational,0.44779414869965095,13,4,635,963,328,18.985398702314342,9416
8554040e-6dfd-459a-a22e-05cb87195297,Educational,0.9862510185447345,4,16,649,1127,478,41.965146105856604,9446
3bf1dcc6-d863-412e-b6e8-4405418ef0f4,Educational,0.776934249036118,37,25,339,350,11,63.816088163548734,8326
160e7cde-0451-4da3-af56-29923aebb6c5,Educational,0.4348752411036486,16,6,709,1281,572,92.92257394515319,1775
b4b1c1d6-251a-44a4-8e60-9b55dc09b9a9,Healthcare,0.776805669378666,5,46,95,159,64,97.35962362830453,9250
fbbcb3b9-823d-4917-82e9-2f86e4b3db84,Residental,0.9488168533616912,27,17,38,689,651,50.883787628203116,9128
f6bf476a-73f0-4eb0-83f4-3ab35ad2447f,Residental,0.4997447258282405,37,5,430,898,468,14.523928031680647,1171
4c967474-5933-4106-9826-0c1c5dc8c0fa,Commercial,0.9349718471680112,3,37,707,1187,480,18.691561603750067,4887
c931c901-317e-463b-9518-a9f5985a8a84,Residental,0.39294341265757193,4,29,617,1147,530,25.78303109099655,3577
ab90835a-00a3-4f83-9ae1-7100dca985d7,Commercial,0.32774510774303134,19,34,214,735,521,76.43591150011399,1570
e0ab3a29-acb6-40ae-9ece-312701b2772d,Educational,0.01901172091920511,35,23,314,1201,887,63.82734352643833,9999
1ab481b1-87c1-4290-abd9-12358bb64fa0,Commercial,0.7041506506902342,26,50,26,1344,1318,48.71583097090194,2467
a949bfa4-e245-4704-ae03-9b46200e3d50,Educational,0.017618233330296218,31,26,541,903,362,56.54981566913558,5703
2c9917dd-2b9c-4ea3-8aab-837a1311b1ff,Commercial,0.44122909657148146,27,15,576,976,400,64.5574239671831,3169
62e5bdb6-23ad-4ff8-aba0-daf747f3a56d,Educational,0.31601341303824126,34,3,592,1173,581,57.47117591548195,9565
c582c629-afb4-47c1-ad71-c63fddd3baec,Residental,0.8277777291820709,28,15,63,538,475,25.465665641254432,6490
02836484-74b1-4e25-9df7-f7dde1219c0d,Educational,0.9037162382910943,23,36,40,979,939,34.38116879191837,2858
dc7e48e4-cd7d-4f6c-80fd-9dbb771b410c,Healthcare,0.39898200045128596,39,20,504,726,222,39.37846922955491,6686
f25c7829-e0ff-42fd-883b-f596a37169e9,Residental,0.24573963922441022,18,25,432,569,137,45.20657422735054,7395
c36eb43e-1d44-46a3-afd2-de3a75cb61f7,Healthcare,0.6140150325282523,39,5,417,644,227,76.88669679729495,2657
9918b9c4-67ef-4f22-9b12-f99b7529974a,Commercial,0.03896319567431561,25,25,261,1377,1116,72.89912820050685,9966
6c0fb8ba-84e9-41db-9782-ff289904ec8b,Healthcare,0.37562673735108865,6,27,442,1123,681,32.47103268040746,6317
b15c1f25-d386-4f9e-80fc-0ba13dd4ddf7,Educational,0.10314271361982197,14,1,154,1109,955,10.082180066125927,3824
ed0d51b4-1329-4f3c-aa5f-fc69b4c9ce64,Residental,0.13203841299030272,22,41,549,1304,755,69.62760098585764,6846
de90b9ae-6f79-40da-8949-8ed1be5a5e11,Commercial,0.18283129307145785,25,39,382,1003,621,83.62602320439439,7502
05ebef1f-71ee-439b-84e7-d1df28a87076,Educational,0.5547820949074934,21,19,150,985,835,10.411727692719596,1760
2c61570b-e2ff-4a94-9e6b-f3323da63407,Commercial,0.20678781153404102,9,38,344,765,421,51.50075433151574,6188
a4545844-43b9-4758-a744-2c39497308aa,Healthcare,0.9543975886021241,3,25,575,1342,767,77.90461874358327,1134
18c19ae9-1a6c-441b-ae50-488be4e77f41,Healthcare,0.9564887217964185,25,27,31,423,392,24.921122949750817,8741
8ec6497d-0b81-48cb-ac38-9ed918f2f76e,Healthcare,0.42198154724657433,5,38,568,816,248,23.34325968799449,7104
0cbc6853-fc1e-465c-b6d5-abb06b83864d,Healthcare,0.5427526771699911,5,7,85,1195,1110,24.60687464979005,3667
ec0f2cf4-0975-4203-b9c8-3016aa074ba0,Commercial,0.6160299620559613,3,32,572,960,388,47.09442838125457,1417
79bee510-4c1a-4e18-8ac9-edd6b97beecc,Residental,0.07611393826102764,37,42,331,1094,763,75.56615224985867,8917
a0cd0a04-e259-4feb-bd01-548b1e7e2364,Residental,0.25905275660682703,6,38,274,409,135,64.64662382627041,3914
530c268e-0c18-4a69-9c3b-5ab4938f9623,Healthcare,0.6215480292577087,42,43,17,267,250,69.78371575620542,9045
5c2d3441-cdc5-4525-b8af-c2de7d3fd009,Healthcare,0.9373079431206791,32,23,187,1008,821,38.52520781258989,8721
d46ae507-4cda-4e19-86bf-fbcbce3d045f,Healthcare,0.32842172158746297,10,43,357,1164,807,57.954860098076615,4479
9de46b76-acd3-4873-a1f5-de712559b18d,Healthcare,0.5422839136270902,41,26,181,1205,1024,95.69683046625056,5362
0158d968-cd10-497f-9433-6e35518b26dd,Residental,0.1848004878745514,19,49,519,850,331,80.63086872660371,2141
c90f06a0-f49f-4b9f-b573-fae48b573b64,Healthcare,0.5587564336031197,48,14,434,547,113,38.8939285506887,2686
bec431b9-dcb5-4d1a-b5ff-59da273bc833,Residental,0.4502454051545566,43,47,701,1300,599,85.98718133826267,6230
0070c876-cb2f-4a31-bc70-e97884891954,Healthcare,0.7088198967842967,11,25,338,814,476,86.014805216335,2388
0b9b5b74-2a23-44e1-b227-e58eaf7f1adb,Educational,0.1530967730247349,1,46,280,452,172,64.98613747977089,1910
492d31a5-5ee9-4a64-b655-2c394ee96f5f,Educational,0.08144005643443297,12,49,616,977,361,52.25715575400315,2278
f6a107d6-72c7-4e1f-9b7d-cd0cba09cd2f,Residental,0.5954703678109149,34,20,70,1231,1161,74.04294163442559,9410
d6b02b5d-83be-42d9-9a24-5b43b29bba9f,Educational,0.21068178660370762,36,1,302,1160,858,11.350466349020161,5350
903e3408-aea5-4ec5-b457-75f42e2b7913,Residental,0.18657257904584434,11,20,494,667,173,77.96356271413835,2794
6f6f4c40-af8a-41fd-b268-1e5dfce7ba2b,Educational,0.3949828992454262,49,11,73,1271,1198,47.917005064341076,2059
3fcc83fc-f451-48fc-ab9b-b09ab764407e,Healthcare,0.694754848183318,30,41,79,247,168,53.13583115574505,5278
3f66fa91-f6b0-4119-937a-968f9eeabe71,Educational,0.8634910612148877,30,48,191,884,693,13.121555904453423,2074
7a5fade6-7b21-4dae-8372-0a7073b9ae0d,Residental,0.8760659407957291,4,43,237,465,228,94.830101331744,9431
ae17d0bf-06c7-4c25-85f8-2aed3611315e,Residental,0.8873146763997696,35,50,46,1065,1019,59.67246801961992,7594
6265fc4d-28b6-408e-acaa-5b5bccb253a8,Commercial,0.4586705706416325,36,44,666,1246,580,84.23443423676868,7903
22e46764-0294-4368-9c22-e665ba840402,Residental,0.3412164027678448,42,24,559,1425,866,49.6275530454488,8921
89b4f42b-7adf-4f62-80df-3891dec9710a,Residental,0.07621353591822655,46,32,116,363,247,19.885382570709762,6503
a6f54277-de0c-4dcd-b770-97952753ce0b,Commercial,0.2632537750639997,32,41,336,960,624,96.44734896453137,2259
cc71ddea-4d06-46f5-935c-d6628fc7fa66,Healthcare,0.27116362867398947,37,17,373,853,480,45.279507445746304,3252
cb45b252-8ff7-4f4a-8ebc-3c51891859e8,Commercial,0.6486423444580952,24,24,378,1434,1056,99.10564059491266,7873
4e8bc2d7-ecb8-41f8-a487-f5a66d316e91,Educational,0.981631799241923,34,11,551,607,56,48.57097317935032,9337
a5cadef6-f639-483a-acca-9784d270146e,Healthcare,0.7703429584941079,44,13,568,959,391,65.89469290944203,5832
08e1b8f1-b28c-45e0-9218-81c3cf7cd458,Residental,0.23877462201686517,36,24,293,1003,710,71.51112139758916,8827
89416e98-514e-42b5-9012-6268ef1e1c1b,Commercial,0.1490907470105508,43,25,522,924,402,45.11733622151891,3190
f1d3bdf9-88a0-4999-a6d1-68beb55a3477,Healthcare,0.40326786570922024,8,12,444,1270,826,36.12358471911067,1689
1a1caec2-34a1-4f32-b659-2d0a7c83d6ce,Educational,0.43308868069791295,22,50,309,1358,1049,87.0071828672079,5309
26e46144-83c2-4a0c-a51b-5f44b53d1a9f,Educational,0.7189433067943766,44,27,200,277,77,41.25849917312846,6234
ca921c56-7c74-4324-8985-04ee56546c8a,Educational,0.3258254957226715,48,42,405,1161,756,79.0080539073632,5671
c5829ff2-8da3-4760-8934-a1c88e45b3d6,Healthcare,0.2564741187745516,25,47,574,906,332,25.109326826923997,3276
119476af-7244-41d1-92ee-f09a9190c071,Commercial,0.5596685228916944,18,23,594,1045,451,77.33893556921862,6768
50833818-7238-414a-8b59-d896fed93057,Commercial,0.8124199841822765,50,1,444,757,313,16.346431583985805,9622
5e35ab16-ea50-41f9-a8d6-b85dfdadd9a4,Residental,0.46986446924187275,41,40,51,596,545,62.694127114954405,1499
6d3a8263-d849-44ef-b004-b864906b86be,Educational,0.8273981770191724,8,46,678,919,241,88.05138614630992,8939
c9cd5ec4-2eb5-417f-9460-3212a95aaabb,Healthcare,0.5665695282796043,23,4,506,640,134,56.93102429031736,5201
c7b257bb-f88a-4ced-ae50-244f1f41b97c,Educational,0.4581561053751503,17,15,85,787,702,31.203402344644687,6838
59b79463-b0d2-492c-aad2-53daf0e3b7e1,Commercial,0.7557819342546176,11,33,654,704,50,33.129145393647995,5964
2f6e9322-6c08-4a70-b9a0-316bd171d62a,Commercial,0.19273671560982886,2,3,521,1196,675,83.74737404443273,5873
18a18da4-6150-4e57-b4ac-56cd1fb333e2,Healthcare,0.6436050981863195,11,20,231,564,333,47.35601373593771,7219
21de317d-96db-4d96-b1e1-6cc493e6c707,Residental,0.252409547999485,34,20,274,300,26,93.32939556702684,8331
3b99e227-c06a-401a-a9ea-9e43500a4931,Healthcare,0.7565903380527533,3,49,336,1256,920,10.183368342985203,7772
3aacf287-723d-4d7d-afdb-5a0a4fef5173,Commercial,0.5542473801251011,9,12,310,866,556,19.260016052583637,2940
2fa1ed7c-e7e4-4c58-9c23-516ce7a5534d,Healthcare,0.3528620566148847,45,7,601,1435,834,74.66239980064162,6334
45943559-7930-474b-aef0-c112a60de814,Educational,0.09495577860049975,10,16,26,1166,1140,43.42185588341199,8172
67491ab0-3059-4026-bd57-d817fd3bab90,Residental,0.6147097862752774,47,31,80,504,424,24.767056856491074,7438
20013a51-c8c8-4d0f-8462-9099d58651ba,Healthcare,0.2642256484281038,9,26,720,1044,324,21.07507085229851,1439
6efec4c5-2ff1-4902-8da0-7720d471cabc,Educational,0.9733594022521724,30,15,583,1433,850,86.21275188110914,8482
18c24459-f21c-42d5-8583-183a8d2f1bbc,Educational,0.6146942694352816,4,18,335,1431,1096,19.37945332970507,3602
95deb091-f64b-420a-89ae-7c7abfff3583,Residental,0.7847634929067923,7,35,510,1098,588,48.04668114234534,4598
c4c8986f-ce8f-4a02-a092-cbc42a38ac2f,Educational,0.9972935371060806,27,33,65,337,272,50.425958196658826,9891
ca2b372f-3f08-4bda-ab8e-680d9c2fea01,Educational,0.7020112158182349,11,23,60,861,801,21.823918860487552,2212
028cd3e7-8df3-4047-b66f-8bc43fb02211,Residental,0.3574807976615476,4,11,499,874,375,69.73955313713876,5365
196ba283-2f8d-4c10-a8ae-a24fb4d6863f,Residental,0.23908512271668392,5,31,330,882,552,35.6921233437541,5674
741d8c1e-960f-40b5-ac1a-8ba6afa395d2,Commercial,0.14527571811265183,17,27,65,748,683,25.237332555306633,9228
e816643c-79dc-42d6-8f85-41ea99a1e22c,Commercial,0.6113985132295655,31,21,666,1194,528,41.97178468323273,3824
7f572aad-8a41-482a-bef9-f689513c945b,Commercial,0.5791514445614528,19,10,654,1012,358,97.26271546108227,1825
2793eacc-79ff-4b32-a30e-8227065fc748,Educational,0.9049472377863675,25,38,128,1294,1166,45.41925393295217,9901
b63eb17b-907a-4009-8072-71c32d41c251,Commercial,0.4525303309857245,41,2,237,323,86,68.65546390756768,9948
ac0fa416-0605-4cef-b595-8dbe41cbaff6,Healthcare,0.9025744509469694,10,27,83,1170,1087,23.999031403732268,1457
674941e1-428c-417d-84c7-a2e930ef47d0,Healthcare,0.5248797675869471,38,22,379,680,301,89.51078033537925,2625
f49e168a-f17b-4aa6-8120-51d18607a5aa,Educational,0.7821853371336809,19,43,31,799,768,15.433454848266413,8014
3f605cad-7153-476a-a2fc-78f70fc2bf8b,Residental,0.4191157421733037,16,40,428,1229,801,79.36957588655787,6171
a0a556b3-8915-4a2e-bacd-fa32d47dba4e,Healthcare,0.07997903457322497,50,34,437,954,517,47.57380952628236,3370
505a589d-6c41-4875-b9ae-b79c25acb1d3,Residental,0.2306206797489253,11,24,444,935,491,52.536181985521594,7701
df173bc0-8fcc-40d7-851b-1fbdf7e1c7fa,Commercial,0.9994142837344747,26,48,449,520,71,75.21235120983316,2159
e2e014df-d25c-4fb4-84ef-2bb8976fb5ca,Commercial,0.4442166250836277,35,32,39,678,639,37.200189982554576,6575
609cfe2f-4e46-4525-81e9-0e0de1d32e85,Educational,0.23200682546156692,44,10,157,781,624,94.40862081125272,3962
c9754a25-fe71-4666-af14-5dad7162d1bd,Residental,0.3642557614707954,44,27,596,980,384,78.30545049483585,5841
cf822c9c-e66b-4e79-83bf-c557e5e1b78b,Healthcare,0.8150523864235472,31,13,677,960,283,37.43956356911346,6584
9b2c2186-ddd4-4bfc-8de2-647b5f0659f8,Commercial,0.7418695952137216,34,5,68,144,76,11.170563472665489,9889
62bc04c2-6208-4d22-a39a-9a00994073a9,Healthcare,0.26761576280250243,43,37,495,750,255,62.72400437198718,3930
a787b33d-d3d3-4c30-8a76-4e65a8854104,Educational,0.06711311330091119,2,10,277,919,642,68.30255380284916,1020
ce0e545c-e2f0-4141-a97b-bd2b1d7fb9db,Commercial,0.09134408527289328,32,26,230,301,71,69.1710682028675,7355
ce2425c9-2d4c-4751-b602-4046f2dfaeff,Residental,0.14613905862912036,31,23,203,416,213,25.665353841194502,2647
f3545804-3200-44fe-b889-82c7d6f0973d,Educational,0.7006790633529144,27,31,377,1096,719,90.38086049684539,2298
faed2225-7c71-4816-a15a-aae154eee291,Commercial,0.8314587482444284,35,45,137,1135,998,65.69211736897321,4771
62234834-02ed-4711-8df7-9b5f04e8520e,Commercial,0.7519984080383585,50,2,69,1359,1290,26.3693498532254,6117
8b5ff287-fa4e-4e82-8963-27134bfecefa,Educational,0.9152243444825737,11,30,309,690,381,48.201735020856525,3377
32c931d9-323a-4486-83c1-c62f5202978f,Healthcare,0.13518957011574517,41,46,681,802,121,95.36103471304953,2461
551d8aa3-b6b4-4677-a696-b68379d6d800,Residental,0.2069746596070845,50,33,340,1380,1040,17.938928889368608,6050
c0c30af9-1b27-4421-8a43-c36d858f6979,Commercial,0.5424369780021753,11,19,120,805,685,23.633354078541153,6988
0b095612-4b81-4f2e-838d-3ca2a388c05f,Healthcare,0.4994368479629162,11,9,163,755,592,53.02332679134435,1699
0a19dafa-e9d3-473c-a52a-7b2de965d107,Educational,0.3951583664455446,50,16,48,255,207,95.34786178247703,5899
b521ee45-4caa-46ce-aee8-0d7248744309,Commercial,0.8821781186008388,49,4,362,979,617,52.923517546462726,8561
bb9a6940-daa3-4909-82ee-26ba1f63a697,Educational,0.9802031157487555,11,36,519,1049,530,70.56386225572967,8292
212ca764-2e30-40ff-aa5d-5a1d05da45de,Healthcare,0.04382730080784558,8,47,194,574,380,14.204299662842494,7469
a61ae350-9c53-49a6-b71b-5c7de5f7ec70,Residental,0.9215771297694572,25,7,491,1235,744,25.895219549163315,5933
df52a651-0e27-4732-95c3-7cfa1c3136a8,Commercial,0.08324877875569092,10,24,234,1138,904,10.511802184602905,8357
649846c1-92ba-45de-bff5-b2f96411c642,Residental,0.9601669608055833,13,48,222,222,0,67.5165651166069,2183
e30a61b2-2197-4008-95ff-a8d3fd25f7c1,Healthcare,0.22728908966253625,19,16,413,563,150,54.03303492636172,4885
2205efb1-61f1-4f04-b8cb-89baf0ebe954,Residental,0.8290217813702884,22,45,464,925,461,77.29623128345332,9841
b4c19238-3b24-4088-bad2-f04dee53169c,Residental,0.9084077975471561,24,36,247,1289,1042,11.614962933163218,3893
c95100b5-f7da-418d-bc54-ffe56134391e,Healthcare,0.9369125832183688,22,49,616,923,307,51.472665482285905,9474
f8e9757c-5496-41bb-8b0a-9f03b5cf54bd,Commercial,0.7117005858709794,23,25,335,679,344,86.97634487171678,7113
bbd2be3f-aebf-405c-aa33-f19726bbe444,Residental,0.8832337479015294,5,17,73,874,801,39.22401918228377,1564
b0e599f1-0751-4a11-aeaa-1a3864b9062d,Educational,0.8267186236210807,35,2,56,107,51,23.724030545882854,7477
883e27b8-9a0f-48df-b874-c2df1c65d9ea,Residental,0.7373812583404942,7,18,659,1036,377,28.022487086847885,9005
998fe81b-50d6-4e82-9f69-09bcf677b08c,Residental,0.844620558450244,45,2,25,1052,1027,25.229328261279676,6912
4d7112cd-19b3-454d-b0d3-69a3b418f8b0,Commercial,0.6330877330581548,4,29,448,1010,562,35.02561562906732,2068
f031da72-eb3e-45e9-ad4a-525ed2a2294a,Healthcare,0.4990813377054426,9,28,593,913,320,72.6471609363565,6476
3ac92f26-4a74-4214-be3d-9079f08584a9,Educational,0.6999222172698141,4,8,114,538,424,85.28620449219464,8898
8483177a-9ef9-4353-bce6-ccb1c149d0ec,Healthcare,0.1215867661428085,2,22,394,1378,984,24.663108338319404,9184
dbf0384b-21a8-49ff-b0e0-d1ee871b3954,Healthcare,0.20587566182006167,26,39,466,772,306,50.91752269107511,6930
193c7b6e-edac-47c1-b716-c107ef9aff8f,Residental,0.2754540748456865,22,15,695,935,240,27.68768653766862,8541
e0edaf7f-231f-477d-89b7-a907ab9e4c01,Healthcare,0.9798757989892187,41,10,283,330,47,19.367508481992743,8139
daa4efdf-3e99-4aee-84af-65e4fa391124,Healthcare,0.9666428196567161,25,2,456,701,245,54.144729185590286,8136
e19876ad-9384-497c-85c7-c0b396afad6d,Healthcare,0.47385004646344564,14,36,13,752,739,28.050975302641483,2190
a5e05699-f589-4076-be83-fd1fb92871d7,Residental,0.792746634623104,48,34,362,518,156,30.916793092689655,7055
ec4f4572-1162-4a64-9591-d1b0aa16188e,Healthcare,0.3170245881010473,26,28,204,1074,870,31.363434767787307,2085
b22bae24-63f9-4c21-be66-543fbe1d711c,Educational,0.09395764080128766,24,40,149,485,336,46.05244259916312,7112
8f81b79e-de5e-456f-b7ea-6d2689701f92,Residental,0.8066605070613805,13,22,635,1161,526,79.56353210960992,8558
33798ef5-28f0-4516-9579-84b85f7e2d65,Educational,0.937821029916804,6,43,647,1010,363,80.63939709629084,3283
cc484c31-a125-4d54-ab36-c50623082b67,Healthcare,0.827801268825352,4,36,202,1119,917,52.503226731886265,2635
d824178f-f75c-4897-a6b5-65c62f16d416,Educational,0.7635304437810903,45,13,147,960,813,86.10840430524185,6039
c15154c2-0a1a-4b6e-abde-2b9dbcf4839a,Commercial,0.028165033236727588,15,17,509,1097,588,11.474626295748218,8352
2a0c5649-eacb-4759-b94a-811681a794f6,Educational,0.1749071206896209,49,40,257,310,53,23.75703195294348,8338
5cb30433-c26d-4356-83f3-1653252d7b14,Healthcare,0.8580567988555615,36,14,702,1277,575,67.73481630711265,5452
e4abc886-f7e7-4f15-ab85-68fec52fde20,Residental,0.19611008968416632,18,12,109,337,228,51.48971778646947,6874
9d58d026-b383-4329-a914-aaacfb223f7d,Educational,0.27611778570420087,36,34,663,782,119,26.394967217376106,5049
1d91abf8-7cf5-487a-95b5-1920ba50ab88,Healthcare,0.20520844725461085,18,46,685,1121,436,34.92699934578312,3682
a6a5af23-01b5-4674-a8bf-99022c9eb45d,Healthcare,0.7201497042783718,27,13,476,1392,916,89.89176895188147,8291
dcd31416-a90c-4dcc-9492-e024a0be90de,Commercial,0.6185726206395685,37,36,320,622,302,44.879143955319584,7952
b9c95503-bfe2-4b80-9c28-1043863324ee,Healthcare,0.21187282474792335,35,48,535,578,43,48.22968823400992,3559
c651420d-9eb7-4676-a77e-5366e84ded41,Residental,0.4183788403474693,5,24,548,878,330,56.82313780807592,3079
d13b15fd-1f81-4639-958f-b8333d7718bf,Healthcare,0.8493922525992944,20,13,608,913,305,50.09672776072763,2093
dbb48586-5677-4472-bf67-719da45f5251,Residental,0.25095192959901735,24,28,16,158,142,70.4132708655443,6659
1d133379-9ee6-4333-9537-fe5bb3e6f2fa,Residental,0.5084759984548478,32,25,622,770,148,41.14009535177431,9412
62377847-fd90-4ee8-a30f-9c2e6a04f75b,Commercial,0.5577162021416108,35,27,367,593,226,97.12186702622785,8289
bea4540b-14f9-42f0-b005-dfc452e355d7,Commercial,0.014967144297377555,27,14,84,529,445,18.133856356323804,2430
012ebfe7-8c64-4c65-8bf9-5cbe565277cc,Educational,0.6582137553430626,8,37,651,772,121,14.930366505677181,1643
4d458032-e06f-4eb6-b786-8cf75408cbeb,Healthcare,0.23687090222685414,26,46,554,734,180,24.2503845390128,3807
6dc29f5f-416e-4f45-9d9e-f77a88be8544,Educational,0.9151615310065268,27,21,616,1081,465,65.83331693488998,3620
7b9e1c9e-c560-494a-9b79-91dcb2baa4b8,Healthcare,0.19557110326699845,27,14,149,261,112,19.910397669832637,3547
57d963fa-1904-470c-8d29-26b34eda4aa0,Educational,0.4340963214736506,26,15,618,867,249,72.76799854911714,2566
9c4e9cd7-e294-433a-a8fa-b6830c452e38,Commercial,0.14383162459180843,49,16,687,1292,605,25.311829691176207,7634
b4ec63a3-c009-4647-afa0-4721e0740011,Commercial,0.9532479686459316,10,44,142,884,742,84.95923780147622,9131
bce555ec-429e-44f0-b261-6770b561c744,Residental,0.913507522810428,38,35,216,1222,1006,20.057048402567574,1368
f43da226-e89b-4096-b5b6-e3fa8f47d122,Healthcare,0.734324982560597,45,26,96,713,617,70.55450905025685,8076
f5513465-4dcf-489d-83ab-040babe93722,Healthcare,0.9642504431733278,28,48,238,1099,861,12.279291340625036,3463
2a511620-5b30-422f-b03d-9f6195ed0cfb,Commercial,0.979058223880345,43,43,686,1205,519,94.77170763244227,6392
25b7937a-bb2e-4d72-9c63-39ab2f507fc3,Educational,0.8451681337922207,7,12,666,1164,498,40.09042491589521,2124
fb772451-a445-4075-a6f1-6ebc3051291c,Residental,0.9782507028019432,49,33,212,1184,972,28.551678705028806,6345
636edbac-8714-475e-a4ec-9c907d7cf2f8,Educational,0.338375990959635,10,2,158,271,113,22.65841032576244,6664
9f0d0b40-71da-4a2e-ae18-0ebe612de186,Residental,0.36837028647199366,16,5,555,1114,559,72.42504156041068,1726
df327ee7-b05a-4566-b318-6d8ebfe2dfc3,Residental,0.26784475577926947,31,14,438,589,151,10.52343947531349,7986
9ce4812c-3535-44ba-8e1a-ac2501477e02,Residental,0.998463783525668,48,45,383,554,171,63.474809703400375,4590
c227c2da-cfb5-43a4-9b8c-cc9c21c316ed,Healthcare,0.7835946560574032,38,26,169,1405,1236,22.60493187988975,4837
e8005f78-b74a-4a16-b07f-801bd11cfb5b,Healthcare,0.8156562133389179,39,1,395,563,168,69.46625112563729,7178
0ebdaeb8-5c28-48b6-aa27-82d2a5eb1987,Commercial,0.11660454796638331,38,10,487,1297,810,39.29110723129004,8066
64e7a28e-65c3-46e6-8dc9-ee4b359223de,Commercial,0.8866014436949788,40,17,451,737,286,18.30836427827996,6720
3d132323-6523-4801-9389-cca7b3a4e5c4,Educational,0.8916723665303574,10,15,473,1182,709,99.85570022272682,1600
2185eced-5d71-442b-ba38-a7578eda5d98,Commercial,0.8944586143179144,13,24,120,606,486,19.694447748996467,7160
d4423ca9-4c84-4d33-985b-f773b086de01,Commercial,0.4819620306715159,17,9,182,697,515,38.77609868073169,8332
38c295fe-67f4-4f3f-867e-1fece3087f9a,Healthcare,0.5970116117653087,22,5,661,1322,661,88.53312029885358,6006
e9a7a1d6-1264-4961-bdd2-a569acc19d30,Healthcare,0.26888699543000294,48,35,627,1218,591,38.189001251485976,7896
d853182f-81a7-4d38-81a3-d1d2d443318e,Healthcare,0.2541550222414264,38,40,133,1370,1237,94.84599098648397,3142
3d971e6b-2f8e-425d-9cb9-0c2f79088ed5,Healthcare,0.15938111035468328,42,32,419,1187,768,24.721077264791223,2030
7fddfc40-19a2-4633-8266-747980791f5c,Healthcare,0.890152864890173,18,12,71,367,296,60.842796957817825,5050
bd8a6930-bf80-4737-acb7-b614374ae520,Commercial,0.8463374484034359,39,2,172,182,10,61.24050437203402,3825
cc5d7cf4-191c-454b-a3f1-798d9797ab1f,Residental,0.6663407328133178,10,27,599,788,189,94.00485871167031,8800
c0d06d50-1394-4578-9d5b-52c03c7b9588,Commercial,0.7257722018558225,45,49,280,1032,752,51.21899313998052,2735
1b356a28-cc10-471f-970a-18f0d3edf934,Healthcare,0.7414798808458778,40,37,426,890,464,18.968934916646596,5652
c0046924-a389-415f-a003-1de461556dcd,Commercial,0.02951637902528992,43,48,628,1377,749,51.63511154155207,1735
888a35a9-da8f-4f4d-9786-08305f27e945,Commercial,0.7892806303975806,1,49,306,952,646,18.080362648334166,1763
ee52a0db-60f2-447e-a04b-eff499689128,Residental,0.04050746288420837,21,24,118,180,62,14.072808557003949,9095
b66d026e-a4ae-4578-976c-d1391a7ea1d1,Commercial,0.25413836040639626,16,10,506,572,66,57.07706226088455,2284
9c4f18f5-8b78-4b3a-9865-e72957e26c80,Residental,0.9536518915763221,2,18,501,784,283,48.641196362198926,5865
0cac5664-6fef-41e3-b99a-f29109be728a,Commercial,0.7590591659813724,2,11,495,580,85,58.641576823316946,1311
49386daa-5547-4733-823b-2ada237d233d,Healthcare,0.9388587318039467,43,21,43,728,685,80.72213923947172,5714
c5c9558d-6abe-4ec0-9fbb-fc0731ea9adf,Residental,0.7362117768631282,6,22,295,722,427,40.32147914185813,5089
3ce9df83-81f7-4019-85cb-fe3f7638dd88,Commercial,0.8244152924168258,46,34,425,1048,623,89.61061288212849,4403
bab64318-79b7-46db-800a-96652ff6ab82,Commercial,0.7603243817695199,10,42,431,1295,864,48.57657864422312,4804
29b4124e-15fd-4397-a9e1-c7ef81ceb4b1,Commercial,0.21261248199356464,30,41,676,984,308,10.058488840116546,6341
54c64681-2e04-44a8-ab4c-67636a43faa3,Commercial,0.974974586034953,19,16,619,1142,523,66.10802245688238,9902
333cca5d-d432-4f1e-b6d6-a3d09a59c1e6,Commercial,0.44911205690509415,11,42,705,984,279,54.04164793984413,6372
ca0ba168-da8b-4cb6-a06d-0aa0de1c159e,Healthcare,0.6708944835374654,15,11,650,1242,592,39.0451903006866,2596
986384f8-9a1b-4d95-abc2-f30c6bba39a5,Educational,0.7469445111850245,37,12,619,950,331,62.14163816836383,1082
9da9f257-5093-4540-84d1-5f2bd879741d,Healthcare,0.33134221503765016,10,8,283,1194,911,10.773172386775032,2398
3d20bd15-b5fa-44bb-8e95-45059b0d5585,Residental,0.8905401135122171,43,22,44,868,824,39.14425299345837,9064
269bd820-2157-4238-bdd4-e4286aac85ea,Healthcare,0.16525640837219135,30,28,379,577,198,21.908437256368916,8372
44bc6691-aa8a-4f27-b26d-7e75f7c40861,Educational,0.1257683910543268,24,48,391,1429,1038,12.18912007109375,2833
8cb509f7-c436-42f8-bb85-a3c6c20eb416,Residental,0.4663222436401384,35,10,232,272,40,90.12850190720378,9952
74af188f-fbe6-4628-b147-164226b31440,Educational,0.5228513755683615,17,47,604,686,82,65.85385396147814,7239
0f4ea758-b686-4824-960f-748647e68cfa,Educational,0.5866563896519146,15,47,323,1010,687,89.39701784228272,5879
ad8ca2b9-3b9f-40d5-a2f3-8310cb4ff3c9,Residental,0.2798667088193151,2,21,501,502,1,90.68619119781033,3102
193c7290-a68f-4e24-947b-597ee06e9d61,Commercial,0.6668511026403792,3,28,543,670,127,33.3517078777068,2333
b7dc0402-c784-4892-8537-b4e35660a6b2,Commercial,0.8324791775611072,42,12,671,1368,697,80.27453319803662,3464
72efda5d-8139-4a4e-8b9b-70bd7b03b20b,Educational,0.8934269485217129,50,4,586,726,140,31.17521496121776,4306
80df6cbf-71ff-4371-96b5-b4261cdeb3d2,Residental,0.2669027915908818,32,27,336,973,637,79.35367919734485,2923
7e7426bd-33a8-4f9b-97bf-7341a571c9cd,Commercial,0.5758326745167579,31,46,443,661,218,19.85487392729129,7542
280beb3f-ad87-4e46-9069-1fc4d0f90667,Healthcare,0.01582170087526491,49,44,613,1111,498,73.40907513171231,4540
8d1370be-66d3-4e28-9d53-f6c002a6f4e3,Educational,0.8191400268797262,4,13,51,1402,1351,74.43402820107748,8474
469faebb-4fea-456f-86a9-8cd8189414ef,Educational,0.5301412554050371,42,42,329,1422,1093,61.745779385793696,3524
dbb70a70-287d-4c3c-9ef2-912a81be1849,Educational,0.8611264003574146,3,25,374,404,30,31.56141018283805,6334
742e9e78-27f9-403c-9516-4ec3df948da4,Educational,0.1995096394762471,30,49,531,1218,687,70.8348981197877,3979
e7c8a6f2-12fc-4837-9b22-7a9ab879c110,Residental,0.4303147436411663,13,22,610,1244,634,31.811423216103805,5713
90a93a84-a51c-4a9f-be7e-7d48c0bff9f5,Residental,0.750077681166622,30,3,154,904,750,74.9191689607889,9131
15d9068f-9743-4726-9582-94e90fce45e9,Commercial,0.9754500321090324,50,28,480,685,205,75.59787218852144,8122
2475f072-c97d-468f-bbf2-f59c70ea3139,Educational,0.11597769316930795,40,27,117,597,480,66.74800537984842,1874
5d1c59a3-bf40-4483-a4b7-b16b5142e62c,Educational,0.5367759342450018,1,9,55,895,840,68.27357751915531,7175
0653a6e0-dbe6-4201-8d24-03eee5674e2a,Healthcare,0.8049430920003692,29,4,290,1433,1143,61.91849491092548,4823
1411f4f3-e4ad-4759-9a64-5fa4df7c399e,Commercial,0.5284223392460206,10,45,444,1381,937,71.48911185711066,3326
9fb95c16-2b54-4283-92ec-9bafee20c961,Educational,0.8954398905159145,34,44,32,1186,1154,96.81765631810941,2360
3c2c244f-ab36-4977-8918-569e6999ecac,Educational,0.10544752256964962,34,1,177,977,800,43.53489892292344,6845
6b01a86d-42b6-4a7d-b143-88224636adcf,Commercial,0.8036942628772724,17,29,14,1102,1088,47.72772270934675,7359
c97519b7-710e-4fd4-a5cc-879d0d7eb663,Residental,0.21500899378405514,16,7,685,955,270,96.1633587434185,8342
307f0ca6-073d-430f-afdf-a62f4b7323de,Commercial,0.9869402929314747,3,15,115,871,756,63.28697471978866,5109
1b3dc839-7924-4460-942f-989462f42b87,Healthcare,0.8386574677351771,23,24,637,1083,446,22.015328021153575,4636
1ac8fab6-ac0b-4a5a-a0ad-4549048a60d1,Commercial,0.8433356280429263,39,42,2,1023,1021,48.03919206318668,2050
1ab1acc4-7b04-45fc-9e92-ea4e9d88fdc5,Commercial,0.6038662790775832,43,9,131,898,767,42.64855847305315,8042
d5dfc4d9-667a-4ae2-a66b-150db85b6bb7,Commercial,0.07662046985101889,20,16,549,1341,792,88.5161095792273,6484
8aa5acec-b49d-48c3-b3ff-dc84d12d3747,Healthcare,0.5444433137467539,35,13,687,1126,439,41.9608635759997,1415
31259690-e0ae-4c06-b984-ae1d39e33559,Educational,0.26965345034402133,25,23,617,1222,605,78.20619699595383,2729
23a5cfce-a8d2-4240-ace1-50d0072b0695,Commercial,0.24422251087052504,49,18,209,1280,1071,50.726673883604015,8318
0ab22641-a76a-47a6-bcc1-08e20bedbf7f,Commercial,0.5086761056761318,19,38,15,196,181,11.225643014230464,6891
3c013be5-ebd8-4b6d-b191-c83af5a52884,Residental,0.7208713551150661,39,7,494,1064,570,50.93440904487893,3679
a55f1492-63b4-49b0-9658-df7049c68cae,Residental,0.6757291599874131,34,45,672,1349,677,81.50222977287504,4817
ad87c2bf-bbb5-4419-81c1-a1439785fe4d,Healthcare,0.5105772185805004,34,29,440,1037,597,87.5393145801542,1952
891d4f69-4d12-4677-a686-7d9c4ed26f13,Healthcare,0.9043098656829148,6,18,602,982,380,81.20749494842048,6950
1a773a53-9cbe-4d23-ad36-5c71b85325bd,Commercial,0.7317238723506326,19,32,538,683,145,70.12681932057939,3580
ae7af387-870e-488e-96ab-a355bf8ec64c,Commercial,0.1393270608017364,44,50,32,1069,1037,69.98687748952479,9409
6e7d0ea3-94fc-4dd5-94da-015d5a47307a,Residental,0.37646623081300234,35,45,94,251,157,98.60246482954754,8536
1c7bbe2e-9438-4e3b-bbac-f58b1d6d3373,Residental,0.3771879002743054,38,7,409,1359,950,88.71771932880856,4249
d98259c7-48f2-449d-90da-622355fb4e60,Healthcare,0.6244501086287746,24,8,25,309,284,49.72235041366515,2793
20b8a1b8-5d67-48bc-b9f9-bfc5e83e02a3,Educational,0.29507500108340057,31,27,487,1237,750,31.190486917196235,8201
29903331-a254-478b-bb53-2b613227339d,Educational,0.5104262720964182,33,36,490,1332,842,68.39945310032942,2302
77e84081-39df-4e60-92dc-98a8e73cc767,Healthcare,0.05175401204612551,33,7,115,1203,1088,11.250494728085293,9601
94bcb5e7-fdea-4f1f-b875-92fd68edf436,Commercial,0.5580570828808038,26,13,171,620,449,84.66276927592926,7955
75e709b0-6524-420e-92c1-fd44e9a0df3f,Educational,0.0028122698047849948,16,36,719,865,146,90.82053773459714,6121
2809eed5-64aa-4449-8173-ba515f7cbe78,Residental,0.07916732552377592,6,25,170,762,592,32.29639128469661,8469
8f0408eb-06a3-480b-9b66-c28b680fda32,Healthcare,0.16729052031464853,19,3,110,1419,1309,78.84896490389704,2348
a56a9532-2533-4522-8e7a-6b21ebae5c22,Residental,0.5605132866561274,44,4,456,966,510,36.7762741260229,2535
9ad324ba-2657-48df-9834-fc935bc5b9a6,Healthcare,0.7283695015880957,33,47,78,845,767,92.80134642538025,6084
0ba1c04d-aee7-43ff-89f7-619df747ba91,Educational,0.687601507786199,2,20,529,1281,752,80.52213883104827,8282
43d110e6-4b2d-4a37-9a3a-977a06442cbe,Commercial,0.04382163945070261,50,31,261,538,277,33.285714463116406,2985
f54e210a-68b8-41d2-9be2-16e473dd2c44,Healthcare,0.3222341233491476,50,9,13,1178,1165,13.587763659538574,3608
04c2f035-97d3-4994-9263-cc67a7c2ea92,Commercial,0.49747371355861714,10,21,573,933,360,68.355373426216,9358
ea706369-42b1-440f-b1d3-9b13da004bad,Commercial,0.46273545483653145,37,29,659,1296,637,65.38221837848822,5707
64cf9c2a-f20d-49e0-ae4b-2557ab044a34,Residental,0.164958539254229,12,12,168,839,671,63.71915834361046,7275
9587cd11-b21d-4b8d-8d8b-fe4caa4b575b,Residental,0.49429230700982696,36,24,176,978,802,54.42501489929453,5792
213ba419-d214-4cdc-aa48-508ae8a90f22,Healthcare,0.4484686610535076,36,38,463,812,349,31.771936408962492,6759
fe756d8e-41d4-4444-adfe-8c9be3ad6b05,Healthcare,0.5626394797652773,50,47,581,699,118,85.4208794288067,6313
d0851cde-48f1-43c9-a5a3-cf9069403d3b,Residental,0.10750673576927683,38,21,682,1216,534,52.90425175227334,7905
0c411762-72e3-4ed1-9ae3-a83c22128ae0,Healthcare,0.45907329856936785,44,18,233,925,692,54.95327205113383,1000
56a3ee88-e7ca-40e5-8388-d50f1d32ded1,Residental,0.8876020377700227,45,4,522,676,154,90.54473766988295,5793
7c61226c-8289-493e-8742-3fb7c5ba58c3,Residental,0.5807602162987082,8,31,243,1293,1050,95.06128510082311,1158
4068a0f4-bf79-408e-9555-908ef3ae3a83,Educational,0.5416939083059267,49,22,163,1078,915,85.38125845033949,9407
6ada3765-17a1-460c-b68f-73c89433c604,Commercial,0.654701175870143,38,11,25,1194,1169,54.38026562988911,5007
60de7714-776c-4007-b0fb-27644f13d972,Residental,0.24019478610355816,37,3,700,1349,649,29.528105537497197,5702
2835fb92-11af-4703-8fa3-d1f841f32091,Commercial,0.7652551412403681,3,9,55,1122,1067,90.37373900196484,9557
ec4901d8-f26b-4543-9ffc-69287966dce0,Residental,0.11794681819689545,33,31,375,1039,664,83.86912045084735,9387
9a38782f-06b1-402d-94c9-4f83a68a45a5,Residental,0.8688373136520601,21,11,303,1386,1083,96.51709115272753,5593
90e52757-b556-4b5a-a72c-004dbbf8472b,Educational,0.5824921471845474,31,49,518,875,357,24.982833061444957,2832
d0cdb133-ebee-4dd6-b21c-2d10f64db245,Commercial,0.671419248199189,3,23,376,510,134,49.84210170382133,1931
c48d0ae4-634f-4b9d-98ea-c228e31556d7,Residental,0.8911363693957297,30,1,707,760,53,70.9548065243637,9583
3f2695b4-64dc-42cd-8aac-bb54c6e70e2d,Residental,0.12149254069441828,48,43,37,896,859,46.066233527295694,4696
82c0ee2e-cb03-45a7-9464-575f18011836,Healthcare,0.7148579790243674,14,20,415,946,531,55.90574032777086,3798
3dbceea1-c22a-42fc-bc37-296ac070eb04,Commercial,0.7395240630407328,9,20,187,734,547,41.91170187411698,6501
3b6f3feb-c8e1-4cbf-b7e7-93c56201af8f,Residental,0.6579585573884934,29,5,62,1384,1322,18.053969484295223,1683
839734d5-1e35-4b05-bc5b-96e3f1bd23d7,Commercial,0.3426709737950666,7,47,392,806,414,68.93005545998494,6702
655f4234-d0d9-48fd-b480-19e710f478a3,Residental,0.2262218145841789,8,22,494,1280,786,17.215699915771676,3104
3cc6006a-15a0-46f4-8450-568dcb6d849a,Residental,0.8544916506791846,49,30,309,329,20,20.005756963617625,2965
a7a1fae7-d1dc-4bd8-a221-fe42056885ea,Educational,0.24924016481129674,40,46,297,303,6,18.502594451267164,6863
c6dc8d9c-03d5-48a8-86da-de90a609e547,Commercial,0.9112855882113002,22,5,588,1157,569,29.76507904802947,3393
eaa4503c-7ecd-4bc0-876c-d3b92e645e5e,Educational,0.5175622398468535,38,38,672,1351,679,98.97070850417597,1564
efb19310-e6dc-493c-8990-6f4fd9814b2f,Residental,0.9349563460513248,10,29,148,754,606,93.2560164813466,5710
2acabc6c-a2f8-49ac-a4e6-2d2bc2bf58b1,Educational,0.09440671650728139,10,39,398,840,442,35.0167940323818,7966
6c46a85b-aba7-49a0-9f47-3639a2081163,Residental,0.8238655174210919,3,8,524,1426,902,15.546392512638104,7132
9753bc7a-984a-422d-b998-0191834aac30,Educational,0.4856194804716304,43,2,462,562,100,33.46532876253208,2601
276c3b17-28ad-4a67-bd33-f941a08decf1,Healthcare,0.2809959644016413,41,11,370,1264,894,20.803144318183474,9564
8e4e551c-98d7-4160-a68f-7ed63221ec7d,Commercial,0.4460431133790814,37,43,437,1145,708,53.46450248526097,1245
c4068a65-7329-4bcf-899b-f18417fb85aa,Educational,0.6652524855605159,35,34,651,771,120,36.75653537956558,9199
be13d8f6-64e4-4183-94c9-afa318118d90,Residental,0.6551801710626964,31,27,364,834,470,23.969383139056248,4473
91c501ca-7eca-414b-80dd-b1df680e75ee,Commercial,0.7942334329689661,21,15,640,657,17,88.65185365370851,5987
03a93efa-d34c-4622-9378-6835d9dfef1c,Educational,0.7917851230112904,17,50,616,893,277,89.43106992421437,3353
8825006e-4b9e-4c98-ae2d-d3fbff772afc,Residental,0.9806496219960653,35,4,141,976,835,62.633438716503704,2793
05eadfee-d710-4cec-952d-61d288c2d213,Healthcare,0.10893149255703949,36,37,152,1204,1052,80.70648730498708,8540
634b8710-7ea5-4d78-a1e2-67eff0fec0f0,Residental,0.7141128920429808,33,22,307,546,239,80.7538167321024,9865
b121b153-25ce-44e5-ada4-1e0b0d0cf979,Residental,0.5053503615802531,35,42,545,673,128,94.99697913831535,6923
68feed0b-9d77-430c-ba8c-5cf7cafcda1c,Educational,0.4519297792307446,5,2,266,651,385,86.17291509397151,3197
33a61f1e-effd-4565-b0dc-97b30993482c,Educational,0.6974645357864164,48,30,121,293,172,55.554231601367825,2796
5829eb13-b853-4129-83c4-681638d486f5,Commercial,0.42286960150571506,28,9,636,1199,563,61.37793054456048,4750
a132021b-0498-4bbb-928e-de002fdb6440,Healthcare,0.3560302955730902,44,7,125,1169,1044,17.222951942531363,9177
44484a39-ec64-4982-8fbe-431acf87baeb,Residental,0.2661530619864201,39,38,421,747,326,61.18428913395801,1331
f73d63bf-652e-4b4f-abc3-f55f8472eca6,Healthcare,0.8003481300547917,9,46,163,803,640,25.589514655010937,1656
c6109d70-06d0-4a0d-bdb2-6ef720c34802,Residental,0.39040536651304425,46,5,167,1381,1214,52.58636371096274,1071
2dad7a52-8e9c-4c9c-942e-249c1864d878,Healthcare,0.9386197640255632,48,26,323,663,340,73.38302103597002,5747
1052c92c-b302-4e3c-a7be-69c3185443b8,Residental,0.4795512760155526,44,39,428,874,446,57.1142573042325,7072
bb8e870e-19bb-44fc-a996-706b1e1822c3,Healthcare,0.9964561885745539,7,2,338,963,625,29.75220206563199,6365
2925b8e7-d7a4-49a1-bb39-fb5a9ee24cb7,Residental,0.32806700794996535,28,29,364,674,310,18.346348981364166,6095
648c7bb0-e448-4414-afc7-2fcab807e72e,Commercial,0.16037149254158056,34,42,1,586,585,40.13421999011497,8707
08e4423d-c262-46a2-bb8d-42e0ec7d36de,Residental,0.6295354771817671,32,15,219,834,615,72.87881118510394,7293
479424d2-f56c-43d4-9f49-4563059a4534,Residental,0.03179017689859143,42,41,554,901,347,80.1256992286911,8301
f9ae775e-0e31-4d97-a571-895d59724a34,Residental,0.03169500123508162,1,37,422,705,283,91.92765002156848,9759
0c7b28ba-0559-4b1e-9280-f8eb528b1d0b,Residental,0.9960887593071239,12,33,120,438,318,48.11242756207402,1424
5c93cd49-034d-4ff3-99f2-7fb76ab40e8f,Residental,0.5200794298547233,4,43,436,569,133,86.60112224837778,5031
91b54f10-6d1f-4f60-8ede-c5ebffafa3fa,Healthcare,0.4272983577377948,21,32,576,920,344,95.14380383214818,9553
4fe726f3-b137-47b8-9db8-42ffe4fe4979,Residental,0.46090982619741316,15,17,22,527,505,45.79496213533321,7720
f724598b-d427-4e2b-9aa1-835ea163dfa9,Educational,0.5671594009410982,34,42,44,1404,1360,38.9513294290654,1621
2fee0db8-aa80-47e6-a9eb-cc79b8655950,Healthcare,0.7096822103513993,47,4,389,768,379,27.713744947958343,4568
155e6548-ab35-4ac4-bee5-42f0becab8cf,Residental,0.7873469981263449,7,17,698,1065,367,80.89673723846644,2256
1515a451-cc40-4b1f-8470-07c10166efe0,Healthcare,0.3389362049547785,41,24,720,1116,396,42.22496080608001,6527
6a401077-5633-41de-b135-9e8d790a6718,Commercial,0.06237568324521703,15,44,365,944,579,55.58614124242494,5003
81d80abc-63f6-4023-96dd-f6fe77707001,Commercial,0.4175623381095167,50,48,633,717,84,19.080227908041493,6394
295c8c21-52fd-43a1-bf59-ae8185c6bea6,Educational,0.41065790894833254,8,9,646,1292,646,40.13738235937978,7242
d702c2cc-1337-4e9f-8c7b-5618b71c7d77,Healthcare,0.8913078608419134,35,35,247,1020,773,62.334922957761925,6985
c35394b3-ac84-4cfb-b75c-a7be14b7efd6,Healthcare,0.8420315136897719,43,38,661,1426,765,78.12447040589831,3894
30ea3672-fff2-4604-b9a5-41ed5d22a500,Healthcare,0.796999420714292,41,49,198,327,129,32.623651572392916,2118
1f6e0f20-a30a-4b1b-bb50-fa949e4a39d5,Educational,0.7658976104768245,34,10,60,640,580,90.28249539405807,3634
660e61d5-5d45-43eb-8c78-f3c1caaff9a6,Commercial,0.3945853812438096,27,45,23,787,764,33.93827298051574,3358
a19fb9f6-b192-406d-a6e7-c8eeca781c70,Commercial,0.16995979532313632,45,23,373,373,0,42.089850779359345,9902
b92aff1c-9e83-49d1-96c5-7c2bdab2fbaa,Educational,0.08750130353414665,7,43,303,1174,871,50.986639783746746,2422
afa11c03-439b-4a80-b921-04e7692a9351,Educational,0.7895939689858922,32,13,164,1235,1071,75.6325685196353,4349
109aafe3-e8df-4df2-8872-655248b2af3c,Commercial,0.28336894790772893,9,45,86,179,93,99.45734786915276,6111
3fa1812e-cf51-4934-af3b-ae394aaf8a75,Commercial,0.11923349217290125,22,4,147,493,346,72.53147249420684,7801
6e7536aa-4500-4922-b8c5-2662c380267d,Residental,0.894184512229081,28,5,541,1115,574,50.29278294081564,5238
ff4e68f6-ac9b-406c-adcf-635e9dbb9963,Residental,0.36666879494600857,48,24,511,1144,633,22.081266058190177,5414
b21229c6-4956-4c6d-bdc3-21ff2efb1baf,Educational,0.7490400203416795,39,31,48,316,268,12.001250253019476,5815
29b835e0-610c-4893-9b69-7e5aa89f18bd,Educational,0.8735145827912996,40,35,591,1428,837,91.43565787968578,6026
fc670094-17ff-444d-9229-084ce399bd04,Healthcare,0.44924804768369364,37,15,564,1250,686,65.9754957085348,6448
f700b6c6-e97f-4045-a92b-58a9e9b7f159,Healthcare,0.32331043338381027,17,43,419,1233,814,82.66813520490335,8331
a6a011d3-ad12-4895-a39c-3a108b55e259,Residental,0.1739786915734779,30,29,223,782,559,34.41464699591434,2004
b85dc80c-2eec-44a0-b2f6-0bfe15c5ed71,Educational,0.8059867538750042,50,31,170,173,3,56.55132556370396,2977
0f493bd7-14b6-4667-b3ad-e3f179e33c77,Educational,0.8916993991062906,22,41,90,266,176,70.3470061641161,5022
1c9ed70f-7f9b-4ead-9c2c-f8f8a9ec36dd,Commercial,0.7341177193126113,11,22,703,724,21,85.33739352390852,2609
25ffea9e-576c-4326-8aae-42e65749c1d8,Educational,0.3641700197979112,42,28,83,900,817,96.87680419637097,6924
7a8ac45f-7398-4cdb-94d0-d081e9bd7c3b,Educational,0.7641268252464405,41,50,119,184,65,49.703428192242775,3993
1750ff74-4a55-4d03-83e3-c63647312d43,Residental,0.5618440712776411,26,46,229,912,683,84.88383525573258,2701
0282f6a1-eab6-4394-8921-66f708aedf3f,Healthcare,0.4061814345245657,31,32,417,1113,696,20.592156962823324,6717
aef195b1-8edf-435e-a007-b2d6deb08f51,Healthcare,0.5135415668745748,14,38,74,647,573,87.47934249334973,3342
2f47defb-ab31-4fcc-9b40-e4ba4d4f0c1e,Commercial,0.04641938536984613,17,7,415,591,176,28.90833918015502,2793
397e9ddc-4c9b-4e0a-9bfd-af7a5bc5673c,Educational,0.23679162900504536,18,25,366,494,128,89.37984398536602,7366
4867047e-684c-4a48-8cd4-1954a2acdeab,Residental,0.6285258822622777,7,11,499,1176,677,44.561795966152545,3063
64cd1835-3728-4d45-a673-6ae50b4f3377,Healthcare,0.8848031038562924,1,39,618,931,313,98.8222644049498,1132
e910f817-65c3-40e6-b84d-de9bbf03a285,Residental,0.6718526421573195,42,24,109,841,732,87.12334689448485,3863
e4084530-53b8-495f-858f-83734d8a052b,Residental,0.9877572901288791,5,18,37,378,341,44.21580991021612,2163
30e4be21-be0d-4118-b53e-1228fdddc5c5,Educational,0.17610721839046162,15,3,250,667,417,88.78296518071399,8695
d5561b5e-f87b-4355-ba3d-a670e84aae1e,Commercial,0.9509247112105839,45,32,691,1344,653,68.22946747284396,6034
7d8bff76-ea43-4ed4-80d9-c51b9063eadb,Commercial,0.5848300515840635,39,33,491,860,369,11.940674636034526,1330
95eec4d3-41ae-4e6d-86a5-3391f5015492,Healthcare,0.10867191601605752,36,10,172,626,454,60.47633911785508,4615
e1bc13a5-8348-4a3e-bf75-665c8a9f3958,Commercial,0.1405774915315039,32,22,559,1037,478,49.07408074046379,1442
54a7bb59-b5df-49d3-8d13-07b9d35af687,Commercial,0.15485718250901026,1,46,589,604,15,40.843320030563646,3856
a52fb5c5-e500-4020-b532-26306af2a2f7,Residental,0.5542608540916143,38,12,387,1051,664,11.64178971357943,2813
c10007c3-2b39-4a7d-88fb-fdf73b38548a,Healthcare,0.9398362082425262,21,32,577,711,134,61.25296575012407,6139
be580355-9d7a-4ce0-a52b-6c60dee78597,Commercial,0.990180567297569,45,14,418,608,190,10.435115396682901,8984
09639f52-e1da-4e51-a583-33d7cee215e0,Residental,0.9192673122787075,10,19,399,501,102,41.20347728722919,3871
5f5b5350-a0c8-4de6-8100-74b4f832e076,Commercial,0.84341427362714,5,40,610,859,249,13.438325572459643,1060
70b3da3a-541f-4c28-8a37-362657bb0610,Healthcare,0.6213013955314602,21,15,560,598,38,52.860098059704114,4292
8d4c0126-a023-46f0-8007-4ea02ab72c71,Residental,0.9507031295800165,31,22,562,1084,522,28.48674481254726,7333
46a7e204-d391-456b-a12e-76cf6152ba99,Educational,0.1958065148737883,19,16,65,1340,1275,56.77005633206368,8924
1b6c46c7-cde8-4c37-b4ac-53f67dd529c6,Commercial,0.9864027267401496,22,27,459,711,252,90.2943972340834,6369
01f26cd4-8513-4c6a-8495-b324575bf51d,Commercial,0.7730534642740035,42,27,112,571,459,28.21205810110984,3354
19574696-552f-47be-a9d1-d21da24b534b,Commercial,0.7483921557948832,20,16,577,1045,468,93.22467885433154,7852
2e52455f-a2a9-4d96-bae9-def9e46312ce,Healthcare,0.022709170717883365,36,38,375,986,611,89.93548428780505,5756
555d484b-0dfc-4651-97bd-798809ad1aa9,Healthcare,0.8696213023961232,19,4,308,977,669,61.61777501701278,1518
bc426f58-b737-4e5c-b140-fea221ba470a,Commercial,0.8597975480329816,22,43,469,559,90,50.042837561980484,3028
5a616236-db08-4aa2-8433-0d67db36378b,Residental,0.44465238735191526,46,39,457,943,486,82.78640102533883,3518
d290004b-4242-463e-8cd1-bcdd6840f0e8,Residental,0.21136904487874697,34,50,608,1066,458,84.24473859652042,8660
b873844e-4a0d-4268-bb2f-bb93b20f3b11,Educational,0.38216474954686286,20,30,92,173,81,75.90823530123139,9176
9ece68ab-142b-47ee-9e6f-017822fa59ee,Educational,0.8484159426475156,40,43,133,250,117,95.34516827228549,1360
df537d49-5459-4aa3-82a0-15b1bf723e9e,Educational,0.9840758182142366,36,10,127,1116,989,31.18370644054392,7216
62732386-e14b-4fe6-a8ec-ed2d3cf85e5d,Healthcare,0.2915973174227309,35,20,352,1374,1022,34.91061842997043,4120
541fdb8f-a0f5-413e-b7b1-c728f1c7e72f,Residental,0.3465735065047234,40,37,631,1370,739,54.676019571626874,2290
413cf708-ca72-459d-acbc-a6a8dc6c331d,Healthcare,0.9744544794095906,13,12,84,218,134,85.11251299947665,1911
39b81f85-05f9-4f05-be2a-45d4430047ce,Educational,0.16557127685789141,17,1,113,193,80,30.91403105805136,7434
9e6187a1-62f3-4954-a63c-10c83e34fa00,Residental,0.527056371139269,45,15,667,1209,542,43.17892086710097,8123
dc323204-de9f-46eb-b29c-e939bb81aa29,Commercial,0.1412009407224467,9,26,78,1141,1063,44.9550944839699,9206
844b514c-19fa-4531-9a89-8cf1e5bfb60f,Healthcare,0.23912916623905567,9,48,260,594,334,92.31362805565733,2934
0ecbc481-c36c-4ede-b9dd-513114de1003,Residental,0.48906704294214665,28,18,553,1280,727,65.20403273453925,3945
c4555887-bc78-4598-8f12-d4e8805b427e,Healthcare,0.37049715093724045,35,36,62,1092,1030,90.27421563191777,7247
9a3e143e-6c4a-4496-8fb2-298806d6d7c0,Commercial,0.9741667825340004,33,32,465,1182,717,42.02161983481358,5570
15757848-a249-4e61-8eac-614ea94185f2,Healthcare,0.4851958884975157,45,29,475,1267,792,85.80835356675793,6266
3640695f-25f9-422f-9c05-7fd137828265,Educational,0.787209996784142,37,20,333,1249,916,59.42607547061009,7944
c36cfeb3-25a5-43fa-8898-b336c48d0cc9,Residental,0.8381093880814485,24,41,352,629,277,76.85729807196347,5006
d2de44ac-939e-40a9-8090-c70e706fdb8e,Commercial,0.4817844076359149,34,22,125,1218,1093,62.313194065339154,6638
173fed7d-503b-4776-88b8-fd14dc88b48a,Educational,0.21028577274846982,19,23,374,766,392,65.6642443971283,4175
60f3ff48-8dfa-4157-a08b-c23e13922734,Commercial,0.9602440532109594,28,27,161,1334,1173,52.507009490431024,4293
65b77abd-07b3-4e14-a101-7b1d0eebec65,Healthcare,0.5403694343201876,20,15,216,552,336,21.650443632354744,8242
6e4302cb-7001-4102-8cc0-51cf90162814,Residental,0.6003476231939289,39,29,185,1236,1051,11.742879954318722,9588
c53547ff-a447-4dfd-85db-6b1e4e614485,Commercial,0.19392277882174414,2,23,711,849,138,10.373393854155236,2330
78d9eab3-d9cd-4f8e-aacd-507a8060e14a,Healthcare,0.5463412556683385,9,20,659,1182,523,25.701813484664285,2460
8f3c5e6d-8c09-4602-88a0-76bc77c6fa71,Commercial,0.7407193169843536,42,50,520,668,148,27.618280782520905,5425
37318069-9cdb-42d5-8443-076621aacbbe,Healthcare,0.392179039999483,47,10,158,1183,1025,47.11646132574812,8245
96e85861-d116-4ad8-a136-94a63feb55b7,Healthcare,0.305866199285319,20,3,261,1169,908,17.167927336594094,3031
6d763fc8-ec2d-4c3e-ab75-6eb29f1708e8,Commercial,0.690847710025159,44,48,679,920,241,12.483087831514451,2821
ebeb73cf-7061-408e-a826-a02ea3c6189d,Commercial,0.2885325949645413,15,35,174,1233,1059,35.33883995405765,5672
ba0a9f2a-24d1-4a16-b7a5-7682b12c47ff,Educational,0.8741483340192973,4,35,486,1154,668,49.94931497303349,4338
87e54400-6ec4-4478-adc6-6a0db307c830,Residental,0.6941433893819406,42,36,405,420,15,76.28777440879674,5903
6e2dc080-4e0b-4078-b73b-7c8035b38ca2,Healthcare,0.35103068612791377,37,11,502,1062,560,62.692484273723124,2624
dd3f21cb-4c85-43b4-b691-e900044fa8c1,Healthcare,0.15259135928347412,34,4,413,900,487,67.97064781660016,1988
37241bf0-edd9-4ca2-88dc-82520700e683,Residental,0.423128029137552,26,14,45,77,32,28.279179023365366,4706
f30f2eaa-3e50-46f4-83c0-bd63631fcbf9,Commercial,0.20032823432437752,40,1,144,782,638,18.700908492925677,2129
edca699d-2b5c-4630-a9f6-74997e41ed09,Residental,0.010739719771403644,47,44,390,456,66,41.943305904913444,5578
9b1b0a47-c0b8-4170-ba75-f481e453c7ef,Commercial,0.7426910229162677,49,35,590,659,69,50.59535851923481,1786
a9025b2d-f6b8-488b-a11a-958c527a9cb2,Healthcare,0.16726108830165543,29,7,73,187,114,86.72886975750379,3345
2f5a24a9-2d7a-4872-9302-c5c86bfa77b7,Healthcare,0.7632122470294401,46,33,98,946,848,63.38277453137656,1360
5f695197-55df-4835-8b5e-7424e8307ca8,Commercial,0.0031819194828628383,43,35,595,769,174,40.41631428379627,3776
8785fef4-792e-497e-91ad-ee84ad1ebf3a,Educational,0.3641462930675441,10,17,668,1034,366,17.11477796480713,6443
dccb8c62-5e1c-409f-8037-7818cb736749,Commercial,0.3443377416267277,6,48,314,783,469,35.31316797343972,9899
ab9a6d5f-7d18-41c6-b35b-fe16a6e81a31,Healthcare,0.6165721452462685,40,19,424,1369,945,79.49683239943879,5669
dfc2a03d-53bb-47a8-8891-2d01c849ba83,Residental,0.9539358086751932,11,14,512,1164,652,32.478919473834054,7687
68d4cd63-86a1-4ec8-87d1-5ab5137c7957,Healthcare,0.5454045706927269,7,10,98,136,38,99.46881188129184,2006
f817917d-40c8-4c6b-9ab7-91691908cebf,Educational,0.3797240718833633,3,10,608,1112,504,47.73722932404648,3457
296273c9-2095-40f3-b01b-e66497619608,Educational,0.32537049923476835,21,21,334,1134,800,69.30460468386747,6083
898b6cee-f31d-45e8-9b85-f0540c10d3c8,Commercial,0.3098520524782117,14,10,177,444,267,65.1085346444983,3988
9fd9c5f4-036c-4437-b218-96e937fa2ca0,Commercial,0.02018810363175061,28,38,272,676,404,22.85254749944946,4434
9b2005c3-f91f-47cb-a1b5-ccf2c7cd5398,Commercial,0.1562814745479819,28,2,619,677,58,99.68488501211898,7755
c5620395-3540-47f9-93bc-8c39fb3e7015,Healthcare,0.938028587508152,49,36,185,799,614,88.3508723575847,8328
185fd199-ced0-49ea-b5ec-daa6bedb1ede,Healthcare,0.18696033373378906,4,11,676,786,110,78.143388619298,8779
9fe5fb80-7604-4288-8f97-154798969ff2,Commercial,0.7083402368887424,9,1,312,505,193,52.07703060783605,3559
92a5f5cf-f763-4cdb-adaf-8f92cd166b7e,Educational,0.15132821660884443,5,21,559,857,298,95.43403474264898,8915
5bb5f455-1892-406b-a167-ca0aff185e81,Commercial,0.09946991845710573,4,44,498,914,416,26.851270532629062,4590
09e4d994-e3d8-47e4-91a0-cfa0d92d21e0,Healthcare,0.13081311038983234,36,24,533,733,200,73.2576934612458,3534
626a5a9a-c480-4911-ab61-b015180c3fdc,Commercial,0.4805008449466127,2,9,443,777,334,66.42584781484504,3858
67b26568-2e5b-490f-836f-d0de4b73f586,Educational,0.24279107134966627,27,41,298,528,230,37.27324317732736,5536
2263666d-ab1c-4b70-9453-c6903a9a22d1,Residental,0.8176060557233301,39,41,293,335,42,83.21017010954805,4150
8e3d6240-1664-41fb-b39d-5e2f864c2a8b,Educational,0.23072870932497824,6,9,106,338,232,71.17110152937423,3056
e00ae237-422a-4007-a415-5690a26a1aef,Educational,0.6123856762142844,3,49,138,214,76,54.949385480345626,9703
2b0b066f-1eea-4c1c-9f64-39a9dd83c906,Commercial,0.5672659386154474,31,2,113,398,285,59.88817857314123,3640
001fef3f-7021-40f9-ac74-7adce228b515,Educational,0.02298231279741514,24,42,374,797,423,31.15134545731194,3004
8a251b5a-bace-4503-969c-19c0a0c7e1db,Commercial,0.2902692459011721,25,13,428,866,438,94.62128785210533,1775
037cee97-4449-4195-ab5b-c738f993600c,Residental,0.3876279067916255,23,39,396,848,452,45.449552581499866,5980
1e26c663-4c06-4e67-97b8-66216a0d6246,Educational,0.5035164076987269,43,34,693,876,183,85.03538844546469,2365
2dad0992-cf7e-4540-b50d-3cc100a2e6e8,Residental,0.3255546020524075,15,46,90,1071,981,37.06863229463427,9624
bf0f213b-109d-4f7f-a7b9-584642dd18cf,Residental,0.6228187906550892,22,2,72,740,668,97.63201416579571,1273
4e21df27-8875-491f-a317-17bb861aadce,Healthcare,0.4797969399342934,3,47,719,804,85,40.72874242875452,8036
25799e0e-5d9d-4f8a-981a-af04c1ae513d,Residental,0.9410654406930445,49,36,355,797,442,17.968818938497968,6133
ed648cec-54d9-47a6-a729-ccb9b77ef87d,Residental,0.8445446021919921,22,50,401,1230,829,23.31646329765209,7012
19844c26-58b5-464f-9e52-d8924df56eba,Commercial,0.9084311896133682,1,16,351,598,247,96.51031994666488,4289
c85906a4-d84d-43ba-9910-12f0aa4f75b0,Healthcare,0.5234083221105309,25,50,87,153,66,22.24003646980256,4788
f1d3a7e1-6d95-42e4-a9d4-70ca424291ca,Educational,0.6134258043242848,36,28,48,731,683,51.724348307664414,5751
5b5a5ad1-edd3-47c7-823d-1e6bce6aae30,Commercial,0.6426178904710685,44,31,704,809,105,88.11394916702717,5594
14788fef-b107-43c4-9276-980f7b441892,Healthcare,0.6401026133652227,16,36,66,1160,1094,14.509693756541507,2296
b2c767d0-bd47-4be5-b962-dccb24a93519,Healthcare,0.29875103214847487,41,43,712,1316,604,93.06972011407014,2831
62171782-a3da-4c0c-89b0-01fa0277e9f5,Commercial,0.7147482085823939,17,45,706,968,262,60.77384592797223,1999
65f6cbf8-1193-435a-a3dc-9dd2c4044069,Healthcare,0.46218557886070055,17,14,192,367,175,13.446055820472829,8340
5ad34673-accd-42cb-829b-37f1c16ac18c,Educational,0.9178706715685339,12,20,533,812,279,62.78429994714853,8804
d1d85258-41b3-45a6-bd51-091996701620,Commercial,0.18407249180980179,16,31,209,637,428,10.907024662802547,3595
029954b9-0e63-48fc-8efb-297a0a9592bc,Educational,0.010506284992533699,27,5,490,1214,724,47.38933539878236,4234
d91a3ec4-1d1d-4f21-94f2-5d1284ca0c95,Educational,0.6091912264912871,15,12,156,1439,1283,27.982189774401043,4594
3cc31221-bf80-443e-a0b3-1c99cc3b1cf1,Residental,0.2862672992661417,47,14,196,630,434,53.72055466818511,4393
ffe44dcb-21b5-4495-91f3-62b06ac40ee6,Commercial,0.7399156962645479,12,27,46,878,832,33.27156947050142,5393
c05117d0-d178-4f0c-9ca0-e527b6033fc2,Commercial,0.1862919157900984,47,38,117,1402,1285,62.926948695183654,5808
a598158b-23eb-4e40-bbce-41bfcb21218d,Residental,0.1153674913790409,34,8,623,1212,589,84.37948573232066,3549
b19972d8-a2f2-4dd0-8a4f-5b545ec58ad3,Healthcare,0.03388802097744903,45,12,353,1405,1052,32.519920939945834,5134
93427d54-afc9-40c4-84a2-9f35ba88de6f,Healthcare,0.8704634512967663,30,30,379,1392,1013,34.3699043608882,2011
d1a700a2-4f6a-4248-b731-e1d63d86d842,Residental,0.3582668370525991,13,17,531,617,86,48.110490572550425,8366
85e810a4-95d1-471f-bb4e-95005934ba67,Educational,0.7659032914843386,38,26,513,984,471,43.20470353947139,4217
c1ff5293-8a63-4982-9a58-9bd1f5fa32ca,Healthcare,0.73716901835978,37,1,136,696,560,59.98872126804314,3424
8c15c1b1-8c2f-4ff7-b3dc-fb324bbb432e,Commercial,0.34188182706152115,44,16,323,374,51,62.71114278447795,4500
11b5d562-e7e7-4f85-9f4d-43293696af87,Healthcare,0.6493751539438382,11,25,227,471,244,74.86340150826786,2202
eb0860c4-d3e3-4df9-8695-19290001f20c,Educational,0.42966870799249046,33,34,540,1112,572,93.70819362325638,4733
4fddf78b-90e8-4336-b1fd-57d77cb38005,Commercial,0.05998834915066342,38,29,278,1150,872,33.560480137205595,8332
c7462059-dd8d-46d1-b29a-80821d9362e5,Healthcare,0.1425096770141232,26,14,70,840,770,39.81397362317156,7303
ca859042-3a97-467a-b3d3-f2fd139d9515,Commercial,0.9650779754222835,38,30,633,1290,657,66.3559703810609,2375
c5b31844-e1ea-460a-9602-3226050dcfb8,Healthcare,0.11273901216240878,1,43,683,1333,650,67.60639905526283,7014
0b8c4af7-b508-4c07-99b2-4e691740f616,Healthcare,0.950437522522724,27,30,132,256,124,55.04191215743747,3147
1d3ed53d-d8c6-4c5c-b6a9-2c76f6efcad5,Healthcare,0.28311395219006286,43,9,170,880,710,88.67795204417538,8365
27171946-3608-48ab-8c42-4f278aecdc2e,Educational,0.6521747907900578,12,36,15,401,386,62.677560276506284,2657
f57cf02f-850c-4866-bb7a-46873e972bec,Healthcare,0.24646364237954177,11,9,18,1389,1371,28.818080229794646,7004
3b17fcf9-c88e-4190-a191-576d4109356e,Residental,0.6093881138929108,12,42,406,1264,858,74.54572126041673,6951
102f53ed-9fc3-438f-ac62-30a33cd6a161,Residental,0.0536399367197502,9,25,653,1236,583,60.342215212675804,6747
e4821322-1201-4fce-ba74-019d7e27f465,Residental,0.1604371679655503,49,5,88,407,319,12.77394003945329,5617
086ef961-f786-476c-804a-41a53973287a,Educational,0.8332166271685227,47,44,350,443,93,30.69927916829872,2963
0aa70cf8-14de-4803-9a9b-ce574f6b8a4a,Healthcare,0.6481109696773877,13,43,54,420,366,30.395978538275497,6661
4177eac2-0156-4a82-852f-8d52ff154786,Residental,0.47414365619749144,45,3,67,1115,1048,44.901935174600936,9672
cb022344-092c-42e7-8de1-c2e9916ca27c,Commercial,0.7919046234058791,1,33,585,1300,715,85.6745998404571,6032
5ead74d6-d52c-457f-a172-d108f7356ab2,Healthcare,0.561873207057339,5,9,718,969,251,81.10254398276011,5991
4f9945d0-1dd8-4834-937f-8de046334044,Residental,0.6486049996642005,21,14,256,788,532,22.68236081398601,7651
e63440c0-54fa-4768-8de9-f78ee56d6a3c,Commercial,0.23901485143087808,17,5,415,455,40,26.404613877911007,7703
c4723557-81a1-4c67-ab57-79148824a210,Commercial,0.6456165792399724,31,1,451,491,40,32.06276467575505,5644
083bb4a5-e34d-4dc0-bf0d-6fc8801eb544,Healthcare,0.41823649594709855,6,26,595,1156,561,63.845758464429885,1188
4a9190b2-6f73-413d-9635-07da64286228,Healthcare,0.8864666073299831,27,2,96,874,778,44.47539419442167,7746
9dc0d60b-6024-41fd-b72d-4f4a2626c9b9,Commercial,0.31396352174340314,1,49,277,523,246,93.36361272288056,3547
41dde1b4-1492-4756-b59c-a73bf17781c9,Commercial,0.7400363604226291,38,6,11,1336,1325,68.66323593784004,2604
49f20a9f-3072-47bf-9d44-29bbe3429192,Healthcare,0.7050767078842697,27,11,228,1255,1027,14.983493739551825,6103
7d8830ad-c5b7-46a1-bf21-a8a541bcbb9e,Healthcare,0.08332461417956638,23,7,303,1028,725,44.81444830398542,3461
419f66b1-f33e-46e7-8d87-0e588621d360,Educational,0.8342790946622766,49,23,433,1199,766,52.99260861734668,3259
5efea679-6d98-4123-9f76-baae41a5f8c4,Commercial,0.4551838358932615,2,40,499,1215,716,75.98085596132483,3904
a44905ba-dce1-49d0-a936-d3812bf50af9,Educational,0.393085236956361,42,19,670,773,103,93.45380332898218,7437
cbee76c0-a62b-4fab-acd8-f7e695a08ba8,Educational,0.6919720541918435,5,49,24,1374,1350,14.812654611216912,3855
838449a0-7bf6-42db-a7ab-1448da13aaf5,Residental,0.9134142772362219,15,50,427,678,251,71.12497185530245,6748
766c9ea1-0120-4d60-973a-b3c523ae3a02,Residental,0.7324387687697964,38,48,286,371,85,41.52816059122508,6604
76926adc-a6b2-465e-91e5-0751db0618cf,Residental,0.42633013445959056,48,39,468,1008,540,35.50240723476411,6660
26606237-169c-4751-92d2-e6c184830795,Residental,0.4750962617215214,14,45,223,1273,1050,23.63826123018615,2218
ad8a02b4-8d78-4ca2-a9c6-fc4c2bfae656,Educational,0.9114790651450535,46,36,479,573,94,77.09458858847785,9213
b02454c6-dcda-4d53-9119-733c6c9d64b6,Healthcare,0.7831099338596551,45,10,189,281,92,62.38926572319918,8989
91077459-2f5e-4a30-a92a-aa20b69df5bb,Healthcare,0.20274870245974275,6,15,277,1327,1050,16.810241218035525,8850
991f9aba-dec4-4f1d-a64f-8ecc9828d483,Commercial,0.16539831788627635,34,25,114,649,535,87.76865784220065,4600
f3032209-4fe8-47aa-895a-c0c64aa97cf4,Residental,0.1676201862230412,7,22,285,516,231,43.003719706356506,4746
6277efe9-bae0-4be0-b24f-e797a536dd42,Commercial,0.9731664692798735,11,16,397,1242,845,69.61826214180347,9939
8585a171-5519-446b-8920-0d14e6bbf472,Healthcare,0.015466909988682387,22,29,348,1278,930,54.80643867474829,5377
44f31bdc-e4da-4cf7-8bc1-b21ae07f6e20,Residental,0.2045365269417928,24,37,351,1367,1016,44.46846103911561,8196
9b07af05-28eb-432a-9f80-69d3e7a6b5fa,Healthcare,0.7093896857614521,41,31,425,1234,809,53.55836171450562,4270
63700662-3646-4a3f-8c5b-77822214adb0,Healthcare,0.417011206363335,15,3,650,1144,494,73.41888700087551,6376
a730ed57-c6a6-4f86-88cc-59af3b504698,Residental,0.43462370592390254,26,41,560,585,25,75.1180466013717,3448
30f450a0-a7ab-48b7-a7c9-c622a3997c1f,Educational,0.6509359565100902,7,32,570,853,283,43.084645125788306,6360
3b6c887a-a326-4f40-be74-999bc780e960,Educational,0.440814657750463,29,47,541,1175,634,12.746845511862228,3634
10c7c7c5-66e1-4f4a-a9ce-c0931ab116f0,Commercial,0.6752837758861341,2,31,25,1070,1045,33.081290179136815,2824
5e27f829-1285-4cfd-acbf-f5160d04401a,Educational,0.6102103860034379,47,42,654,1351,697,37.14324159813759,4785
9350395e-946e-4bfc-8772-4ffc80bb3a1d,Educational,0.057311023845993736,43,10,499,503,4,99.77976409299445,1127
bf4ec66b-9db1-493a-b90c-5f039ba2d780,Healthcare,0.5394139320066994,9,30,303,1288,985,25.732456963075226,8830
a758bf0d-6827-43d3-aeba-355291961d88,Residental,0.4414961756474397,15,18,321,767,446,80.1364166714484,5899
cdfb0d96-99ee-4dc2-ab53-c5eda68ceedf,Residental,0.644376508290508,31,3,20,959,939,77.97640299596044,6017
74263890-8515-40af-ae81-b5d66eb953b3,Residental,0.43033772173843454,46,47,510,585,75,49.40277289970206,9265
762adfa2-fefc-4f10-8d8c-9431ce9d533b,Residental,0.4387104400435041,1,30,506,791,285,49.744765842951715,9754
d13a9db4-f616-4ecb-b96e-71da8e299f9f,Residental,0.6857724899562068,44,21,219,545,326,88.40691741163728,5851
60004649-aa8a-4030-90f6-7fe753451fd5,Educational,0.9050826317956903,13,40,291,766,475,79.61895024391801,8435
7bfd5d1b-fc13-470c-ade9-5f686cfcfccd,Residental,0.9010770611227731,48,38,474,1391,917,13.007700849095315,7322
4631b989-b24b-4faa-b4cc-6b5479b68cd4,Residental,0.3354039401592016,19,38,273,1155,882,91.48524126696736,1975
6a8641dc-3295-46a7-a50d-adb391835945,Educational,0.6075289028024904,37,10,47,511,464,62.67236114448197,4697
8f93f84c-2458-48f4-8867-a2bf04623936,Healthcare,0.43468281750540927,14,6,458,880,422,95.01219253811308,4576
88b296e9-5f73-41ff-9ef5-12dbbe82c691,Commercial,0.13771750698348995,11,22,593,1053,460,86.98440647694444,2917
403869db-8118-4081-8c32-f0587def15a1,Commercial,0.5462713584948309,29,9,246,1112,866,91.57345868446164,1948
7e37d629-1d48-40d1-8c2b-6247b07a6d6d,Healthcare,0.3108730219796809,7,24,279,1115,836,36.339529428437245,5715
ed075439-f8c0-47e9-a03d-37c13b7a7610,Residental,0.9866839443461557,32,43,132,1374,1242,43.7096869984207,1814
262ecbb6-c061-45e4-90a3-605f514aed61,Educational,0.5998645523336957,46,21,252,657,405,44.57222086346368,2083
3c94d462-4776-4738-9504-45e69abb4dde,Healthcare,0.923223015295727,35,18,84,482,398,68.27407306223199,7119
8d4134f0-10d2-4ec6-be1c-9783a2d91690,Residental,0.9832314548589279,13,47,493,1338,845,20.636779889412153,2504
fb239979-af48-4564-8e4f-8354a6fa8a91,Residental,0.07051877344283741,21,37,598,1355,757,37.938215751230445,7121
ea25b311-6e8a-4bb5-a655-3f0a24b8f216,Residental,0.6490854538505655,1,43,320,808,488,52.1900669885066,1025
98e723d8-b19f-4241-8abc-503e6577f166,Educational,0.22896585051340979,11,50,28,277,249,64.32049371097273,1480
dd205979-28c5-4b2c-ae3e-22d39578065e,Educational,0.21087033475159378,20,12,637,962,325,59.83619918682397,3136
60cb5cf5-edd8-4d66-9991-a7d082563d91,Residental,0.8668475188357349,40,13,675,936,261,36.64779686236574,3179
f228766e-dcfd-492f-855d-f86230281cea,Healthcare,0.8455965753137537,26,24,538,887,349,60.445375484369585,8930
208cc21f-8c07-4911-87c2-9e0c06ea0aea,Healthcare,0.5652666585395615,10,49,182,1183,1001,70.41310944026101,6888
6f6977ef-53fc-402e-99c7-1dbff61ad3d2,Healthcare,0.2942429463109132,46,2,383,722,339,71.40330717876587,9230
7e8acaf8-48e9-4cb9-ab78-da7f05e38274,Commercial,0.7611331885408891,44,47,496,667,171,70.50220684269506,3637
0b56e677-c6b4-4f50-b6ed-f3cce15b70a9,Healthcare,0.4692268765476467,27,4,215,632,417,35.77264199609644,2548
8c66a8e6-d369-4224-af07-97267bf9dd68,Residental,0.19161286212077266,25,19,562,995,433,11.876909106029625,6362
d8f98b57-6656-4851-9eef-82e94f44726b,Commercial,0.9489813060966433,31,39,88,692,604,15.752481877183609,1774
05ff77c8-3cca-4779-ace1-4680c3676bb4,Commercial,0.4922881770802342,26,21,390,1239,849,92.17592347613406,8223
5dae0095-6dc7-490f-be14-3f4321f9ed82,Educational,0.382143391967363,36,32,347,1435,1088,71.15601487448356,5952
d77c2df3-5c0c-43e6-b715-5a9bae7db3ae,Commercial,0.8258302328656791,41,10,56,248,192,76.97611730374594,6654
e113d4a8-7a7d-423e-9ae0-2c0ca1561ae1,Healthcare,0.5982550413759921,15,33,2,344,342,45.82064676830321,8163
cac13f08-c4bd-489f-b393-add299685415,Commercial,0.0610081106396545,8,43,277,565,288,85.63768901871158,9389
4136b3b8-4a78-45b1-becf-b5034bbee7ce,Educational,0.32985516427070316,35,46,285,644,359,53.10473162686458,3604
f22d6240-5078-41d1-832d-c6a4c998b427,Healthcare,0.02002977106466497,33,39,265,1253,988,55.34136052810103,3839
c099f521-2122-4e95-ab1e-2208b37d3a29,Residental,0.15764822318008742,44,36,414,505,91,85.39174194633107,2191
b4ff63c4-1e64-4bc3-b62c-83fe898a8a56,Healthcare,0.7781299946245529,35,21,383,534,151,69.3060241316661,4841
a4dadc18-417f-469e-a96a-6c5e687ee29e,Healthcare,0.24802724088265304,40,40,30,238,208,61.84760839440708,7458
d99710e5-a5a1-47e3-9840-7d43d3af59c1,Educational,0.21759521858811692,26,5,584,899,315,20.310286887261434,9949
f927aa01-376a-436d-83a2-6e67b2beb3bd,Residental,0.3540972231239846,44,48,300,760,460,22.857013946618146,3650
feeb7804-f253-4d62-afd4-65429b9c3d43,Educational,0.6740056336433001,21,3,9,169,160,39.44695113527652,5517
2a4c03ca-5833-4fc4-8c7f-5d2b755e489b,Healthcare,0.7135789465046719,44,21,57,1427,1370,38.46543989432615,3072
9bc1d23f-7508-44b8-a27d-1a471b6674af,Educational,0.06114676175891909,24,32,182,206,24,11.13746198347511,4411
7bc34563-3031-45cd-a9d1-5008056de6b0,Residental,0.30409148907223915,34,28,715,1295,580,84.09019735070008,1000
8844f13d-348c-4e54-b83b-164ffb305aed,Educational,0.6490900821684532,43,43,195,1157,962,16.07466438014879,3644
e79fbb9e-2ac4-40c4-b34c-41888adebf5e,Educational,0.28283424518758316,44,44,690,1156,466,97.44533382257113,9079
5ede508d-223a-4d9b-aea9-43912cb102b9,Healthcare,0.8559365860220987,46,19,577,1223,646,63.09319339833033,8280
61b08b93-f963-46b6-8b70-275bde2b1db9,Healthcare,0.7768173741851649,46,43,140,980,840,34.334427639798946,2918
dbe3bb88-abcc-457b-89dc-fc40eb36bac9,Residental,0.5973009021073546,11,23,397,884,487,44.43930382189139,9887
610a8cf3-7707-4047-929e-758c800ce78a,Commercial,0.11656007757402698,18,19,465,1104,639,95.24326963632716,3352
3137cebb-37eb-4312-b8c3-1c78eb5a2dd5,Educational,0.5407966543906224,21,18,566,1433,867,38.49428217822836,7000
a9a6ad56-8798-49a4-8dce-41d8d10be8d5,Commercial,0.2645709603122339,12,31,289,1307,1018,52.41367548486826,5040
a9cf57a5-4269-4ed0-b51c-c68cbbd5b126,Commercial,0.52512369794527,5,7,128,1298,1170,20.51614497236725,2365
84c09f8b-6575-4681-8e82-03bdfe879947,Healthcare,0.021326823604640777,18,26,585,1358,773,30.717210613363378,7959
f2393df3-b724-4222-b015-db47a2b4d3c3,Healthcare,0.2516020908351482,19,6,146,882,736,77.33086898810187,2242
43fd2042-d4f9-46e3-8b77-c24304d21331,Healthcare,0.7520524889182062,24,34,425,1216,791,84.16251255887846,4600
15a4d053-9e05-409f-864c-edef3a6a187d,Educational,0.06059250553112627,9,27,298,972,674,51.88276319770454,6614
adcee613-14f0-4811-8e13-4f2ac21d0ed8,Commercial,0.7675259800355174,30,33,454,531,77,99.47000576264344,6408
e3d584af-214b-4617-bb1c-65ab5daf990d,Healthcare,0.3813161016246732,4,37,21,94,73,57.314820801355474,2964
2c49da10-19b7-4041-8a93-8f3c7a287162,Commercial,0.16722266681031595,24,34,635,1266,631,65.20205321082742,2339
8462cd4d-af18-47f2-8e4c-0534a40e0fcb,Residental,0.22477423494065785,21,36,280,1256,976,44.76751152546365,1205
3be571b5-13fe-4324-92a0-7aab4786d0a7,Educational,0.8918219438721822,2,40,292,989,697,72.14055143650694,5121
3f2883e3-6c2a-4c6c-9a18-f2eba2ce29e6,Residental,0.32539549211670293,10,14,256,1328,1072,53.21510913682417,7262
bd307fa8-9bb9-401d-ba34-05177767ca9a,Residental,0.8768335989039492,44,14,335,1138,803,51.24297848572242,6651
c68e3015-9ff7-4792-9162-85177cae8a6c,Residental,0.7294767080275668,32,40,666,975,309,36.13707811251551,3053
8a2ffb4f-ceaa-425e-8424-0b227768d558,Healthcare,0.15825532119631025,16,25,359,717,358,16.855868910747148,7579
42fb6bfc-edbf-4799-b327-29df853e08d1,Educational,0.32371704937299695,26,42,663,761,98,30.7716807884218,2466
3a5e28ef-990d-4d61-92bb-bf3924a736da,Educational,0.3005274028411823,36,37,60,109,49,16.9431345242661,1725
c6d11cc9-43bb-475c-b055-6ea574218141,Residental,0.30029401073251183,49,26,706,1088,382,32.34201723613647,9438
6288bd03-ba29-426b-8f33-af6639659e91,Residental,0.7689245656698642,5,17,189,421,232,61.12217427565501,1847
9d2a67d4-3887-4194-a404-82451a0648d4,Educational,0.7920936809027604,44,37,165,652,487,17.94841711122767,2785
b3ee0ebe-508e-4c99-9b51-b4b9a3b7c2dd,Educational,0.6025269749675481,46,29,285,315,30,46.038786730607704,2815
ac6950dc-596f-44b5-a815-6027f3d80209,Healthcare,0.4353908617760023,34,45,458,629,171,87.95423068691709,6370
ae6e03ef-cf86-4b49-b708-d3cd02e51c10,Commercial,0.030744527438516744,7,11,596,1194,598,24.78055300776206,4793
8ba4ab11-fd69-44d7-8b75-5cb651c78da5,Residental,0.032834908714650224,32,2,386,839,453,52.272439452435094,2971
5e02223c-0eed-48fd-8a9f-a26efcf930db,Commercial,0.01504345111429295,17,30,356,1288,932,79.53325274296343,7713
36ef3226-6c78-40d2-890c-bd503cd151aa,Commercial,0.6621679726645601,47,24,261,1094,833,83.01022169312688,4518
3ba85884-db1c-4894-83fa-2d07a77e4b3b,Residental,0.39296140625987686,49,28,462,1097,635,88.68144293400326,2238
d7a4b137-cdc1-4d6f-ab36-b5db04bd27df,Healthcare,0.6342871792626666,19,38,598,1143,545,46.801488058218666,5040
02e67cbe-05d1-4475-9f28-fefe5e16d02f,Residental,0.9275475428201824,16,13,374,1110,736,51.56629117410797,8150
a5a4cc20-3b5b-46af-8261-e3d7fa8131bc,Educational,0.33832372103128827,28,33,635,803,168,88.19180773316823,8281
08e0f67d-0715-414a-bc46-ea01b0966b89,Educational,0.6066486547694172,1,23,540,1086,546,96.76227935818837,5847
a23a6b56-7f83-49f8-a15a-e0e0499fa78c,Educational,0.36163961602110994,42,25,408,1000,592,72.83375391799876,2034
c4f056f2-e9a5-42ec-92df-186bf9a1039c,Commercial,0.8080362602595267,24,30,465,819,354,46.935182411419994,6008
d7a0cb99-3601-4c9f-a4d2-efad6f0d7032,Educational,0.6733366189600094,35,3,27,1401,1374,46.775653541832135,7884
6669c527-b446-4d56-b222-43c4d4f2e1e3,Residental,0.17551657534579757,48,25,400,452,52,70.08465078138639,3055
f8b0f9d5-9948-4ec2-86ee-9558de905370,Residental,0.6197632166518529,49,34,156,1432,1276,38.866765968252736,4732
ec1a9378-339a-4096-8451-47f6e62ddde9,Residental,0.9250989639440004,4,50,629,1117,488,48.86761259129616,8098
962b07cc-0b26-4769-876e-9fa4365b8d1a,Commercial,0.4857018695614135,8,30,491,808,317,90.62832013384774,2733
bf4af0ca-1b48-4829-be87-5b85277efc80,Healthcare,0.4402171817276075,6,20,134,1409,1275,86.79546851105871,5439
b8498e81-80d5-4474-979f-975fcc55f930,Commercial,0.4923304105878742,38,6,55,954,899,16.956149279414635,8991
93bf1993-8765-4584-b97a-7c1777582985,Commercial,0.3105539037205307,39,30,568,1021,453,23.976094249940047,3756
c84e23b2-575c-4f90-9b39-2244d286c8b8,Educational,0.05304421616746624,42,38,25,679,654,33.362658922472676,6375
8ca06bc4-8f92-4e32-b227-05d7c7efb7ae,Residental,0.8617581790996355,3,39,124,479,355,93.77870592964197,3494
6732bc7e-1b44-4768-a3ec-5d904151eb8e,Educational,0.11053396987979325,38,30,49,265,216,17.311560671856416,2576
1b850913-d11c-41b3-9fd0-c66281a9dab6,Commercial,0.12835041928687096,42,22,669,1009,340,92.15932674745318,9225
00871a3b-5b77-4787-9916-d006a32af187,Residental,0.16005762195127393,11,9,631,1181,550,37.33632498259567,5248
3e9349b8-0b06-4a4f-9a63-314978b441fb,Healthcare,0.10390672401917145,12,10,489,1191,702,36.50732638332735,7163
0ec517d3-805a-4491-ba61-22c44e50d794,Educational,0.8976270843805244,34,4,513,651,138,20.8785441403489,9624
648ba4b3-4062-498a-8536-72b9e3b93fa6,Healthcare,0.22869186852320655,48,47,181,866,685,86.59465035778912,4040
18482517-57bc-43b1-a25b-1f0888240d31,Healthcare,0.2260131794191429,5,2,390,740,350,91.21751801026353,9543
4cec499e-45c2-4aa6-8dda-6762b922a866,Healthcare,0.3391075849287941,39,47,540,1432,892,84.5284062490151,7278
f0c1df5b-9c52-4290-928d-696b6b40c1cf,Healthcare,0.4525087960984737,19,9,1,571,570,91.70667829537418,7755
8e93fd8f-af67-404a-9730-5a1f7f9be59e,Healthcare,0.08952085845403601,25,47,33,341,308,59.528059861029384,2915
37babceb-fc99-4004-9688-fc2316d40f13,Commercial,0.6590765785457656,24,24,114,1120,1006,51.111429199437026,1488
92551dab-3ab4-4f95-adac-0510324a8bc3,Commercial,0.3944439268872817,48,30,494,848,354,32.367339956913725,8144
f4637fde-5553-4e9c-8351-dbac4c91eace,Commercial,0.04689791724445391,18,13,22,623,601,15.14019819072547,9320
03693482-dd04-45b0-a2b6-1bdf8086fca4,Commercial,0.27334783929671624,19,31,623,1007,384,71.65645569355118,2024
9864bcc0-87e4-413b-874c-af25ec893cbe,Healthcare,0.3141959563324186,27,13,275,729,454,34.85575860128728,2043
97267aad-7bf9-4807-b62e-a655073e2895,Educational,0.9276406710895017,23,42,392,728,336,75.57466569641922,3331
efe8b8f2-2c87-4b62-80ba-b7605c9d45cb,Residental,0.1397878822936639,32,5,103,1289,1186,67.88786047655539,7900
a894d5b1-6ce4-4052-9a3b-89b3238bcc56,Healthcare,0.9072873983450486,29,49,471,1062,591,35.319064273929456,3939
f3be6b6b-3f6f-48f8-8f2e-39ea1f3a8a7b,Commercial,0.9530649656271554,42,33,294,720,426,91.06364085896722,9985
ab9d70e4-7707-4b6a-a847-e87454b3ef67,Residental,0.537542802339943,40,32,357,753,396,79.76107240712975,9213
6bc57018-4d16-49e0-85cc-5d113e66a4dd,Commercial,0.6887954532947793,6,34,505,939,434,49.367079833263176,2179
6ef4ceb9-0b34-4756-ad7e-647f4e9c08ea,Commercial,0.8757474289525509,29,50,105,400,295,82.5123275929281,9029
5d543c6e-f127-489d-b52d-3b920ccc77f8,Residental,0.8695651512471677,45,46,582,1214,632,45.975654367514764,8268
f1ce22e1-67fa-41b9-aafb-d4d0ccc262d1,Healthcare,0.7205735254888043,43,31,418,1011,593,87.1978417167186,4674
fef4b756-a4ec-4aba-b731-47e35be64e0e,Educational,0.9906479574195871,7,5,190,952,762,39.989767360149905,3931
9f9f2626-acb9-4c0f-b067-35033ab2a932,Educational,0.5910783071572614,41,31,353,1183,830,18.74435180282589,6293
23bd3c23-e471-454b-95f6-b53242ba0140,Healthcare,0.48148222110826855,15,6,617,1059,442,41.94844317098408,2986
01c98eb3-a542-4506-a578-ee6eddc66dc4,Residental,0.2733397331371259,36,36,78,1046,968,79.64689011604435,2657
b1590593-161d-4a85-8737-4e7fb725af06,Educational,0.30077133893401,34,16,117,342,225,57.88294637634153,5910
0ae324ab-d29e-494c-9321-6fddd5ae99aa,Residental,0.043230308982430965,2,35,152,427,275,82.90672188294468,6201
d4c6e7bf-9a5d-4d75-add8-7c39a575c887,Residental,0.5211637989033455,24,46,84,719,635,43.032684074634204,8027
5d00a9f7-c237-4145-8984-0b1789eba6de,Residental,0.8028580379419091,8,7,170,1196,1026,39.40624672394799,6633
5455c338-1201-4efe-9f48-9f411d865d00,Residental,0.9711193887626746,22,7,530,1332,802,44.06200210537267,9844
bf725588-26d9-4574-9502-08412f342ca3,Residental,0.5884960920095599,23,13,102,1198,1096,75.93600617351221,5100
2df4401d-569a-488a-8ea4-ed7cdb0f3e42,Commercial,0.9550191401496679,21,6,274,390,116,26.19312402651298,2664
a02fe4ad-d61e-48cb-8306-eb1695261d65,Residental,0.2991920275276313,27,12,421,489,68,90.43519191808916,2016
86bf2e4c-c408-47cb-bfb0-4987bbfee6b0,Educational,0.14249166440818817,43,46,259,839,580,45.54945474850218,6738
99e6966b-f489-4fcd-b301-58619d8cb520,Educational,0.5890578928859137,7,46,538,855,317,47.848724477441074,9013
22640f1f-1ac9-4632-ac8e-dd1a684ab41b,Healthcare,0.32317081717863205,21,4,609,1053,444,18.821134899907797,2684
383b2bef-9e50-4024-aae5-766c8dbb471a,Educational,0.620668733879575,24,4,192,719,527,71.15497056349476,4702
18d31332-c2f9-49e7-8ddc-28d87f782560,Commercial,0.29703209874195335,35,2,77,188,111,73.4248514706895,3178
3381d12c-f072-49ee-ba2d-1ef5930494ed,Healthcare,0.7626920832119298,49,3,403,915,512,15.580388011614444,5154
3817e6fe-45c3-4ddd-b3e5-5342732b79e5,Healthcare,0.917129782222645,27,38,680,938,258,69.36732600341651,4890
0ec6e146-8856-41d6-8889-3c5566cf1192,Healthcare,0.4599885057666123,45,48,526,1021,495,99.38993665874784,8696
9d0e0753-b90b-4acc-8841-756d6678f04d,Educational,0.5981098536750085,16,24,516,1248,732,51.12765934664777,9089
caa5cdb8-2e72-49a4-93f9-8d89c16484c0,Educational,0.08182583202436555,49,3,473,814,341,15.409540533788402,7009
f3cae68e-a110-4752-9bf8-8a5bfde6ebf5,Commercial,0.39594023577604043,50,50,590,1340,750,88.4606217518367,1239
28f642fb-5781-459e-aad8-cc52216173da,Residental,0.5560464692889286,29,31,664,920,256,32.89112292729055,2265
d4a6f1c1-47d8-40f7-9f67-3a3633e4ba76,Commercial,0.24293099064004797,40,2,283,390,107,78.00307955016072,7319
f8eed947-a51a-46d6-9a41-374892dd4ae4,Commercial,0.11218529535825084,3,1,286,452,166,76.82640059356038,3817
2823308b-2909-4b1d-9023-b9932e02c3d2,Commercial,0.7403650932396282,49,44,686,889,203,53.62227881963826,3850
9284b626-0786-414e-88e7-996e53aa9372,Residental,0.13718638843226083,50,21,659,662,3,31.04184442284858,4014
03c42d3a-92d7-4498-a246-9abadba3d61f,Residental,0.6234074615554187,24,28,114,609,495,25.22424562999168,1881
323e190d-dfa2-470b-a3aa-22690b457543,Educational,0.9406039101799862,17,11,657,1027,370,89.42708107372425,3626
769009a7-fe67-47a7-8f49-a26580fb4a64,Educational,0.1394288322561611,3,45,151,644,493,69.08428023424031,5363
ee84c053-bda6-4f80-a4ba-7cb37866227a,Residental,0.4032111514707515,3,32,280,368,88,91.7299416341319,1013
3f5e024b-a25d-464e-8118-7ed3abc3a1b9,Healthcare,0.7397755802955994,23,48,167,1125,958,33.4104878444026,9075
d8ea17c0-6bac-4f84-bca6-8422580bca72,Healthcare,0.5311332273562113,41,44,501,626,125,29.142553050043784,9273
665cba01-7e28-4d2a-93e3-a9829b7fbeb8,Healthcare,0.6475811578856628,24,2,275,1007,732,33.29098288916282,9467
9c7e519b-ff48-40ea-8f0d-080bf08d8c4b,Healthcare,0.9820425120749843,3,10,323,1071,748,43.85641541010749,2704
001738b1-0d5b-4fc2-8a84-92dd2ccba828,Educational,0.8027000520234348,22,30,415,923,508,44.710919877713025,8715
79d509b6-8c98-4b56-816c-215efabf58f3,Commercial,0.4941598243611739,29,31,653,1128,475,48.716721589468214,5390
6462aebf-3dc1-4f89-9536-fd37d4217b6f,Educational,0.4614872204587728,22,47,286,589,303,28.98939888972758,1567
f515fd67-0bd4-4083-816b-c69ec9a689e6,Residental,0.5674338833351923,43,20,248,1071,823,77.72349434090087,6463
efd92371-fa97-4497-a20e-f51f92e80041,Healthcare,0.27363548537217464,3,13,61,143,82,92.97324302726287,9486
ebbf0c77-c8b3-489e-8c53-e28441452f96,Educational,0.1967438229647246,14,39,545,689,144,43.22187425114466,4091
ed020771-a870-4cbf-88ba-b21abb88a4cb,Educational,0.31155948308009385,14,18,146,864,718,67.26795647165689,1132
a2fb25fa-70e8-4de7-8dce-499177ad8686,Educational,0.17071823145295983,4,16,562,1007,445,66.36941061135263,4585
99838baa-5ae2-44ba-a57f-58464ecd4cde,Educational,0.3069247020886131,31,14,382,1269,887,58.27020737634545,8204
477b9419-6d48-4f2c-afc4-b4b8d8b8a9e0,Commercial,0.9195209999255289,28,44,221,1276,1055,16.48713431455413,7117
7b06100f-0f74-49a6-af6f-632809a458d6,Commercial,0.16680970324217748,9,17,114,1107,993,95.26805415627074,3440
00ad1d60-c22b-4130-80d4-d3defde3cd33,Commercial,0.19877111305687645,3,22,87,632,545,40.83764003507359,1716
a18eb18d-fe4a-4201-982d-28c73f1c1fca,Residental,0.2773235174078008,10,16,128,1172,1044,94.57951869617479,3010
37f80e86-7e9c-4900-8298-0279b96db987,Healthcare,0.11811259338422342,46,12,417,761,344,90.66407127921728,2839
8cf4a241-d09f-47e8-bff6-ac4b7fe8f018,Healthcare,0.7442781005328892,48,39,451,913,462,36.96635552251228,5191
ffc63fe7-344b-4066-a3a9-fde11a098968,Healthcare,0.9802718331721487,15,20,497,1317,820,48.62592493295985,4348
8fb93628-9b0c-4081-ad56-d35d8e857f99,Residental,0.31711484556597214,22,13,222,1030,808,99.158905319709,4581
3470fa82-42d5-4be5-abf9-aa952246f16e,Residental,0.3274250789437626,15,29,277,286,9,64.57983685279889,6219
65a15ab8-6bbb-4f97-aa38-ca093017a74f,Educational,0.3855168546890634,40,8,553,555,2,28.938596755557107,3426
b53e6684-7d4c-4c45-9538-e0dd6066d812,Residental,0.7176621726553234,22,1,608,1215,607,18.631091983367092,8988
7af2d3bf-7ef4-4a0c-9811-2dfc9fdc91b0,Educational,0.7187506218716172,40,18,605,663,58,89.99561533972816,8152
7eeb5fc6-d223-46b6-91d6-6895d79007cc,Educational,0.9907387880532581,28,12,498,1063,565,50.356569019605594,5038
19d0d333-fce6-4cb9-b552-a996d4e2dd17,Commercial,0.8218930710625186,43,3,8,410,402,72.30475654173978,2534
cd54e54e-d58a-4200-8959-9d17cd18707f,Healthcare,0.06411045497531132,34,18,524,1285,761,40.448435449842556,4224
33f2e516-6cc3-4df9-b0f4-2e4ff7e9a97d,Educational,0.7827573775412109,6,46,79,1369,1290,59.35113382242121,1672
44625b26-9405-4a42-95f3-a18549a85b95,Healthcare,0.10332160140602609,2,49,20,1290,1270,40.371536421650184,8655
faf07273-31a6-425a-a83a-7c59031d5150,Commercial,0.3958826094540313,37,26,176,566,390,84.16020062437194,4734
c123ced0-1d6d-40a5-8b6c-9745f451cebc,Commercial,0.5731043761768296,24,30,402,1158,756,35.55096453794988,2250
c293b961-b31e-4179-b788-a5f1257a5f98,Educational,0.4354905182211011,43,39,211,603,392,76.5289512563995,6789
f80e6321-46f7-45a8-9646-de7f5725ee7e,Educational,0.8815624268728534,37,19,304,871,567,39.704026964146905,7439
a692e5a1-12ff-4e4c-abdc-f29b56142d1a,Commercial,0.7827306896520755,34,26,61,740,679,35.05304263155274,5831
3e2d0265-1580-46dd-b939-fa5c38ebdb4e,Commercial,0.5348613474563515,22,23,115,461,346,13.416571374320874,7202
6973a6f6-ef94-495a-befb-f774dcd23ea8,Residental,0.6078346881232559,6,22,613,1169,556,92.40877767316171,8382
d250b6f3-6413-4e26-bdfb-4ce33f578935,Educational,0.8791586793855121,9,15,209,741,532,40.03573133073862,6607
080ff751-d91f-4614-9831-588e779a05f9,Healthcare,0.04538227301731279,35,25,118,637,519,55.083176605202226,7417
d2bb78d8-9b1c-4c40-aa36-12485d1f8920,Residental,0.43167539422545,16,49,77,1014,937,66.11914760462571,9501
6505e498-1934-4b20-995c-6f96f4186ace,Commercial,0.09145835258724277,9,1,572,1082,510,97.29016214859182,2627
dc778fcc-09aa-4576-a307-23a763e0383b,Residental,0.030062051364858955,47,49,351,875,524,96.88736773211782,2004
cc42ab30-4759-44d8-aab6-210a4c7f71db,Residental,0.8962910020573452,45,3,568,573,5,94.90670980031844,4659
d90d7773-7061-49b9-857e-139ad3d975e9,Residental,0.07260194690717536,16,28,465,787,322,29.733683598337713,1633
ff58710d-5361-4e8e-9800-d8ef33321f6c,Residental,0.3031675085387374,46,41,591,1053,462,89.88227676297899,2612
2e6b7aa1-0b4a-4e32-95e4-83da9789dc13,Commercial,0.3667243238023984,5,28,102,1123,1021,94.80102784191128,7953
b4a196d7-b197-4f0a-aeaf-5efb4838827b,Commercial,0.7749996416987435,16,3,40,667,627,54.35329111308009,8174
10933210-174b-4e6f-aad5-386975d6b94a,Educational,0.8770651299285859,29,16,214,1422,1208,48.352971604662415,6281
e48216ca-f005-4b79-aed1-3992f85119b8,Commercial,0.4562129259088269,8,28,460,901,441,92.63173971888148,4676
4235b149-1fe3-439b-9db7-23c3c1d33139,Healthcare,0.9469732402357177,26,23,524,808,284,29.825568202967798,1509
c4d999e9-7462-4b61-bfbc-227dbeafaaec,Residental,0.8786868983378439,8,6,627,769,142,98.30120634052888,2499
d3102357-3f4a-44c4-a9cc-40df49f8b368,Educational,0.3689150827340023,43,17,675,1142,467,37.78262693395466,9929
0a9d2ec9-8baf-4ece-be92-138371793442,Commercial,0.17464160536214346,48,26,190,287,97,39.68336969198167,3742
f5d4d6cd-3bc5-4957-9504-7fe9bbda13d1,Residental,0.26576554013381404,48,33,647,680,33,88.10684819843917,9471
621c8be5-bf46-4caa-bdce-76176775b5c1,Commercial,0.5775760827350097,40,12,4,797,793,31.50271738045151,9414
706200e1-b2ac-432e-bb34-32ffcddc9be7,Commercial,0.8012336461281089,6,41,292,1196,904,84.28160020436904,8938
24a59380-848e-4288-be0f-76524088f8f1,Residental,0.39253937023171115,33,49,643,1145,502,63.70162520042468,2513
bd9037d8-3b72-443c-bbf1-c8deb77f24cf,Healthcare,0.26425227444290833,8,33,508,1270,762,32.803705487196595,1312
2fe64c72-c0ef-4720-9ba9-1339e0f52c80,Commercial,0.33695882649945386,12,30,575,1017,442,28.00607016484409,6134
945b90a1-6451-4c7b-a12e-75f9c36db681,Residental,0.48129907002767613,19,16,696,1295,599,41.01764874386555,7726
d7ce2772-c556-48fa-a5f1-47408757aae6,Educational,0.7288190221419741,19,10,599,1243,644,48.5463230391351,7223
aaf7bbe2-7654-4678-92c4-7fb4ac44dad9,Educational,0.28362100352642416,37,7,33,579,546,72.96233106216596,9639
fc04da57-10be-4676-8be6-75d93256a082,Educational,0.8897665822891283,46,29,338,948,610,28.953384112969836,3580
5c66d076-a698-454a-87f4-ebba79c1ca85,Residental,0.5183393156941021,34,41,345,1264,919,99.20645154091706,8538
d4cef52a-f4b2-4ebc-b067-0001fee0978f,Commercial,0.5990083864046128,41,30,484,1156,672,68.8861582387045,1264
c5628581-bf9c-4712-adaa-01d3f48297c3,Educational,0.22048075028774528,39,20,696,1195,499,61.24380619738779,8699
4b23692a-2df0-4d64-a197-9cda0e37c366,Commercial,0.8075533528871276,9,50,405,1032,627,25.815450758897878,4135
4668d3b5-38d0-491e-aefc-4b5809c0b69e,Residental,0.6325655961661051,46,38,347,445,98,82.15484309639913,5677
5ef9d47e-c414-41d7-8d90-b650818edf05,Commercial,0.8231067831063545,19,41,336,931,595,70.47525419719194,1998
77e30c5d-b4a7-4d3e-8678-e77c0cd8d931,Healthcare,0.4077793323691711,26,28,208,591,383,76.1508963853864,9856
7345059c-fc9c-40b2-a8d3-e5bce6e7c151,Residental,0.35315637408633305,14,38,389,1266,877,91.22295199069666,4974
a0ddc5f6-90a1-4d9b-9339-e2ea3955a926,Residental,0.5470939345469049,11,45,228,1304,1076,89.3112078858186,2949
b4515a6f-bc42-46f9-807f-e2015ae82ac5,Healthcare,0.07092249993113575,15,11,200,718,518,28.95293049132554,6988
c8401f43-5c5e-4179-ab13-a6f9cd219d10,Residental,0.46921321390391735,39,20,124,150,26,18.830737970641117,5652
8cb03bf4-a17b-49d6-a0dd-ac66ee83a5aa,Residental,0.046050964943652684,20,35,62,1275,1213,34.11457032015575,9951
ed674384-4d87-4437-9133-9826df5579a1,Educational,0.23519487795617167,14,46,621,1273,652,45.53780897240046,8579
db4c73b1-3ec1-4ac7-9aa2-d100a9e982f4,Commercial,0.7332864577380667,7,30,344,1305,961,47.14148544856498,5540
a648c23a-73b4-4a5e-adcd-522c708f40a6,Residental,0.963386591319602,41,11,719,1060,341,28.085565915039034,5399
e564e15a-5bb9-4688-88dc-0cbb90c0ffb6,Commercial,0.42682869364756093,3,47,276,1049,773,67.93705247125536,1044
658e5bf1-3037-4475-9eb3-8dc2a84d6236,Educational,0.14622193811374462,10,1,332,841,509,80.62667946403447,8420
0ac92d1c-b085-41f3-8f30-a980392d7988,Residental,0.4290401927831715,35,39,16,229,213,38.037308500680474,5154
8df228ed-927d-46b6-998b-99a8dec87941,Healthcare,0.2027516493827941,35,43,672,1226,554,51.2868153620377,4406
b4363048-e2d4-4d93-9887-56346d6a7164,Healthcare,0.5998194422899243,47,1,239,1209,970,42.24500884780841,2501
c421ae63-369b-47cc-9efc-fe3a307572ce,Educational,0.2514832168918424,36,30,337,1259,922,73.0486622084514,3447
487180e6-6e75-4a3e-8668-59d8ad35902d,Educational,0.2740097631047812,32,34,198,1147,949,60.89067706479181,7192
b4fd444a-4ed2-4cf8-b6f4-1875d4ac7b08,Commercial,0.21120314275328111,45,37,395,1294,899,22.307673955661528,2145
218289dd-87a3-4a73-bdce-5c34f7cb9553,Residental,0.5665248745820347,2,5,392,1281,889,86.40007551073126,3962
b8734706-af46-4cb8-9297-df452d96b63b,Educational,0.7685214412313585,32,2,507,613,106,71.89338789691658,5857
baab9553-51d1-4fcb-a031-8c0483a9832d,Healthcare,0.597035781428725,22,43,398,738,340,53.78932303733097,4447
1cd6ddf0-ba97-42ad-9732-267fbd893723,Residental,0.7597891960530597,16,11,419,1386,967,78.82723384928343,7674
a4a18cac-b137-467b-ad6e-db02d9b9a140,Residental,0.49267230906058235,14,7,367,1399,1032,76.10345828697278,2211
c6f3040a-7380-4ed8-935a-7bb58f7ec85e,Educational,0.7652882729119981,5,15,39,677,638,81.78830532811405,6194
630795ac-6d66-4827-aa4c-76a8de87535e,Educational,0.7898410851469011,43,26,675,747,72,75.02274973055103,3327
5d344ef0-9fb6-42aa-bdee-2606220d90bb,Commercial,0.4433838272099476,46,13,412,720,308,55.78538062427349,1756
66127f5f-5e3d-42fb-bf72-d47e0488a15e,Residental,0.7849925152516343,28,11,385,1340,955,54.66512927709486,2786
da8b2d2e-cef4-4f1f-87bc-3125b90413f6,Commercial,0.7457821562418688,45,5,497,1097,600,94.06827102840458,9984
d52f6b53-8e64-421e-9106-cea93fa24556,Healthcare,0.6551245602684209,23,42,658,1061,403,28.117663392391375,6329
aa2470eb-717e-4935-ae9c-c7db63388897,Residental,0.974242159389904,43,50,402,535,133,42.316017149214886,8606
1407f25b-91e1-45cb-8009-4692a6b32dec,Residental,0.29393484165494377,46,22,51,309,258,97.4092493467903,4179
4a64cf22-72cd-410b-a8d3-f8d767762c5b,Educational,0.09783377934678694,9,46,699,741,42,56.129541332941805,6319
4e37d12d-b065-4ec4-9d29-20ef01b7eb38,Commercial,0.8946105097266089,48,32,649,1315,666,17.01345809846738,3708
18d67f93-a0ed-4bc9-9bcf-c7464f8fa18b,Healthcare,0.7430726625637666,26,39,606,934,328,74.29423766005617,1757
f59ce16f-fbfc-497b-8b1c-6f169442bfeb,Healthcare,0.6390180452996124,17,18,495,775,280,76.5083746219828,1622
2666398f-a098-4375-a685-2c90c15bf853,Residental,0.12876841572210085,23,10,372,1174,802,71.33115310509532,3825
d2d6b361-80ad-4b26-9b59-ccf759142446,Commercial,0.5949400534835281,39,11,667,845,178,68.31318538952146,1394
1c142ddf-9a6b-4959-b718-4ff98a62cf39,Educational,0.48229070406948227,9,35,107,817,710,67.27126437380832,9512
08486330-fd1b-4774-bdc6-dabae8189d2d,Educational,0.4991980442586449,14,46,476,879,403,26.340688183392505,5419
7872842f-2900-4a39-9910-486736b3d054,Educational,0.33216007746564147,1,36,167,1027,860,40.71185206521288,3543
efd23ca0-be87-4cf1-9d19-cbb1a77905b9,Educational,0.3621190808133762,50,9,659,1300,641,47.61949148596963,3957
82065ffb-9928-4c60-a997-bdbe50e4c243,Educational,0.5944117837394729,8,8,208,622,414,10.442173073843154,6222
8fe8c866-d503-4ae8-8a8b-60082dc77910,Commercial,0.09872969668425924,16,39,98,1127,1029,76.3974947444126,5337
2d5d197f-1a82-4e89-a4fd-24e7ed5d5c03,Residental,0.12136698762012121,16,4,454,527,73,93.58946792212802,9209
0e21c14b-a19b-45ed-b8f5-a17ca57f3511,Commercial,0.42858144102370144,1,45,664,1011,347,42.73305728160202,9651
8a7abc03-e90d-4902-a699-1931c9214001,Educational,0.8266033185305646,34,36,232,774,542,35.39773159328422,8291
9b6e8647-c9e3-4adc-b10d-fb9a7919a6c4,Healthcare,0.4125841620239472,4,48,668,1402,734,71.70139772534041,2507
f3ab7dbe-4c89-438b-84bc-b2bd381680a0,Healthcare,0.5742679642034547,35,5,433,623,190,97.37157723091957,5469
3f6e23cf-f20b-4f75-a3ce-e739fad1e8d1,Healthcare,0.7210131076705234,46,46,241,819,578,69.18351830518927,6220
4481df96-f77d-4436-ad17-3d4bf5037ddf,Commercial,0.03702909252804387,39,12,309,1090,781,76.70789291647309,5795
f1b4e1ed-bc02-4339-8071-6030e4973b92,Residental,0.39914020143318685,17,14,100,667,567,69.96500582323105,5430
98372ad4-f82d-4a91-8c58-1133a4181cdd,Educational,0.41205069288522733,21,21,343,416,73,13.884172251751627,6319
8cb460fa-c015-4434-927b-6be0b0221fc9,Educational,0.5121629686834169,25,48,255,1398,1143,46.51306912346668,2405
de584a9a-985e-4d24-a8be-65b2d83bc997,Residental,0.45443725817644276,44,46,440,885,445,98.12907758970957,6572
7eb5b2b4-9bd5-4560-88a6-b0c29d58378c,Residental,0.4150896482412685,46,39,240,1035,795,31.43175527516809,5185
687cd735-ff67-4e5d-adf8-9fd6c6b578db,Educational,0.17354818455623278,46,13,430,499,69,79.40135833408662,3274
8ea3e993-c789-44c9-8bdd-84b7181ccc99,Residental,0.7645481942329553,15,46,208,229,21,46.03270508959882,6611
3053159f-eb1c-4c96-9f11-8d09d0f71b5e,Healthcare,0.38959237294588767,45,35,596,1299,703,85.0876918432266,8188
5af6774f-1e44-46e3-80da-5fb767dd80eb,Healthcare,0.5983469509731264,45,37,84,934,850,17.81632385517981,4878
96835c05-fde1-4297-a3b4-30d3334d3bff,Educational,0.42057097574867686,45,42,229,763,534,73.06899209832645,3452
53d64530-df1e-48de-a144-6fe0e3ff23ac,Educational,0.9757333130187966,29,17,476,1018,542,46.850836809720434,3942
57cc0be9-8c4e-4263-9864-be75c71bb495,Commercial,0.3501662530947227,14,7,465,718,253,84.02927585514739,1358
47f23fb8-569f-41a0-b295-db086cd27039,Healthcare,0.1072188811497734,15,25,436,498,62,97.07425441361481,3410
e444202c-7712-45ea-af6c-1d123048f5a6,Residental,0.7113866055565601,10,31,468,1104,636,49.42755614718988,3328
f7ad9350-d683-453d-b61f-109c8f7844bb,Residental,0.4067464187009614,15,7,30,538,508,14.162020172613248,8439
64610130-a421-46ca-8951-65dca9ea8c64,Healthcare,0.8667344764095828,11,41,112,710,598,54.06621418693134,3646
a6e89efe-3452-4bc9-9fef-002e8540b0b4,Educational,0.4656461623082603,31,31,136,1114,978,86.4149213807896,1258
bb2188a6-553c-49b6-9f30-82306496178b,Commercial,0.27013476838771633,32,26,661,1386,725,44.32357085253647,4291
33127d07-9b53-4fad-95c6-e108cbbb1d9f,Healthcare,0.5124650948825491,9,26,627,1290,663,38.626605228562326,7373
b3531dbd-8dee-4da0-9866-9fb296f84f46,Commercial,0.7501577582811388,23,9,680,1286,606,56.89299057920768,2260
3084c40e-7a6f-4523-9c21-ed202fa73c29,Healthcare,0.7209776032539095,17,38,147,1234,1087,70.02967177697627,7165
63fe4390-8ddb-4a09-861e-2e962d5332a5,Residental,0.24763753808225608,26,50,644,1191,547,40.136755079497874,4906
0cf6cf3b-1219-441b-b7d3-0c256fe09922,Commercial,0.6308413419567547,35,15,623,820,197,35.917292723328515,2145
d26e053c-b2fa-4103-94af-949fe5de3894,Residental,0.4227428206022569,11,9,215,1072,857,31.803809689855424,4313
7cdcfa28-bb30-49df-8f39-806a34771cb3,Commercial,0.868626952252916,23,40,465,754,289,77.77526957530199,2339
e882414b-6172-4d74-821a-8bed8a1418d6,Commercial,0.44432593523992303,9,5,596,1340,744,92.83888690170987,8728
741b8dc6-b633-4a88-a82e-7343a72c85a8,Residental,0.4771472054978064,1,40,291,489,198,21.80962902780414,1615
29b26c3b-fc35-4657-ab86-d7038a249e7a,Educational,0.8190927487422144,44,28,595,858,263,46.23286644816323,9975
9a99a19d-c8da-41de-98cc-acb11e95c3a2,Healthcare,0.18424057619479894,2,31,582,679,97,81.91661482044627,1523
427464aa-bda5-4f6b-9c99-ab22388860d3,Healthcare,0.23223440163413078,49,50,365,1113,748,74.18079339429707,2855
32e73e25-39e2-4d8f-b98d-bcb62fd02333,Residental,0.5307765737360897,47,10,222,857,635,84.57900552313527,3786
08c08d2e-df4a-4b9b-a00a-f28e6de071d1,Educational,0.9079898608507884,44,35,372,425,53,63.11865312644794,1333
32c996fb-f0ea-48ab-aee9-50791d7f7728,Healthcare,0.8051614741578038,2,15,10,230,220,88.00499485360154,5021
ccdf9979-270d-4d61-b709-79de6b0c79e7,Commercial,0.988260809192181,41,42,293,1126,833,88.02529174915155,5046
36e75bd7-127c-4b1d-a133-abdb58b422c1,Residental,0.01627192199419103,47,46,311,731,420,45.50960075213657,1452
5e073d40-b8bd-4e0c-a1b0-24fc4773d0b4,Commercial,0.006672798575832806,27,25,677,1362,685,17.93053799732581,2331
28cfe1ba-0599-42fe-a32a-fc260476d687,Educational,0.8503756943457891,28,26,302,815,513,68.81588578805986,5428
00107ed1-2d84-4e11-ad60-33f7123105dd,Residental,0.4409432435056747,7,13,89,1268,1179,74.57066839250216,2720
0006db11-7cda-462e-b764-f9a21abb18d5,Healthcare,0.9111515255158873,50,13,319,675,356,37.16719894331909,6810
2503a0b9-4d57-494f-9b98-ede150c01dca,Residental,0.26035205165154107,45,32,583,1354,771,21.898985046037886,4964
c1488b99-c181-48ea-bf9c-fafb145cce74,Educational,0.7928955218541199,2,45,574,1406,832,70.71981369373947,7961
92871b8c-2da0-4e93-9c75-f147ba072e0f,Educational,0.9560891421085975,21,30,355,579,224,83.74864682024852,8190
c24b2bd2-65f3-4a04-8d92-206ed7a37cf7,Commercial,0.9343933803516804,3,22,377,474,97,40.30388753589855,1222
b4e13c3d-1cb2-49c1-8d94-1ac57144cf46,Educational,0.6507270247003665,5,37,211,671,460,41.97309831069293,6333
3cb039af-3b7a-4269-954f-fcfdb0fe6e72,Healthcare,0.5404447862971199,16,30,158,1232,1074,92.39277970378339,1235
f2eac9d6-d07e-4ef7-b8c9-f138b3bc57d8,Healthcare,0.20148917154652257,14,41,329,973,644,58.62847528866151,3332
ee0f3a44-9c6c-46a8-a4db-66c1d48ad8e7,Commercial,0.29710473017839323,32,20,91,249,158,79.15210764654336,3533
b73b9c4f-2697-41a1-be0a-84b932a57739,Commercial,0.6068163980056402,48,7,259,714,455,82.92223432114167,7131
1292bc7b-99c3-4a48-8b9f-d7aebe3de34b,Healthcare,0.1035253224617052,2,9,348,1193,845,70.38250949752138,2327
ec19612e-c076-4633-83f9-ecdb63016648,Educational,0.15876582085540436,29,14,289,1257,968,28.999488105374454,6284
0847beee-7a18-4a40-8b44-037639902a88,Residental,0.4762518461955646,4,17,604,967,363,93.95895272275237,1219
ef5b0d63-2ad0-4497-9f4f-cda3a956eb41,Educational,0.8035427890962181,35,36,603,1257,654,39.76856676497071,8325
5ad0f3cd-e738-4672-920f-f1f835a1c82b,Healthcare,0.8436153807413188,30,44,328,1062,734,12.922649844159412,7726
e4199e46-927a-4386-a831-06d62b26a992,Commercial,0.2306493680221362,16,46,569,1265,696,63.52656639673492,2107
a8b24e5f-85df-4610-8bc9-09f0b68eb6a7,Healthcare,0.3795014349807013,10,7,699,702,3,28.23924624756685,3082
b8bf0977-a844-4572-ae7f-f0ea434b295e,Educational,0.6577488239094248,46,41,607,729,122,67.91325104119309,3597
d5754393-c14d-41db-85e2-aaa46f95184b,Educational,0.6507468584602867,38,7,317,1095,778,95.97734350766748,6276
1188a804-2e2b-4a1c-ac82-75cb43ac09c0,Healthcare,0.08599859459130232,43,45,696,971,275,23.77033677465956,8146
373c0065-27ca-467c-b1f7-3db21ec7b71d,Educational,0.8981079331082928,40,41,281,1333,1052,96.50777425101637,8957
43555ad8-bad5-4ab5-8b5d-c1535dd5fac2,Residental,0.4249945421828215,9,2,528,1077,549,98.99981095687181,3955
10c5e41f-4ade-48cf-b589-240977393eb4,Commercial,0.880611589764649,12,17,271,1178,907,61.5268881409244,7785
fa434242-4ca3-4b25-b413-3cf601c5a6b6,Residental,0.7932824199022492,28,23,259,1071,812,84.58474615064267,1107
f75ec6f1-a028-48c4-b385-9df3b1a4e464,Residental,0.8138308299878646,12,26,95,218,123,30.888379873905563,3391
76262bbf-bf18-41da-9192-b2925384dc8c,Residental,0.5805569410487055,39,13,78,79,1,78.42907174927814,5659
22d30acd-d93e-4440-a07f-ae12805e4b92,Educational,0.5488795955499731,39,13,597,1000,403,68.45859792896763,6078
0eb30c8f-7154-4499-9243-cf5799d41e50,Residental,0.6919026690945465,48,46,388,776,388,69.08159747242684,6289
e597941f-d2c1-43ed-a879-bd170ba3f667,Educational,0.7186917961736464,16,38,531,1324,793,79.05829556055424,7997
37a55645-a105-4c55-8081-9217608e9d23,Residental,0.1894061907675616,27,6,81,657,576,73.89529851998492,6230
cbd27b64-1ffe-4780-a5d1-2309a3e5521f,Residental,0.44952417569175496,34,9,494,639,145,79.38829708610206,5638
056ca627-d790-47d2-95c3-abddab283968,Commercial,0.9888227763321981,4,46,482,1132,650,68.47857236262436,7461
6b56025e-7c12-4557-8000-0cba9a26bdbe,Residental,0.9432771230596407,45,22,476,555,79,43.24975365234097,5789
f234e6d0-7a75-4b9d-9a35-872fcfbf6779,Residental,0.3500454821847975,45,42,625,965,340,26.16931478211039,1807
73efc9c4-926c-4bbc-b742-bfc776c5b7bf,Residental,0.2436185517631796,49,11,346,688,342,47.838518392806236,8726
8c7d58d2-bd29-47a9-be3c-102cce97385d,Educational,0.6971849512087068,26,38,168,307,139,48.14445306347132,7649
deb54e8b-e767-40a3-aec9-2af9fb26935c,Residental,0.18573263132271756,17,21,401,996,595,69.11490779510291,4617
3800c367-c778-4667-8527-d91bb5ba4a71,Residental,0.26444667195212235,49,48,267,664,397,14.695822405996346,5649
76c153b8-4809-4c46-bea1-b363e3e83ec6,Commercial,0.4582108371129455,22,42,644,1287,643,65.1756461914315,1167
18b84564-bdab-4336-b2e4-3550220a37a3,Educational,0.8033655585859414,36,11,520,824,304,43.985798255185884,3566
3157c619-ee57-47f9-b833-708744f42726,Healthcare,0.17471930973113592,16,18,22,294,272,25.287790168297622,8349
cf03f329-44a2-4f72-9eda-830ad0501c8f,Educational,0.8914774213858363,2,6,690,1422,732,62.95946233054842,4682
ab776297-dec6-46b8-badc-2595a743459c,Commercial,0.15760623791964212,46,45,163,1379,1216,17.588559136360864,9628
c683e010-7448-450a-b32c-61f0053c7823,Commercial,0.6599502538503338,15,20,494,565,71,39.9834304320228,2183
e413ee74-dcbc-4b2c-978a-cbd81362177d,Educational,0.6196945087841615,38,32,212,938,726,50.452673446331474,3720
b05ae718-8c67-44df-8962-dbab65aaed9f,Healthcare,0.63975377823834,29,8,644,1140,496,16.856708816219772,5252
172cf884-3b72-4978-ba95-bd3fed2b8b43,Commercial,0.7427656556647035,36,10,253,614,361,49.137865432749436,2747
9dbff3f8-bc0e-49e9-b38f-6340542a2e17,Educational,0.07428245504532838,29,2,99,650,551,96.70779361551713,5619
4b15f7f9-6a53-48a8-a79f-e95375ffad7e,Healthcare,0.705696490633987,41,12,360,1199,839,57.34054936591595,9685
7da6b441-d2f4-4463-8e54-1fcb9643a17b,Healthcare,0.39096552231725623,48,28,264,759,495,85.777305795938,8999
fa9261d3-eca7-44a4-b3ba-5eca0a2a3fba,Healthcare,0.005374254755391328,27,14,207,750,543,58.00099413405105,3355
f217fbcc-412c-45b3-8d10-21dfed73b66d,Healthcare,0.37339021394802063,12,17,404,1321,917,87.96621487482183,6619
994decc5-08d1-4128-9048-dd9599af6150,Residental,0.35916549508201323,50,41,85,714,629,60.99504591278258,3670
7113637f-9628-4aeb-8fbb-12936d5a415a,Healthcare,0.7214726189000397,17,10,424,1030,606,18.610697508035763,7238
8792775e-f328-4358-a578-07d80b214638,Residental,0.5755200809431943,10,12,433,1117,684,91.58050935802862,5872
921d5d33-e222-4bae-900e-3cf5cbefe193,Residental,0.16002582481258787,16,49,302,1220,918,91.8208448229294,7261
1a2ac15e-798a-48cb-a6d6-dfc2ab97201e,Residental,0.17330857117440313,14,40,355,418,63,64.19984190735038,9782
b45dca6b-c76c-4477-87c6-7aaaeb43a6c6,Residental,0.8223647697335729,1,7,269,1273,1004,49.599226520098696,3762
19a85020-d701-4ac2-b06c-c418c09239fc,Healthcare,0.5025631296632862,25,4,428,1156,728,59.732477022855655,7824
c1aebae7-5243-4a1c-ae7f-f59fbb39b07a,Educational,0.949791599328685,35,50,560,1306,746,45.007357869212676,8463
181ddb33-22d2-4af9-b765-154ad632c29c,Commercial,0.6836578085931615,46,16,393,1088,695,78.5966255951044,9523
cc7eff7b-ca9a-422f-a08e-1e88448b1ad1,Healthcare,0.4007882240113281,7,30,336,1028,692,92.06712106585942,6273
3aa1d24a-5b5d-42b0-a8ee-b2ab13f1b4dd,Commercial,0.3138218199887942,31,26,271,1313,1042,69.84584606759708,7987
fd8ceaac-a9de-47d4-8341-fe59768dba2f,Residental,0.3092510141076753,31,36,263,381,118,19.015300215904773,6110
eeb5f14c-19d7-4d6f-8e8c-f22ab0a473d0,Healthcare,0.8321305063012966,25,12,720,968,248,88.89042607378943,1138
54bdc8a1-4e94-42b5-9e11-7a058acbcf44,Residental,0.5527547261787025,32,41,52,664,612,37.28784226778781,3138
0a56c7dc-58a0-40db-9aa3-24973e2dc0f2,Commercial,0.3925524844164564,7,15,91,505,414,40.02703636515449,4352
58263216-2f9a-4074-9a1b-2136a04d6f20,Residental,0.3062593709025726,47,38,92,1217,1125,48.795004361004096,4116
96fc3ad8-883e-4048-8657-a59b7a7ce64e,Educational,0.3343374911220752,27,46,553,953,400,10.08686304364889,2566
ccdaf11f-d03d-4f16-9054-32e929273d80,Educational,0.9716845048339952,39,27,555,974,419,17.79544743519478,8730
330c8441-90fc-4131-916f-93a573f45af9,Healthcare,0.007323612039283001,9,41,337,693,356,38.255636984136075,1429
7df5e228-9e39-4c64-9599-66f51e9afec8,Residental,0.4686496287815878,10,7,56,482,426,16.369741535612032,2554
c18f2557-0aa3-4f30-b0ed-65b3dbe29c46,Residental,0.7978551204113804,4,50,330,552,222,78.71840392865724,3626
a4fb94af-c491-4c92-975b-691e88ebafb1,Healthcare,0.6063809367205667,17,36,654,969,315,20.98720077291163,8879
03a2633c-6410-4274-b4d3-efa82c203932,Commercial,0.26468214010540736,50,5,425,1389,964,57.972958793006164,4893
d7b6599f-9050-4ad7-a934-771772993a50,Residental,0.6543816056229639,30,31,320,588,268,61.789105406782774,7776
b1a7e174-f0cc-4290-897b-64995191039b,Healthcare,0.08046347740151749,19,39,568,1127,559,98.91740921116238,8427
dbee0c83-50fa-466b-9e90-ad0898eae51d,Healthcare,0.27120236974654843,43,1,294,1050,756,92.88484071935646,4848
c8b72f23-e96e-45f2-ae07-86cd6dd360d7,Commercial,0.2130054606983428,35,7,121,957,836,22.86180864776604,4770
3cff0b20-84f7-4b7a-9df4-9e1ee27221ce,Healthcare,0.3912724047179129,45,12,134,1121,987,57.15178082977556,5015
6413fdfc-03e8-41cb-846b-49d09417b6d5,Educational,0.8693477146619129,13,23,293,855,562,65.51143816467687,3636
eff0fbdb-e274-455e-b1b0-6fed16506b10,Residental,0.5625935762031115,38,25,617,644,27,14.832689248584966,6129
0e16a1d3-7ce7-4252-a0c0-388bb9844ff0,Educational,0.6132260482851248,36,46,386,505,119,83.55270239754331,3169
da95703e-3fd6-4175-8197-6ebca3d0c3aa,Commercial,0.9334486360816711,9,26,242,1321,1079,50.68426551874019,9828
9807a1f2-abd8-4982-b444-cda9e88d04a6,Educational,0.2392213264856624,26,36,561,1087,526,65.80009568841476,8293
291a749f-1321-4825-b674-e28eca31ed38,Commercial,0.9297169712261448,19,12,466,1122,656,92.8871655821449,3099
812a26ad-6bce-4d7f-b692-5d8f192dcdff,Commercial,0.2976280300575366,38,35,499,522,23,81.72930673366331,2750
8246828e-7ac2-43e4-a3ba-b40ee00ef051,Educational,0.24431650744778932,48,1,433,557,124,20.326930779033937,4317
96f63c24-e33f-415e-aeb7-dd0853c4020e,Commercial,0.8166141212276363,10,27,568,573,5,38.23407050135798,9192
95adbcdd-3ad0-4136-a91e-0c911bf88ae1,Educational,0.6937112286527545,8,30,584,786,202,37.783757439869916,1194
c0090d7e-c2bb-4afd-975e-da505c23087e,Healthcare,0.6497442682336445,22,18,718,1081,363,51.07884752624133,7364
53b4b58d-0391-4274-8488-63cf8f7d7679,Educational,0.9753031926869755,13,18,272,398,126,31.670032559536345,9949
16aebf91-aded-4a75-bd11-c9f55642d776,Residental,0.468761799884026,10,23,287,1007,720,62.85487326693666,1649
d95714a3-8f33-4ad5-ad97-046d777a5797,Healthcare,0.2202686810651303,20,22,389,1225,836,53.54595839939647,6707
ff5c8b13-7e9b-4dbe-bcce-c142d5735f81,Commercial,0.6808715010254648,42,19,166,278,112,80.34424953713341,9651
3e5db07d-6990-4786-b7c6-5cb530bcee4a,Residental,0.13331876352324745,15,21,301,511,210,88.74544359942662,1657
03181f61-fef6-4a83-9c6e-1f0d611bcb4d,Commercial,0.03096234195303138,27,29,121,1114,993,81.95549766836493,7263
6475efbe-f201-49b8-9ae6-15e3231c2374,Commercial,0.363459956863883,5,41,651,700,49,38.09098337972068,7181
cd7f9cdb-e33a-4b31-9eec-090f692ee8db,Healthcare,0.008290923130939487,7,27,424,1177,753,62.75269393565819,3977
7b34ce1e-281d-4ebb-9813-477eb6cde5e4,Commercial,0.052330130037739564,9,45,390,1236,846,69.56755636911836,4661
23825874-aba0-430a-956c-fb552bfb6cc3,Educational,0.6837861325597262,20,23,358,760,402,69.22228340064174,1586
f907f8db-ff1a-4e7f-b9b5-2f301db80c52,Educational,0.8179146435475754,33,29,538,1239,701,46.25306626941621,1633
019365cb-b654-4b3a-af83-da04619703c5,Residental,0.8028573332833358,20,30,643,1029,386,18.11994581713735,3546
6136e1e5-fec1-4dba-a7d0-36f8bfbdb895,Commercial,0.32817702162389795,7,29,302,1023,721,75.86182375892875,2670
061ef123-9f55-49cc-9852-961b81246c86,Commercial,0.42958832539786906,16,27,595,620,25,98.71747770882757,9384
054ce1ae-e452-4eee-bee7-6db892733b9f,Healthcare,0.6692969086592042,50,35,249,690,441,89.98638776618083,4527
f47d3a64-e148-4652-91b4-25aadea18dca,Commercial,0.4638993612922112,31,43,404,449,45,86.92177637412435,7132
01b5fce5-3976-415d-8736-d8e4dff646fb,Healthcare,0.6558403028608037,46,12,193,919,726,29.3466366865509,3249
fe497c70-cd65-4ca1-ae7f-d09b93975fa6,Educational,0.8578838012885229,1,31,439,1009,570,62.955292748325974,5814
405f6058-65d3-4afd-a117-f52f059fbbe7,Residental,0.691105020497076,4,25,666,1124,458,54.226919127115956,4881
91de02f9-3ad6-4e0e-a9bc-f1513a664e58,Healthcare,0.17120110450059756,26,24,554,1165,611,55.917324038865814,1473
25418a8c-1d2c-4c48-a6c9-b6d9c4e2485e,Commercial,0.7480294962250685,15,11,246,1283,1037,26.389355161497207,3493
25b899eb-9093-433c-8c62-eb841bf9c83c,Residental,0.7779509086703973,45,14,249,654,405,11.655515622426387,9565
e1fad68b-b7d7-48e1-bcf8-e7deb483085e,Commercial,0.16907694000374518,40,11,76,1289,1213,74.55565147424622,8634
10238968-483e-4357-a6c8-b350ffe3fd20,Educational,0.13425639074505558,15,44,667,1256,589,73.31458435912829,9129
a053066c-d9f2-497d-a1a8-73a37b925287,Commercial,0.1145034270100228,47,44,131,863,732,48.08184407268628,8762
9559f127-dfbd-4876-9eaa-354996202836,Residental,0.15497677577805047,23,35,602,669,67,95.50190449576883,2907
36619440-95aa-42ed-b67c-11e7b335c8ef,Commercial,0.08174729588973628,50,50,601,1229,628,78.04174464858819,9048
808805f3-6d20-476e-b559-84c37760c5af,Educational,0.057614461727214406,9,50,214,755,541,92.38608595976514,1000
e41d107e-1e43-4caa-81c8-2f5600c2625b,Educational,0.18885964048191195,44,16,457,1437,980,45.91049197270694,7038
74edb502-a63e-485b-8319-f7dd9d922df8,Residental,0.6817138096275173,34,4,128,713,585,47.91103392598776,6066
0fa92e13-7141-488f-b62b-d207450746f6,Commercial,0.5379983892472108,21,14,586,723,137,27.51923677726238,5524
daba9dd0-dce5-4c2a-92e6-c177d5d98b74,Residental,0.4011886982898767,18,39,381,1260,879,35.214785653545405,7302
8e885bbd-87db-43a5-bd3a-09504089d1db,Healthcare,0.5856488646706095,40,24,707,920,213,46.94036681285091,9586
20cce2fc-54b7-4c85-bda7-e5e287eef090,Commercial,0.3230548115248574,13,35,535,588,53,83.3991115430042,2641
a64720e9-e04f-4d32-b3c0-88731a7dd3e4,Educational,0.07926851925792866,11,45,663,664,1,89.46263488731881,5768
90c3964f-a247-4b72-8df4-c776fa883fa9,Educational,0.2198218941334128,34,16,199,380,181,66.01946713860679,4567
e0e2b676-e455-413f-b798-865ea40a575f,Commercial,0.5589921671111826,14,8,619,1319,700,55.20021535866068,7015
1241388c-160e-4f33-a9af-163049509492,Commercial,0.20885987927317617,29,20,630,665,35,22.12672127194716,2776
3903370f-6675-4ecc-adf3-cee0eab6fd63,Residental,0.6162235157510875,26,35,347,1265,918,19.831797164230935,8573
207654e9-3232-4c5b-827f-ba174054adb1,Residental,0.8227784225375979,39,13,606,742,136,27.93000123097298,9704
a5b2ac03-6db7-4f1d-83c5-539b40078fbc,Commercial,0.39031081093415776,31,3,596,808,212,90.23426527928248,6391
c7eb89d6-4684-473b-a5fc-90865ddb2f71,Educational,0.1513036604620418,39,30,697,1388,691,78.1221599302637,4790
62eb6539-eadc-481d-af77-b5fdd5e97632,Commercial,0.9835692657174491,13,46,429,557,128,51.87426129937733,9755
3d4cf80f-f6e5-4f3e-b061-b0e979a23e82,Educational,0.07568555281271161,8,30,506,1139,633,70.88291894477351,1199
0a4b451c-b421-4f12-89c9-2f480c4013f6,Healthcare,0.5961974523825297,42,29,648,1053,405,84.21544143245193,1475
b5aa6649-a01b-430c-8a71-6f709ffa26cc,Residental,0.5297626641210682,42,12,11,502,491,35.100235873618146,5914
ef7ee009-0e65-4c8e-9766-050f0d50f271,Educational,0.5620016414497184,45,7,45,1012,967,22.72507199784146,7530
6a133bdb-a77d-4b41-8eb6-be21fea5eb67,Healthcare,0.1453751314011481,17,22,545,1193,648,46.032581916291136,3875
7c4282ed-0516-4dfc-b395-856329360e34,Educational,0.05876968487628864,43,17,291,686,395,12.909854615007983,6408
eeeba9c5-99aa-4e01-9267-8f813ff777af,Educational,0.9768178585777332,2,18,622,769,147,36.41502782166911,2516
8aa31f8f-a318-4273-ad6a-76e717c94fbd,Commercial,0.5293032304668519,33,29,5,640,635,40.297868763548195,4291
716126d9-b4fe-4ae2-b68f-926a698f416f,Residental,0.04535973176307595,34,38,344,1069,725,98.11113600345874,4494
8999ef3a-13a5-4f59-9b57-dd5826e06b87,Educational,0.6671773252077233,6,28,172,1179,1007,32.96689689855948,3065
e4fad4a1-6070-4f51-a907-2643bc882b91,Residental,0.8177190097675254,23,45,465,1266,801,65.21795974354913,7019
bdfabc5f-6612-48a9-a902-bf79ac6719f7,Residental,0.7106851753626812,27,33,36,139,103,84.07457292345342,5047
6f257dd1-5251-49d9-adf1-efb7013dfe93,Residental,0.8226984314900238,47,4,37,1334,1297,66.74478088369054,6467
5771c995-261d-469a-b45e-64d899a3cdec,Educational,0.425953993467696,49,42,653,1037,384,67.48654299519461,1702
9f26a4af-c1e2-4111-ad3b-039413d2f43c,Healthcare,0.04321130767176118,7,33,713,740,27,16.194747001148418,1022
7f403ec1-8e91-4290-ab59-dddce980d2d2,Educational,0.1754628437820699,31,18,256,322,66,18.958808892443102,2425
f44b8632-0c31-42bc-b098-149dc5748eed,Residental,0.8555875627203737,4,23,494,1385,891,24.57655505692324,8418
bae948e3-15fc-48b6-b4b1-aa3f45c8ae48,Healthcare,0.03164731285993427,44,26,372,1033,661,67.84254752892343,8943
8659bcf3-cae5-4097-bad7-f2f00c6b34c4,Educational,0.8195202602675492,45,43,385,1410,1025,89.81087045981332,5362
e18fe482-e579-484a-b1c5-cd479f9d41a3,Healthcare,0.5208348538143219,33,17,673,1190,517,78.3505294693785,6403
5e9b40a8-5e45-4d4c-afb5-98935956d55b,Educational,0.40884806952985997,47,25,716,1150,434,53.02288418831421,7560
4da29ae9-cb99-4ccc-9e01-1f535da8e7f6,Residental,0.753659072111208,23,16,539,978,439,64.34464665375093,5109
0a3dd199-827f-426a-b0ad-af9518605aed,Commercial,0.9658831786896693,17,28,549,893,344,66.98430635999128,3435
a805b843-1d81-4208-b056-1aac38064890,Commercial,0.2169461580071428,13,1,115,637,522,29.34321795977265,1476
70e6234b-471e-42bc-950f-2d0687ed8c25,Residental,0.04941907666014966,45,21,406,983,577,89.55554923508986,7991
c39a2461-df97-415a-b1c6-292b3b199ac7,Residental,0.3297653194415946,31,13,491,1110,619,74.46411738801164,6122
c6c163ec-60d0-49aa-b862-a13bc1375aeb,Healthcare,0.5260911635370487,21,40,469,1336,867,27.828703098967274,5135
31102178-9044-4c98-969b-01950861d678,Healthcare,0.537247310020381,16,25,505,1263,758,42.0598994308535,5583
06f1900d-7a9b-4e8e-bb8f-db0d37f0a06b,Healthcare,0.9637686141285138,44,16,687,1060,373,37.54907366895668,5672
5d610d26-e70d-4d48-afc8-a58a3e75483e,Residental,0.7890927904416389,40,44,514,1357,843,27.25333087603605,4843
70e318c6-e725-4bc8-b27f-80b576cf1e48,Residental,0.8467433119793805,23,41,472,1310,838,72.51670358918416,3572
b161f1d8-06f9-4cd4-a529-dbc3a0714a8e,Healthcare,0.38828413435460196,37,38,419,1247,828,94.27855748183364,4613
9ce82a3f-e13b-4fce-91d8-e028b8b9c32f,Commercial,0.20131179112074415,6,15,479,1221,742,36.17044663259803,7359
c7934808-f36c-4faf-a7ec-a9b312a05ac8,Educational,0.7437848655837626,40,48,119,781,662,88.25427952595156,9611
a0d5024e-770c-4173-a43c-46227f887e28,Residental,0.4844015473457186,41,16,74,660,586,86.41924174301184,9441
5c3714ce-2ffb-43bc-892b-5450928234e5,Educational,0.637951636435338,22,42,654,1010,356,20.93751812390394,3600
874d6dce-7266-4fa1-99b0-d57987d72399,Commercial,0.5934271324919442,28,2,328,1303,975,49.1787106989182,6259
bd9fd8d9-3b1f-4fa0-8eed-f45e3ffcba1c,Commercial,0.27628621636626316,13,35,314,682,368,63.455495359795385,2533
ae515c07-216c-47f8-a18c-b7952ca698b0,Educational,0.060458325164193694,10,35,313,325,12,12.443393048053952,5717
cc39b76e-3682-4a3a-af81-23c568ce216c,Educational,0.7985335680235123,29,13,179,806,627,12.377112015809633,9613
ae118d52-b972-49e1-b235-1da9b1447d5a,Healthcare,0.448625774781916,2,16,317,870,553,14.421239550859415,5899
33bc0c98-7fdb-4109-904e-85c5a5b2a658,Commercial,0.6777050545119266,17,49,598,1037,439,70.48053753286217,8666
5fd97e88-60eb-4bb7-b0e8-f709c1fc4068,Residental,0.8171714198266146,3,7,461,569,108,98.94564187432232,1604
32779c4a-c4e3-43db-856d-188a2e748243,Educational,0.5969700913346853,21,7,508,531,23,10.464726491105896,5944
ed6ba192-36d8-43f8-bc34-766265bc925e,Educational,0.6311887732994957,11,14,142,1291,1149,11.6173724389662,2821
5682f012-b3e8-4c16-aca6-d5f0d58ec6eb,Healthcare,0.017128554567420684,10,22,528,845,317,57.12770298306003,4560
0bf6f096-13cc-41d7-98b3-a9cb9fd3c491,Commercial,0.6153089294819185,16,14,122,1144,1022,69.39002802477052,2618
09bdd4e6-3586-4e5f-8ed0-629a981613e8,Residental,0.39394054752857366,42,42,297,367,70,75.371480629315,4042
28766cf2-52ad-46fe-a8fb-41f6180d32b2,Healthcare,0.9258979204623264,2,35,521,1250,729,39.96933291426511,6029
b4bb501f-337d-4901-a395-6ea7d393c5f0,Residental,0.8650941603344903,34,1,366,536,170,34.08775016866173,6308
80180ef7-2a68-4b92-9e39-6f72af91e41c,Educational,0.4641194962919125,42,12,369,694,325,65.40215451109259,6371
46d59420-3825-4abe-b321-670c2392b29f,Commercial,0.41485619712999555,45,33,148,1218,1070,16.184472161834115,7341
1d7b88cb-61b1-496d-b3ea-7204de5bb386,Residental,0.7082385702312366,9,31,312,897,585,28.75388604503864,6792
05954237-3149-486c-afb1-82914bd3c06b,Healthcare,0.1491906337365797,18,10,540,1034,494,81.70776290465994,9791
e5d28dfe-68af-44b1-949a-274a2c0ea80c,Educational,0.5537417216983503,6,33,672,920,248,50.00708282286497,2778
16cd6ed8-abc1-4d2d-ba38-8df10a81b017,Residental,0.3196130559153032,40,11,177,269,92,31.11063554621812,7254
9cd8aa8f-5beb-43da-b297-a4d632b0b682,Residental,0.340768853354416,21,47,633,1332,699,37.93873172420718,1839
1a8c3a91-420d-4448-aa1d-054d4a39b25e,Commercial,0.9903645845763579,26,15,160,852,692,78.83322884842386,8075
19b045e5-a308-4377-8caa-d302aa35cfcf,Healthcare,0.9478111431140089,4,16,164,862,698,68.14429475465973,1089
49fc1d2a-bb41-4d2f-91f1-7b3d66995395,Healthcare,0.9797428259751948,13,39,278,465,187,51.17739777103606,8762
173c21a8-e9d7-4a17-be3e-f055db72afaa,Healthcare,0.008471668287047707,38,31,496,983,487,70.73252962724521,4902
b3621e67-ad65-42a5-9403-133cf7c52d2f,Educational,0.38050436378630215,29,27,498,876,378,69.82331819797258,4376
f8d4472b-77e1-4196-8ec2-ea69a6af33f5,Commercial,0.6314863870975327,33,21,713,1139,426,37.90020374317467,8235
c3384d91-3e77-4fdb-af54-d5da7427e54a,Commercial,0.19847217271984363,19,38,587,622,35,43.11169592172974,9842
28da969d-b101-4c2d-84cb-e1589cd1f73a,Educational,0.7584946517006927,25,35,28,344,316,12.888549297756544,5575
4d657d4c-17a8-47e7-99ef-2298f786b8a1,Residental,0.5507170890431434,1,43,419,787,368,95.40449100178019,9961
c32a3340-a976-41cf-8740-c00cd7d20258,Commercial,0.6135812224636558,24,40,164,1198,1034,48.62426452920123,3831
526b2500-7a9b-44b0-9798-cb9b6659cf67,Residental,0.48861731651653184,6,23,363,1319,956,53.05685608161886,6879
8a933093-912f-4739-b525-68c442ee5e3e,Educational,0.69724201203597,23,32,496,1126,630,63.65721789847518,9417
d4206521-ba3b-41ba-8cef-ab349b7c4572,Educational,0.2615926045618654,47,19,80,299,219,24.035454575809883,8396
601cbf20-41a1-4de6-b074-a76fc83313cc,Residental,0.2695038563513057,33,16,153,1404,1251,15.32855803952821,5597
ee572725-b8f1-4283-89e4-aff2be23fbb7,Residental,0.6918580727341749,38,5,190,790,600,30.71708193435553,6150
dc1f7e9b-b3c0-4ff0-a631-389925d8f40d,Residental,0.9467968226544243,8,20,672,969,297,37.460405805502134,8856
67132dde-218e-42ff-832a-fe31db88fced,Commercial,0.15573802278284565,28,10,293,400,107,87.60596101316466,1775
8976f6a8-7421-42c2-b94a-274f170a0d9e,Residental,0.0624758235374987,24,37,253,490,237,12.007258434579864,2142
78c4be40-c5bc-4ff1-9113-19c39b02f705,Educational,0.6434660818010219,23,13,21,600,579,94.60388935119313,3396
6fce89d5-7c9c-4efb-a523-cba5f47396d3,Residental,0.8215494975829294,21,15,486,1325,839,15.041343945844368,4196
6e6f8f78-fd35-4094-a12c-b8b840ec7115,Commercial,0.6169840575167095,33,11,272,715,443,22.97654369587068,7344
a0546fe3-4fc3-4964-a9d4-252dfb000354,Commercial,0.5806535727171467,21,48,304,1024,720,48.01882661402599,3830
6ae85775-93a2-4fcd-afbb-35a7a6674a04,Educational,0.8601496857313695,38,20,664,936,272,92.73129502796552,2107
da55c0c6-ac41-4173-84bd-5bb9308fa3a2,Commercial,0.869203937440237,39,39,713,810,97,25.638405904227948,8320
9d471601-a374-411e-8277-28c02436be7a,Healthcare,0.3321274802063394,19,7,556,1270,714,88.03355302527588,8367
cdc66095-4f24-4234-a8a3-9fd9fc8df3f0,Healthcare,0.6541522081819304,9,33,14,285,271,67.41747537128907,5961
3f2c1e55-20d8-4491-b157-0e681e630110,Educational,0.7246032013305227,11,1,240,398,158,76.51523200444048,1342
0b9d2547-8d73-40a4-9229-58bdd8b14480,Educational,0.44148572608859593,50,50,494,758,264,64.74383143149947,8179
df8bef82-448a-4679-b530-8942aa40cc34,Residental,0.9202988047354845,46,4,537,1250,713,46.27117338959416,9351
79132c6a-10b3-4f25-8310-854e3b1198ea,Commercial,0.1674514271169586,26,15,717,926,209,56.67088837547597,5993
e81d70b2-dc56-4e33-ab25-877d525637f9,Educational,0.2543688032965986,10,5,410,1246,836,97.31342286965686,4763
8005e8cf-10de-4520-9726-bab293ac8f6c,Commercial,0.21089066985845506,48,15,615,1347,732,98.8690844478198,9163
77318610-9554-4a5c-8862-e43d8a67441f,Educational,0.07669264439644297,50,5,76,327,251,70.98298659466107,5813
38062571-876a-4700-b009-45105184c4bb,Educational,0.5586018069153253,43,41,692,872,180,17.224764009593983,2722
33facded-94eb-4526-8908-35fa159bb2bd,Commercial,0.3571024693869683,17,18,660,756,96,14.569857630639202,7632
628a6ed5-e4c1-4e78-b201-d8444822b16f,Residental,0.3353012477422468,16,10,686,1305,619,16.795640358051905,2502
ed05a7b0-eaa8-4d91-a0a8-efadbbb6e226,Commercial,0.17587124469640902,10,25,489,761,272,93.58952478597105,4686
522be5c3-8e94-41b3-8da2-1a83a6365c33,Educational,0.5761240404582415,28,28,253,688,435,17.902615517904014,4004
506956e1-1c09-49b7-a016-8144688a5814,Residental,0.8091092230463491,35,36,67,1287,1220,98.676357968883,2611
7b87e68b-ab81-4f91-8505-d33e05e83800,Healthcare,0.4448245556316751,17,23,371,1066,695,11.627018985828457,9402
e53693b1-724b-4bce-9b8e-11584dfe4e65,Educational,0.9328283931740545,47,25,517,644,127,88.12747449136685,1918
f713789f-411a-414e-9719-1d8cc4a80fda,Commercial,0.13134397472486803,2,8,177,573,396,53.95940440581859,3538
67638039-1bed-4ad7-bc1a-00fa1ebb6a48,Residental,0.6222243413036298,8,23,642,1399,757,59.12140262929754,1513
e89a5fb9-a50f-4487-81dc-9a40ed4345b8,Residental,0.8579914000724747,11,23,224,743,519,37.309420070363544,6813
1eb351b0-6aaf-4574-b60c-8dedda5a138c,Educational,0.029673699354565763,30,1,199,1423,1224,65.97765425782816,7620
0968c05a-ed43-43f0-9750-327e94dd8a53,Commercial,0.4973012940984095,34,29,425,747,322,36.43323283836477,8879
a562afe2-f0b9-46e6-b099-420a656ba32b,Healthcare,0.3438987526058668,24,37,126,859,733,92.64562401939058,3569
01fd780d-868f-45d4-b543-348323a3f531,Residental,0.32928561881268437,10,14,522,1321,799,31.04498347175144,3184
d38ab369-118d-4dbd-860d-d97140e1e2a6,Residental,0.8446645116072461,36,35,171,1170,999,53.849041463398976,1680
1bba7187-1c92-4fdf-a370-4b4e8eaa77a5,Commercial,0.6120442513769981,43,23,322,748,426,21.590768757429124,4321
bd3bee95-c84d-431c-840a-63ece87699f0,Commercial,0.8788338593223115,47,26,184,596,412,19.342921010039355,7330
96be3ead-deb8-4576-ab43-a57723db7448,Educational,0.2967718250054271,48,27,434,1089,655,18.650601189075573,3979
d8a3d1b5-16fc-4889-a8d3-8da33cb1b1e6,Commercial,0.6071691252018551,11,28,192,1367,1175,51.090503480925086,2855
0afe8206-03df-4712-9dc1-db722ef034d0,Commercial,0.8130615609585551,14,50,141,373,232,16.80470397228995,4632
f9d25e0e-5e90-4147-bafa-5070c721af4e,Educational,0.9184235921484636,48,3,566,948,382,55.85318940027761,8898
6cbcc28e-085e-4238-90c0-bfdad00c3819,Residental,0.24260902194161038,41,4,106,872,766,10.795450573467868,5513
3b01b923-a0c0-4a02-85c3-986fd3b364e6,Healthcare,0.054540839758444704,13,18,307,498,191,13.522375190064597,7225
3669272e-5247-4ec6-9c3d-7b32c7d2a930,Educational,0.7514605826484048,6,19,84,404,320,11.700656885385932,3741
e6d0d93c-5ecf-492f-a5d1-9514b573246f,Commercial,0.980925280243391,7,42,337,480,143,88.95175611775225,6260
f6a2f71b-ba93-48c9-9446-86fce99580d3,Educational,0.96007814457107,3,31,215,433,218,72.1271587123662,9732
869831e3-4178-4fbd-9001-c9f62e3f3be9,Commercial,0.36776990573058477,20,32,658,1386,728,83.22049042898198,8027
4ded0828-b476-4bac-9070-5dbc8b2a8105,Residental,0.24224733125296727,31,26,687,888,201,98.65163550615871,4178
2c364cfc-941d-4a86-ae8b-65981801c32f,Commercial,0.24291695988079354,31,40,620,652,32,60.26735669857166,4323
6d63f351-3fc9-421e-a09c-7af449e14fb6,Educational,0.30839916595279815,13,28,502,1083,581,37.79016611057904,1550
e246060a-7fc2-4469-9140-5153d874667c,Commercial,0.17646269103065637,34,50,358,1109,751,57.05735242382612,5804
96df40c6-d0a5-463c-8af8-9fd74d5f0263,Educational,0.47296676841109797,4,19,515,584,69,22.211149223904684,3127
9b9f6984-30a7-4188-8d9f-b22552c43786,Healthcare,0.9107762494747267,31,38,155,440,285,80.2985853141344,4095
81174074-9309-4606-a1a8-2b4bac120540,Educational,0.6334405457318513,33,7,432,957,525,41.93403513732163,3397
c0766e36-0761-4934-933e-0084de8a42a5,Educational,0.11295391949742362,30,49,197,1239,1042,30.30099346666298,8911
28ea705b-6ec5-4fa9-9568-2db6976e35fe,Residental,0.9065936485683833,19,49,458,852,394,31.5552357601714,9666
beb53044-b07e-4a04-b602-fc9496523efa,Healthcare,0.2933232876937065,13,9,347,1003,656,29.82676877036039,8907
314f03a9-8586-41a7-90c7-ab64e6d04ccb,Commercial,0.19496850580378555,28,17,692,1339,647,16.221301058474317,9778
c13cc0eb-f263-4509-a305-a28cc977c394,Commercial,0.5719813816468029,43,32,221,504,283,53.48479263111154,9857
d529b333-a88d-496d-8bdb-1fa63cdd01f6,Residental,0.3124888492815421,36,48,371,580,209,64.13466776748723,7059
23808ef9-84cc-4091-aac1-92e5d8357dde,Residental,0.49905210024511193,21,38,59,1302,1243,30.490789426782815,7182
9e88a0ae-4bc1-4b5b-b480-246cebd635d8,Commercial,0.8395222221741776,47,19,49,1212,1163,86.56089111403935,7697
6e0b544f-e7b4-4c98-ab4e-f8a2e7b084a8,Healthcare,0.4109508180534023,7,42,561,1184,623,66.57887080666475,6661
1b9102f8-0cb7-459b-ba47-5e06974b0374,Healthcare,0.07130641835853624,10,9,350,1340,990,44.154218697214006,8745
952e5b1f-571c-4270-b964-3c13eea7f545,Educational,0.4136629744206801,12,39,363,1153,790,97.35098810053293,3396
98ab7f2d-3ee8-4d6b-8795-7dd2cbf6d37c,Commercial,0.8017265473548588,21,36,187,1196,1009,24.53233386965483,6076
70dc96de-8e68-4a8c-b842-53db575a02ae,Commercial,0.8258991640975523,6,39,592,1352,760,86.18486239886035,8047
22947743-3927-40cf-a6eb-dc5952d6b437,Commercial,0.1197243158220408,33,38,577,1391,814,27.392554165652637,4645
2817e691-7663-4cbb-a1ac-3a63f995bce9,Educational,0.7605647269254382,41,17,456,1164,708,27.701210422557153,6751
24d96710-5684-4d55-96fa-36832ac03cbf,Residental,0.8707419794617577,41,2,461,596,135,80.21162333184728,9911
9b8fc551-d396-49ae-a236-43e1febfaf41,Residental,0.5953649533690484,17,44,572,1048,476,15.2475331809406,6189
c9b1a4b8-d074-4551-a8c6-261fed2bae9e,Educational,0.8771097439516183,11,42,207,306,99,60.641398298476965,1343
16978b3f-e735-49c3-9953-ad03e6d43b88,Healthcare,0.42442887447308975,48,48,543,807,264,89.99610976009893,2436
55481174-f64d-4f7a-9ff3-047e13f47268,Residental,0.49897167572719825,38,31,323,1078,755,97.60489858143382,7340
0972ec56-4987-4106-a816-0964936ae351,Residental,0.5352252968218256,21,46,299,580,281,85.10619235763826,1502
f537cd47-c6b3-4cdd-ba31-861cd372cd2b,Healthcare,0.9951587864636703,7,42,564,1262,698,33.08900803916819,2563
3e212860-cf32-4c0a-9ff6-a7cc555b3082,Residental,0.4528548566296766,33,1,82,1432,1350,22.83596574726517,9532
13a97b26-ae1e-49a7-9b27-43dcca74942d,Commercial,0.346074114786741,5,6,75,295,220,90.53006270544009,9406
9e5d63ce-f205-441a-8e84-12a6b06d431b,Residental,0.6683429260784417,40,40,181,1261,1080,85.99110129963398,8191
98d7e864-6a73-4c2f-9cd9-f5eab8301406,Healthcare,0.24835396541412558,44,3,127,658,531,68.05569773139152,9728
c502689b-9690-4a61-9e68-166e07bf1285,Residental,0.9920442460761718,50,40,153,1386,1233,52.982260964590324,1474
d0687d53-c5e0-45d7-8205-b3fb4e7a5ec1,Residental,0.9470354683182571,42,30,197,285,88,50.41921445072932,3689
f96885ff-1c98-442f-9a60-e44c3848358c,Residental,0.2679111814302315,38,7,198,722,524,82.11213067680885,1617
14d9e67b-c945-4d42-ab19-904ce028ba88,Residental,0.8168240737997334,14,25,127,683,556,48.49645512447215,9041
d89d0f0f-c0f3-43bc-afc7-41c0e203518a,Residental,0.3350277482114148,3,30,127,665,538,86.60564204403201,7994
dbc398a8-9656-43e1-b6a7-20de0d684262,Residental,0.9154918890414542,46,16,583,702,119,11.023510315226083,5175
826eea08-3636-4bd6-a2d1-65726bc43ef8,Educational,0.6177670500318205,40,49,434,1270,836,14.043925665256854,9988
bc273d63-7618-42a4-a209-d2b43538a9a7,Commercial,0.8598180736148461,40,49,640,1070,430,17.365209977927144,6417
1c8958ad-c4b1-40c6-bcae-4fc61f9d4912,Educational,0.34629320955585385,44,43,660,1408,748,12.370668580964779,6200
734bea88-d3cd-4956-b439-2b4cb1a8bffa,Commercial,0.7802823847832674,25,27,323,576,253,81.05511394884039,5699
7a9dc82d-ad9a-4b41-8d46-520e517cdbe6,Educational,0.011671389984829972,15,22,444,850,406,34.60701797144337,3269
1807b08f-d4dd-408a-840b-41920b499b2d,Commercial,0.4493313075688402,42,8,492,1373,881,11.780338295525144,8024
76b18656-b35b-4c59-9ae3-740a82ab6b87,Residental,0.6323875461185092,11,24,26,470,444,56.25433511359225,6834
90410204-bd9b-45f6-bc87-cd9a8527c295,Commercial,0.37175147886335413,35,3,132,425,293,23.447798519885758,4648
a8a9612a-c997-4ff8-b250-e127e2e2d54d,Healthcare,0.5683017962937656,43,30,614,1134,520,83.47635410942925,4582
356ba814-1022-403f-b1a6-c571ae113446,Healthcare,0.7913909269004746,47,21,631,1282,651,95.2392731191517,4244
4415d12d-e8f3-479a-a70d-6f8f94d71b69,Commercial,0.24002745374168055,6,39,347,1138,791,84.84883660051666,6933
1e223653-d02d-48f0-94e9-1a2ae81690c6,Residental,0.4331034436805863,4,8,370,643,273,24.264809396919418,4480
62148bad-bd0b-436e-871a-32814c61a534,Residental,0.7268799115297608,39,47,10,907,897,99.23720384685977,6381
3c2e069d-e688-4c4e-93b2-9e01b9011c10,Residental,0.10916601749221211,10,41,155,926,771,84.78213331211619,1540
b805efa4-5139-494e-a679-ea8707883e56,Commercial,0.08642690065800218,38,41,606,805,199,70.6047170230148,1665
8be075bc-264c-4445-994e-aa3571280e06,Commercial,0.5206151854114883,22,16,370,1401,1031,96.21422701520704,8226
e978e682-75b4-47d1-b1a0-0b2864cd6e43,Healthcare,0.34183991542324266,32,13,338,680,342,10.028510689413082,8311
e6fabbbb-24df-4bf6-9139-9a2474278cb0,Commercial,0.45469648028864773,49,11,325,528,203,68.5913537704285,3730
e800f9fb-f800-4050-8183-5bc4ed312e39,Commercial,0.8335987624641431,9,10,573,1344,771,74.04327587647349,6802
89d38526-4782-48c6-a9c0-8470fc2e2ede,Residental,0.09844872848608166,19,23,196,1369,1173,85.47099625758119,5105
1f8856eb-e66d-46fd-9b78-5f11adf1cb8f,Commercial,0.30533524427065883,40,20,170,581,411,85.23886086179375,1762
d1a78232-d5ef-4088-b0f6-81fcfbcf9877,Commercial,0.7398233546278435,44,34,228,257,29,13.78137076107733,4418
dc05438d-715e-40b7-994f-3c75e0d5e161,Healthcare,0.340885842310502,15,15,359,777,418,75.83871882849095,7549
41b43217-02c4-43cb-afd6-b2dce7b42f45,Commercial,0.9418141059396195,29,9,20,772,752,84.40249129098319,4192
d90dfb54-60d8-4244-9aff-98db9735309c,Residental,0.3931043426710744,40,44,386,1364,978,65.2726340074714,7299
0185e26c-852b-466c-b9ca-62ba4a416fd3,Residental,0.6022643246373968,19,26,27,256,229,39.657346815465715,6618
e5ab2f5c-a4ef-4ae7-96a2-0f45e4441275,Healthcare,0.12309599473047739,25,9,302,1182,880,23.461762021425407,5428
90ac58f5-70b5-440f-afaa-dfb74c2c9073,Residental,0.06308859243790799,1,21,511,1402,891,40.53836345099957,6490
e5ced45b-5bb7-4f70-90b2-5db68c7643a3,Residental,0.7504348229362318,21,19,500,903,403,47.069704490217276,5002
31aff5a7-13bd-471d-b2c3-025ed53dc25d,Educational,0.09660346164843359,30,45,177,1066,889,27.21360901333458,4678
11d66468-84f0-4c23-90e4-95081d611db1,Residental,0.28906078560492,27,22,550,1317,767,71.9578072786048,2491
a6a21e35-fb22-4e51-8a97-380a84809f52,Healthcare,0.5155134013509785,33,28,635,769,134,30.409075407187014,4714
779387c9-a202-43d2-b0ba-ed2c14f1d5ef,Commercial,0.22980912712939394,40,12,13,272,259,34.22823828473187,9102
a66db666-89b4-404a-9d78-499133c89374,Residental,0.19889162862938892,40,48,674,1244,570,10.819876416119717,3712
2a93c9bc-d0b0-467c-a80c-dab09bd20ec3,Healthcare,0.986401484717957,12,25,332,911,579,22.18225710800249,5138
60d72c6c-0ee4-4543-8ce9-ac752514c4c4,Healthcare,0.8896761080938262,48,40,653,1331,678,61.33486463857111,5622
b8728a33-f2e0-4ae0-b469-9ebb4a0f9f31,Commercial,0.6739813696439912,47,41,274,987,713,10.396124125226423,5936
381dd55e-5d04-4a2f-a0aa-5875aaa12a03,Educational,0.8378221488205692,39,24,234,1006,772,14.001440740779245,8536
b959d117-3287-4856-a0eb-5084e0b90365,Educational,0.14908600073447809,47,17,374,603,229,48.15936940352495,9519
aff0d1a7-fa30-4abf-b3e1-71d4303fe4e1,Commercial,0.5831600098590288,6,23,347,1007,660,57.72339830780813,9256
eebda672-74c9-433b-8304-cd39f7230983,Commercial,0.4313532544713595,10,14,163,1030,867,20.632445011395582,3622
2e2a12a6-a17e-4ef3-bfec-32b35f7f1c2c,Educational,0.6865433859661295,1,20,373,1327,954,18.72543876135972,5587
d9c619e2-43ab-4450-a9ec-192846ae9b1d,Commercial,0.3253802280547321,40,17,706,927,221,98.05776868189348,6710
587a65c3-2675-4e6f-a2cc-6db9e31817e0,Educational,0.5066887510353192,17,45,559,814,255,10.953956931769303,3947
fea58221-aeca-4445-b7a7-64298b751785,Commercial,0.11412134156013476,34,5,605,1411,806,61.319199103391426,2551
22dda8d7-349a-4fb8-b5c6-4e718246ca73,Residental,0.28444835445375694,45,15,251,616,365,81.90485140307116,5918
0c54418e-7014-4243-be43-e33484482cd5,Healthcare,0.3719719007494682,4,30,39,222,183,42.97825744008671,4597
8f9fd2ac-72ce-413e-878f-ac0901507557,Commercial,0.8061866742006218,39,50,443,1354,911,11.73309697872815,9584
5abcc003-12b7-4787-9745-d2b744c71532,Residental,0.8166628956752033,45,23,90,491,401,81.58940408079602,9628
52a133d6-46f9-4103-b605-9b16170f42f8,Commercial,0.6008830656121049,43,8,26,1059,1033,56.62345029001018,5820
4a68445c-533c-437e-b740-f3f85d8bc85f,Educational,0.4406095108900998,8,50,544,1225,681,44.02618932873983,6343
b8b6a755-c453-41b1-ac3e-e1ec6abc6c01,Commercial,0.09202133500319565,45,26,63,964,901,33.23454020620833,4909
463084de-712d-47bb-a60f-00b92d90aff9,Residental,0.8378013180881793,36,11,717,1325,608,89.42383339577741,3134
a8625685-db12-41fb-8772-802616399dbd,Educational,0.8125814571756252,7,19,218,942,724,65.570193149955,2110
4a547366-3686-4dbd-b853-b15aacfc34b6,Educational,0.5709818377606604,37,31,14,775,761,27.0177934807563,7330
d46c76eb-0fe2-436d-819e-35a05a6e4b09,Healthcare,0.27227785827705,46,48,643,1033,390,28.063098275392342,4839
7a7a66ac-4143-4e86-b1e0-f8ce85757323,Healthcare,0.7486596783444421,5,3,81,995,914,56.11616949342894,1527
17ed9bec-27b4-4d55-b45b-d6ff4981cb93,Commercial,0.383357209818851,26,43,294,1202,908,52.68332800441907,6351
12debcff-3102-469a-8cda-43361921ff57,Educational,0.8403150792274605,45,47,357,1432,1075,86.54426406739377,1446
5d782076-50ae-46e3-9f1b-b2def220288e,Commercial,0.5536670535284015,48,16,107,277,170,60.10539354041521,3794
88623287-fbbb-4a90-ad43-a691e98e7440,Educational,0.8607515267852767,7,39,156,1413,1257,83.96298883408453,2549
2f01bc11-f6c4-49f6-ac81-a622407a6cff,Healthcare,0.10485881254070717,8,37,654,1168,514,22.350355573397017,9798
122c91be-bc1f-44b2-ae38-03e04085fdb1,Educational,0.3023676011258829,23,4,213,365,152,68.25092507405532,2124
04f0ca7e-e1e6-4ebf-883c-38aeadeb562a,Healthcare,0.12250179408580408,27,13,569,1169,600,98.44218644843104,2878
1b549e17-9ad7-477d-a539-c79600fb4d29,Commercial,0.3771047797719428,30,4,145,148,3,81.98222950442427,4043
c68517fe-9650-42ac-aa16-38e30d026168,Healthcare,0.1828006764781387,16,35,229,942,713,62.939030032565576,9468
98338cdc-53bf-4a49-bfa4-bbe321efafff,Commercial,0.864492197552603,4,10,504,1286,782,50.384554640670125,1316
f2d62cf9-2a11-4c00-a080-211a70b7244e,Residental,0.745611507243943,10,8,477,758,281,20.35917125365009,4016
c4cff692-b660-4e0c-a8c5-4288303fde3c,Educational,0.7245968400061092,3,1,36,882,846,41.15659781269294,2719
3f0457c8-e276-45b7-9af2-eaa238618c98,Residental,0.4340455842893286,14,6,212,1421,1209,91.90628207715126,9221
6c664fa7-9a1c-4565-b169-30ac1a0a92f6,Educational,0.8021797046546575,31,28,24,261,237,34.52532787139829,6966
e9156052-be50-436c-a15e-e0d260c78e5a,Healthcare,0.5649127635894985,14,37,178,682,504,68.58240499697824,1800
ec16d383-bf2e-49da-991f-177194b703f4,Commercial,0.6105646296391134,42,44,146,769,623,36.33363361633749,1192
e455aa5b-54f7-43d6-a86d-ef8f3b1acbe4,Educational,0.07668237615758533,15,6,100,1416,1316,48.31590561043569,1586
d4ea3b91-d581-440f-be80-f428d6aad796,Commercial,0.6171963491899596,5,23,598,1403,805,44.793343444021254,8369
57e62b16-d538-4c66-85ed-b050a20f44bf,Residental,0.2729424494327807,5,20,384,1001,617,13.165858158295585,1423
ddd76f7f-251f-4d0c-9f87-c04a3a557d1a,Healthcare,0.023049263909644124,45,23,579,1083,504,72.10281370447575,3724
3523f54a-40ae-4142-9f62-22c007be5e09,Healthcare,0.49992233589008983,46,29,577,955,378,33.38237613376313,2233
7336a073-3ab1-4541-941c-22c6ddd9bbaa,Residental,0.1341652561410348,39,14,23,1024,1001,99.64939769070418,1956
3d235ee7-87e9-4310-ba7c-fcd0eee66a36,Educational,0.24665894519353027,12,30,497,859,362,58.68048970892071,4076
b7535fe1-4ced-416e-b7ff-52bd357803b9,Commercial,0.5681357149736838,36,20,296,842,546,78.50240929317815,7371
f06db9f7-d642-4542-b65e-92918051ae0e,Healthcare,0.9546649513102062,28,15,369,1311,942,69.95628995482366,5420
b8196911-b07f-4338-a38e-76c2594c20c5,Healthcare,0.16356067988868483,1,42,671,839,168,29.29103649847606,3134
f257ed2c-9315-4cf1-86c8-17726a2e0fae,Commercial,0.7883760433671969,20,32,427,762,335,29.507377534891635,8779
bff9f4c6-b1b8-432d-ac11-19c1a1511735,Educational,0.03268650141678364,26,18,544,894,350,49.44315762276742,3227
7c87a32a-f589-487c-9096-7ed3830747d2,Healthcare,0.06801118355111968,31,32,126,737,611,91.35336723426047,9209
45c67211-9d8f-45a5-8b36-79b5fc77d04b,Educational,0.44968451215006666,41,31,503,843,340,80.12785436488758,1225
06d045bd-08bc-4b4f-8cff-3c9fd1736f93,Healthcare,0.14611762935939898,33,7,340,1116,776,29.217601946137272,3901
c18c7bfe-f472-4b48-a59f-d82ef2336d9a,Educational,0.7632026988640928,10,35,343,789,446,10.533463126777992,5621
6290eeed-c4e5-404b-aee9-ad8ecd98563f,Educational,0.14829594289850334,24,19,13,1034,1021,96.6798667780089,8458
ae3aba00-fb6d-4ba5-9f90-fc88d9fa1454,Healthcare,0.028254983612146067,8,37,86,515,429,98.12009123618861,8953
a6a5acca-9c8b-4d3d-a3da-603071ca2e56,Residental,0.942146308996841,30,25,310,641,331,62.794349613471525,9599
5f8d41f4-e746-4398-8fe5-ccfc8082977c,Healthcare,0.3820809930479463,6,23,292,503,211,56.62327694294497,4750
217e5d24-5cc7-4806-b1ba-02593e7cc031,Healthcare,0.20904292026037008,39,35,29,1000,971,40.76174247945311,8051
ec71a31e-0917-4ca5-bbcc-9292c9072352,Educational,0.3696588775176056,46,27,104,1332,1228,21.909788084977258,6014
ba569800-8593-4482-8c1b-cf054a43b866,Residental,0.330245175412908,44,22,514,946,432,87.69177489991739,4791
8ffead7b-d982-44d1-8f28-0a08105b91ac,Commercial,0.01852105029097706,42,20,147,854,707,95.36455039846209,3064
ddbd996c-9514-4cc6-81be-7a8e7cc067e1,Commercial,0.019164852373123598,49,6,510,978,468,46.411014405421895,1375
b22ccd69-b851-4f17-a082-76372a478aab,Residental,0.5220325367112414,2,14,33,739,706,91.37354971209703,4752
47311125-2ebe-4824-9eaa-1d5f2c615b38,Commercial,0.493376265941179,16,15,642,798,156,33.31928372695566,7062
5a9381b2-e090-40f8-b8eb-398e20289a2e,Educational,0.6490610296068741,30,13,464,855,391,54.63445658401343,5738
50f0aacb-5586-4a6e-a197-b314ff74a308,Commercial,0.801692248852107,46,48,648,1252,604,54.35439587274523,6377
d89bd4c7-dd01-41f1-9ae8-0cf1b473f3dd,Educational,0.47770200206181235,19,48,389,587,198,61.67453741921817,6796
ddd82a8e-411d-4958-91e6-0df82567d378,Residental,0.7506893688140316,14,31,31,1271,1240,84.61644471249882,5845
1af6e204-6c8d-43e0-b03f-1e65adeaa8c9,Residental,0.5735983160187058,27,4,60,1113,1053,39.14168947901536,5155
f2f5f93f-3fbe-41f8-9a29-64108c411d5b,Healthcare,0.954217184602245,20,39,679,1051,372,30.21042058955472,9921
6396732a-f9ae-49f5-97de-8decdb16e9c7,Residental,0.8029230112655108,37,20,251,962,711,23.072140318126305,5970
9dfec5e9-4b80-41cc-b9b0-bd1aa68347b5,Commercial,0.25276088391996987,36,29,313,1158,845,26.819353372688912,1870
d313df67-4b03-45ba-b814-013e925a9786,Commercial,0.1686835670645822,32,30,163,785,622,58.05545737315433,5483
c2c0b639-97ca-4086-9f4e-1867b4719d97,Healthcare,0.9682170649859395,48,10,310,855,545,93.38599099056908,2068
4776e7c0-0c48-438d-8981-706f833a743d,Commercial,0.7246653231992632,40,30,377,827,450,98.60720391404068,5087
a16b23a1-46aa-451d-b368-c9cc914bade8,Commercial,0.06527713703701199,29,8,153,414,261,50.16131799052018,9209
237e54cb-1bb6-42ec-9b21-49476ebf9889,Residental,0.8452896845983656,41,5,123,946,823,48.492646453977,5455
08dad158-46e5-42ae-86e6-39a227c5923e,Commercial,0.2659464681812904,31,47,322,1248,926,28.504034611300156,4957
2ff2fd8b-d75e-4c2b-8534-d27c9aedf5bc,Healthcare,0.3457559759361576,4,37,539,990,451,25.408082232793106,6196
794c1af1-bb22-4fdf-b32a-c60d99454498,Residental,0.5707818378077328,10,40,301,1071,770,69.16989509228057,4657
a3333923-2abb-4ebe-b211-3e6962c1dc7d,Healthcare,0.912882596993688,12,19,214,231,17,62.425705203116514,3350
cec6a8b3-cab0-433d-98d9-c4033a096396,Residental,0.40114540847425395,47,32,524,1041,517,89.75677679983467,2860
3eb5d212-d3f4-4fbf-9b9a-d25a4656aae5,Educational,0.7697164415639909,13,24,662,813,151,83.41208965263947,7770
9c63c551-2e68-40df-9160-87d34901bd5d,Commercial,0.16175008924077705,26,38,490,784,294,61.857100987643406,9127
61d37671-f435-4fcf-b7bb-82bc2a495753,Residental,0.08111771601477724,3,29,290,902,612,22.55444183016045,8596
d3a4a411-8cf4-4dca-807a-d13e9507fbef,Healthcare,0.007300451514449691,11,42,272,636,364,97.53112115151012,5780
186fff10-df39-4c92-b698-1a6fcdd4699b,Residental,0.11245895972079067,33,1,465,977,512,39.35510714096037,7198
b5367bef-722b-47b6-b2d4-920acf481c1c,Commercial,0.33788757211603626,1,24,511,985,474,99.21036119637765,6383
7d56434a-806a-4f2e-b876-efb7d66680d6,Commercial,0.9872158380290996,13,29,672,971,299,20.274287755614395,2844
d2499d32-a9d2-4e92-a347-bb913a84a07b,Residental,0.24762426830753015,43,49,643,1365,722,86.78491377563147,3168
b4de618a-7459-44ec-ac66-99970e95407d,Residental,0.34774312367670235,4,37,96,1154,1058,84.7926845564049,8058
79661c1c-a67a-4753-b1d9-9277b43914f4,Educational,0.5348481546048451,23,21,140,1195,1055,80.44905694508807,8068
86395e12-28a9-4127-b3d3-667a1299e442,Residental,0.09472750280010378,14,28,687,834,147,34.16470773564197,5997
ec227ded-7606-443e-9ddd-375bdae69ea1,Residental,0.7030731440339872,43,15,255,1387,1132,93.66590218772497,8980
efd05f08-a8e3-4502-ad0c-0e153114815a,Educational,0.15327677089491332,4,11,256,965,709,53.62341047081897,1172
fc9c32a6-4cd0-4f60-8ad4-67ac9de30d1b,Residental,0.6500653219272098,5,44,687,1038,351,52.85484747061595,8537
4e583b02-6e34-4fc2-93d2-67f3f3c0687d,Residental,0.6912621580297387,24,2,574,1108,534,82.8879320416704,2487
9e020886-d262-46e9-b5ee-16222c0ddf55,Healthcare,0.08635283612743327,41,8,438,503,65,42.59136529752445,1534
22200894-d435-4ed3-a1db-4cfcd2d8a61c,Educational,0.0025737227555477915,24,37,442,755,313,33.08052545638442,1646
5072a612-7daf-4860-853a-3f1bb3aac653,Educational,0.7793253234415124,14,34,591,809,218,35.7541520771576,4639
20ebf6c3-0ab0-41b7-b610-3cae214b51fa,Healthcare,0.7836006130003071,5,19,636,1391,755,11.049835614186973,8447
2af95afe-c917-40a9-b02f-53a08cd69209,Healthcare,0.33357999879348177,49,34,413,987,574,82.84641818445677,6939
0e00e4c7-1785-4562-92ce-3a23b8b8da31,Commercial,0.9982750430167417,9,43,425,1359,934,10.173456768929064,9608
dd2c1dee-72b3-4e93-8095-72f82701f72e,Healthcare,0.060602706651509575,41,11,375,491,116,55.37437971755664,9640
b0277377-7f9f-44ed-9f8b-03b32525017a,Commercial,0.14921465043727267,16,41,249,947,698,92.2957643076099,5213
0b432876-3738-45cd-a522-93260599ee4f,Residental,0.0708220970881609,14,22,261,1073,812,62.53991711047704,3067
92590df9-e307-430b-884a-0f169b622bf6,Educational,0.9865397665919086,35,7,14,678,664,49.05020739022891,1533
bc66dbba-8fe6-4b3f-8078-034259d98b05,Healthcare,0.09633257395951156,16,13,349,685,336,41.89799908193415,9965
b5522e77-bb14-4969-8a82-a3970b4026f4,Educational,0.35594986601469614,48,9,120,541,421,99.45584541284217,3206
bd191215-34b0-40c2-8e5a-0ba3ada943d0,Educational,0.9841176342661867,10,35,593,1401,808,38.24114968528132,2460
987181e5-9eaf-45a1-ad26-de32cc7b5df1,Healthcare,0.15868715846559645,46,37,552,1280,728,95.26919972885686,6645
5654201d-ad16-4e9d-8781-6f00c347d8a1,Healthcare,0.22587307899318487,13,34,528,1081,553,46.748654808384394,9078
a234b17e-e292-42c1-89b1-e0f6228a87a5,Commercial,0.32059086822480687,21,7,660,668,8,65.60774034776435,4142
f613725f-f2b1-4441-877d-554abab8734f,Residental,0.10465108025010861,25,48,266,467,201,12.035079172042394,3603
eff88e8a-92f7-4645-83f4-f1ce54267762,Residental,0.3079558391249212,50,24,47,106,59,14.30371975257627,8987
43d1e3ed-8de0-4775-8d9e-7023a757d1b9,Educational,0.6875348866244873,41,16,299,1361,1062,12.238604150886122,2760
57616bc9-7dcb-4462-b6fb-f68fb88b1b9f,Educational,0.5232346616127788,45,23,144,590,446,68.01682597756081,8161
c44fe7cd-806a-4462-845b-32fc92abf6e1,Educational,0.6330937939317437,17,9,134,1090,956,70.42224157221983,9987
ba7b5cbe-d8e1-4b57-8ebd-f5b77ad34161,Educational,0.7504376130876235,50,27,38,332,294,95.38788581900614,9914
50dc8ad3-305a-4e62-acb6-bec0a213c553,Educational,0.4789326764610171,41,17,5,581,576,23.080859133021203,9219
29a1f3c8-17fb-4011-a756-863ff7741e4c,Healthcare,0.9646151795500847,49,11,483,1053,570,68.84614443349702,8202
35e5eac1-d1b5-4686-8aee-a3cc9972a9ec,Educational,0.8109716529544281,19,48,642,861,219,88.89487241164025,1128
75e9e2fb-3b1a-46dd-aee8-7210420cff53,Commercial,0.9699378302541958,26,46,16,1206,1190,19.544278576964963,6617
187c9c17-5d5b-414f-bb14-4131df04f21c,Commercial,0.0485719301343146,32,37,134,1126,992,77.51782351914105,6219
446f13bd-f964-456f-b393-3499bc68b2c8,Residental,0.34849066459016,16,24,654,1110,456,94.57752562914281,7421
ad9111f7-5586-4c67-9dc9-69533813d456,Residental,0.8834191173469966,8,44,694,888,194,24.50236939802476,9889
82435ff0-2b75-494b-a46f-832311aed86c,Healthcare,0.03454610681008463,40,36,341,904,563,56.426918644782305,3492
ad35025b-8f25-40a8-aa33-bc34f1346b48,Educational,0.031040865964075515,37,2,629,1194,565,15.840581745780039,2123
1349303c-f5c5-4f70-b115-441da7fc5c1c,Residental,0.038690077847342685,31,24,695,1315,620,18.999103390533158,3396
c42b751c-a806-4c11-96d9-6177d3c08df5,Healthcare,0.4485641863896712,17,21,639,642,3,89.60438414707095,2676
ea731c80-b770-4886-9999-62afcd9460cf,Educational,0.807798494749369,50,47,522,765,243,61.758777710531746,1159
8602e9f2-6892-4ddb-9dbb-0e59f71ebbb7,Residental,0.26461300016611855,30,8,571,625,54,71.37871245340817,3150
77ee485d-a7ff-4160-8c2b-9e235b72ac98,Healthcare,0.523945641386149,22,23,129,339,210,77.1189036584777,5084
1fe3dfc6-59d7-4cd3-9f22-67ec033fd6ce,Healthcare,0.07023357406963049,22,8,447,821,374,51.251065424107765,8837
cf358f96-7203-4f22-8190-5ed41fcadd36,Educational,0.9934504233052519,1,9,275,539,264,86.33205866906296,8592
168291ba-ef79-4c9b-aad9-af18333ac9a1,Residental,0.1452830590316322,38,38,375,1205,830,19.35435799494228,5445
7754846c-b728-4196-af38-ee550067225f,Healthcare,0.29679872829109766,39,20,525,1059,534,92.04181488301599,6751
04e17d89-3819-43ea-9400-6dc3d619a60d,Educational,0.4957518179210816,14,43,91,404,313,52.863074927968306,4111
4c986265-7e45-42ea-92ab-0d125a1cd0dd,Educational,0.10835670265681907,28,32,79,782,703,67.10212444887561,5155
0af398c3-eea2-4d5e-b3c5-b4b408061d92,Healthcare,0.5544356559813316,25,39,538,1262,724,84.79473982823212,8552
addb1b06-25b5-4b85-bc04-8cf17745893b,Healthcare,0.03784882318651306,33,27,681,1065,384,99.53896797973556,2829
ecfb26b7-e0fa-43a9-a6f3-ca877d238569,Residental,0.6800726110311407,4,17,711,1152,441,76.25706191406589,7288
564343cd-88c8-4cfd-91ec-8d86c4ededcb,Educational,0.007437044549890359,49,45,147,1429,1282,72.91227187356176,8361
1036cdf5-438e-4937-b7d3-007fba5e35e8,Educational,0.80495611734572,16,24,58,212,154,71.07267316006995,6158
3e44fc51-aad7-4d35-ac8f-b337ba72b113,Residental,0.5242091938184766,39,26,196,337,141,48.690155152311654,7543
8772b20d-de7f-472d-895a-136aaa1cc58b,Residental,0.11891503198821496,32,41,519,661,142,27.591890381487033,4385
b54b8545-9eec-41d2-a826-dfdb367086cb,Healthcare,0.5424044369146578,28,36,19,199,180,44.29597068418465,5164
91314540-fed2-41b9-a1ce-44c2cdf8b536,Residental,0.060635316384200166,34,41,168,1416,1248,77.91471351026222,4351
d64d8bf7-6f91-4b8d-8d6d-fba4e40bf7cb,Commercial,0.9057687304173255,16,49,479,910,431,12.575775046157187,3587
6c1f7e25-e5ff-4c9f-adc3-2aab87cba5fa,Commercial,0.8788163010656843,39,32,35,248,213,73.82222593209008,9207
6cb1b654-877e-465f-a11f-b22c74df9281,Educational,0.17917216571251626,23,13,536,637,101,71.46850270803029,2793
f5ac78dd-d100-4fcc-8f40-31e98dea2889,Commercial,0.49201404257574455,20,41,350,758,408,34.62139709060669,2685
71eb9623-527b-48ed-b538-fa0785a35040,Healthcare,0.7860823488142106,35,46,681,1353,672,83.21352781380494,7188
a5a6e5d3-3a74-41e5-a3a5-306d7174763e,Residental,0.7216675693957142,34,23,555,1140,585,37.697938680475175,2796
abf35943-b094-4285-a966-2e6008a1840d,Educational,0.6998626286046463,44,20,712,857,145,70.24590225684308,8653
f501b4d8-0614-45b5-8517-07841dfbd601,Residental,0.9884998562571491,3,3,524,527,3,53.573502263164436,1610
c39f9417-70cc-4d13-8269-37c14bb0e1ad,Educational,0.6609295023945247,26,45,488,525,37,27.182344297657476,6905
268f7cc6-4f6f-4f47-b49f-c2d432538fb4,Commercial,0.9583963321346511,3,29,323,1304,981,16.282187326352197,6621
17f894e9-4552-4fa5-8ee1-b6f08ff0c4c1,Commercial,0.03356379487583938,49,27,541,844,303,64.96692594850428,4141
16f07e27-6609-4eb9-87d0-d305f53e618d,Residental,0.5550479136617199,14,30,496,770,274,94.86323191774946,6455
28effe34-bf82-478b-b5f1-3fa8d3def8be,Educational,0.1459558367359457,27,16,109,592,483,62.76586201181053,4078
fd1a0a27-1082-411e-beb4-f3230893d76c,Residental,0.07652187894057927,17,49,632,1317,685,57.43964413788919,8896
0d8f4c2b-34f0-4e63-bd34-660a53d13016,Residental,0.164819339933019,29,37,173,828,655,14.58941636133088,6616
4201db96-457a-4f5c-aa37-f24f3b3da19c,Residental,0.3323808045082912,34,19,694,1382,688,72.9844130991637,1457
884afefb-6530-47be-a4a4-9bbc6943f9ff,Healthcare,0.247823952464022,43,31,467,1065,598,81.82840553320534,1452
7e1f9db7-5357-4ea8-a48f-b36f290c4adf,Healthcare,0.049298283318272684,16,7,105,277,172,84.33707459585872,4383
543e03e9-1e7b-420a-9b5a-32f11aabc33e,Commercial,0.2185677036855439,15,20,477,720,243,20.456693462842782,2369
43573cc4-1689-4b24-966c-7ce41dcfddf4,Healthcare,0.3370020100659894,25,41,234,945,711,19.309858966663583,4920
229fa159-8187-4f68-8300-c0dec5d9e60f,Residental,0.6431486328725743,4,13,553,627,74,20.65081195490241,9032
5f8c033c-2ba4-4db9-8ba4-84546d395ff8,Commercial,0.8926549948840901,48,3,665,806,141,93.43124413378506,2492
aa5dcbb9-6dbd-4a41-8d51-056d1ad05870,Commercial,0.37708257533246337,41,38,487,1395,908,67.91830414025637,5146
52e32b92-263f-4870-9ecc-b3cd8c6da98b,Commercial,0.4513374972265549,43,9,113,721,608,70.52090386893954,6545
89b016b1-2e50-4a9b-9f67-3d74fac77def,Commercial,0.5030803622871318,19,29,165,881,716,52.79310502977747,7979
7fc09edf-fb0d-4e64-9dc4-5228d66ea5e7,Commercial,0.5708620144629453,27,9,310,804,494,67.41272613019575,6570
3921860c-5f05-4a6b-9a94-69914589f938,Healthcare,0.22846926138281165,47,5,146,1300,1154,97.11348013072067,7329
3239dbe6-dcf0-48b1-a4ab-b04555a38a97,Healthcare,0.45193695858749316,20,1,19,530,511,97.10841007635466,6488
b57835c5-eb1d-45f7-a0a1-f365d5cecaf4,Educational,0.4719795590490722,23,48,412,1263,851,54.78376195793823,2336
9309fa68-8d52-4ecc-b97c-4d34eb8e069d,Commercial,0.315428581891978,33,34,314,317,3,48.723699740518846,1736
23f1be1c-3021-4c9d-a5bd-aed53689c600,Educational,0.8428763084375859,9,6,222,1265,1043,28.059330955581064,4418
dafa27c8-af0e-4f13-a087-c9921fc4ee49,Residental,0.6509667817819963,41,38,57,1166,1109,23.888664390731805,1350
92e55319-cbb2-4cd3-b0e5-dca670a1294e,Healthcare,0.7372693990352167,23,26,158,498,340,79.8550473494182,2717
2282015e-481b-495f-9f13-9544400a1c4e,Educational,0.5875294456304061,50,10,713,1030,317,72.95907697863285,5294
abb1974d-5557-40dc-97c6-5739197d00a3,Residental,0.8216600793575841,44,45,138,999,861,19.60434947843301,4111
510ac728-2a8c-4055-a4c9-299a1671a728,Healthcare,0.6056698971512569,2,44,710,1107,397,62.99977939361187,2233
8e5e9710-d978-43ad-adca-78019693af41,Commercial,0.20635969487504424,43,3,548,716,168,19.363142929625564,9379
4ac719b3-d154-4df9-b843-6817e1724a94,Educational,0.7859080494708911,21,22,503,547,44,88.0388969796334,3277
6ebbe03c-19a0-4c4c-ab24-16b6c7afa6a5,Healthcare,0.378865121754835,26,17,449,768,319,37.9148583695453,4021
77c209a1-adbb-471a-bacb-0eee4ca7e76a,Residental,0.500272496557103,39,9,36,975,939,86.7260664054825,8126
6c4248d1-80cf-46ac-87a2-0171de5d9df9,Residental,0.4186124571030134,16,44,273,763,490,95.93304352713541,9345
9ab4247e-ba0c-43d6-9dc5-743e5836b0b5,Commercial,0.22619668588892639,42,15,477,1230,753,54.29349035976909,5686
c8449d1e-da9c-4d17-9bbd-4aa763c51278,Educational,0.3671587041362886,11,46,45,579,534,82.77288074317613,9961
724946c8-7c3a-4b01-b414-afa47c110515,Residental,0.19613970943481374,43,39,188,1134,946,22.70674016807073,9679
b95ebdc3-a73d-4a23-94e5-e87985d48f6b,Educational,0.8923095424387412,19,40,674,1177,503,21.338131254566804,4884
51c11ebb-0b40-49ba-be30-11e380ae17f7,Healthcare,0.9215030740479998,14,28,64,432,368,61.258365331469754,3207
8fea8b63-729b-4747-908c-55a299b1e14d,Educational,0.5842775141422631,42,49,283,718,435,59.389912050276706,2368
1016d338-4060-48a3-832d-b0840e49e908,Commercial,0.4806499335051929,32,43,339,605,266,50.67252835244669,5319
1298454f-e1da-4c49-8952-c801498a3b3e,Educational,0.5044532513993706,20,7,393,815,422,78.86161018144149,1581
fa1f4b98-2b6f-4715-8957-03e4a8a194c3,Educational,0.939620145756804,8,36,498,507,9,74.1343462991449,3639
ee7cc8c6-dbc4-4484-b44d-778631305e6a,Healthcare,0.3331377009238077,12,6,158,307,149,23.220169624725003,5338
ce2998c7-0a98-4e58-a4c3-663ee7690550,Residental,0.8459082103273994,15,40,496,671,175,54.41467167125928,6264
5084102a-20d2-404f-8166-29f32d8cf9ba,Commercial,0.44409244809498183,32,18,94,1189,1095,71.68666781330776,2977
8014784a-6453-40d2-a2c4-f94d1c6c770c,Educational,0.2864762915460266,18,30,18,805,787,51.45704655444361,2818
1250bd92-2f74-4bb0-bc48-8d924cc2c944,Residental,0.3107076044810553,17,46,245,872,627,86.75940532233439,9328
0d280f57-1972-4b8f-8bc6-be9581ac2231,Commercial,0.9928822673410539,9,12,502,787,285,91.05973944008001,3508
ae06593c-e326-4ccb-95d2-9e7eb346f97a,Healthcare,0.07474759991110402,28,21,338,962,624,74.12380162437132,3300
4ef7beb4-b4f2-4096-a448-6ef2a216cdd4,Healthcare,0.6810197610420988,9,7,630,767,137,31.119234892887818,3226
c876c705-9f46-44c2-8b22-882d79267649,Healthcare,0.7222838196212633,20,29,421,1292,871,58.93710362909301,4193
23fe11a8-feec-4d84-9df5-b170e6db9791,Healthcare,0.4916179350485371,2,4,719,1075,356,32.08839304921799,3300
c0201506-3604-4a9f-81d3-7f8126cd0412,Healthcare,0.4687339905283866,20,50,676,833,157,23.373055723771294,3964
ee4f8da1-d0aa-4cb4-805c-99e689a7a0e0,Healthcare,0.1852127402060315,2,28,289,735,446,59.014562611061635,8179
3ef41727-a9b5-426a-9936-7bc1f52584d0,Educational,0.12051238296701072,13,9,718,1251,533,49.32690243072479,3531
754404b5-26f0-4996-b7e0-09484f9af58d,Educational,0.4396721368287162,49,24,282,1361,1079,32.469019098399954,9252
eb2936e3-163b-426a-b627-3bb0dd4adae9,Healthcare,0.13992126865672616,7,46,457,695,238,37.055165779381454,2103
60846956-f6fd-4b6e-8f36-a5f5f1334f10,Residental,0.8421440508435293,7,49,215,251,36,25.744913358880353,9070
94f2d314-0648-4b1c-aa6a-aba77d532c5e,Commercial,0.25155513278606056,4,16,526,1137,611,61.87025858794268,2716
5180a37c-97a3-4d1c-bc40-540d03d728e1,Residental,0.2838191656176817,2,35,571,756,185,97.51304025964816,5354
5fba97b3-d505-446f-9f7f-d0767ecd6171,Educational,0.3360389641543199,21,31,507,1169,662,96.92081183015799,3062
d5d270c0-4f76-4bf1-aac9-bd6ce7933b1f,Residental,0.2381958145845735,27,31,324,402,78,17.129144867150227,1257
d3551311-4ed1-47ee-84ec-e2f272922079,Residental,0.5882737596224801,31,39,508,596,88,22.43985710873543,5388
38d66f79-4b39-4cdb-8a4c-b86f72f33669,Healthcare,0.6767004002735577,6,23,690,699,9,13.68555960555073,2573
39d80c50-4c8b-4636-96e1-82ff5685b2ab,Educational,0.34603657094890405,49,10,493,1134,641,75.37149949236974,5237
91a5968b-1d9f-4989-985e-631b7ad36364,Healthcare,0.41056771122811964,28,15,695,884,189,86.48614106317905,2689
e25ebb13-f73d-4156-935d-9898b597e4d2,Healthcare,0.948825731533111,40,23,560,728,168,28.103778648042073,3104
762c3f22-076c-4f4b-a6d7-6af795d38877,Healthcare,0.8884807677192861,35,1,718,759,41,67.6857295818899,6936
0b42d82f-91e9-4921-9aa7-487c5f079825,Residental,0.31000045743942906,44,31,272,593,321,97.28962194613602,9251
0cfcbaad-288d-4a0b-9842-46fa3406314c,Residental,0.2803783883259513,35,49,449,646,197,45.84537925587184,3281
e88464ff-b903-4896-95ad-41a55b9f7557,Healthcare,0.5036020210614567,42,43,622,1211,589,55.08684352992317,5566
8bf129a4-b88c-40be-95bd-1ccdb5bddfaa,Residental,0.13900832144271869,40,48,501,1408,907,52.31574362226568,8378
75ca3e5a-b707-4f5d-a48c-0d8cebd26201,Residental,0.9415642205390055,42,34,400,1410,1010,97.3722533025603,1006
751e333b-68e8-4375-a2fb-6d38c66ca6d6,Educational,0.6934168627231456,9,40,168,425,257,95.70138467786235,1575
1b3b7451-dae6-423a-961e-ecfd18db5c20,Commercial,0.512389956794415,47,22,563,1103,540,97.38526361182902,3188
697e79bd-86eb-4df8-86b4-33e2265f9b20,Commercial,0.4237869257303546,39,16,165,725,560,87.92759345263688,2984
3e18d741-686f-479d-bdbe-3283767f1837,Residental,0.3382628287678918,9,29,700,1389,689,96.43652158031352,3199
dd936c2c-af7b-489c-a6e5-9e73ab1d5503,Residental,0.6102375739101427,27,39,546,559,13,90.05979510150537,2930
0e016d55-819e-42e2-817b-c9f2aed77567,Commercial,0.3000526456530913,50,26,418,956,538,38.23482627901218,8817
58dd1e94-1307-49c7-894d-4917911bfb0f,Commercial,0.6365884168825977,33,38,485,1413,928,55.654284276936636,1100
e9cee7ff-551d-423d-835b-59d8b9289c45,Educational,0.15276647325003667,47,7,410,824,414,25.0537408617015,4500
658911be-64a2-4616-9e25-95bc43fb62b3,Healthcare,0.12888025208507403,34,40,576,937,361,53.61431653503507,1480
aa8ab86e-5db2-453c-8302-02d5dfa43774,Commercial,0.3849918234186709,18,15,605,1351,746,48.617900424096405,2738
bc0f40f2-0042-4902-bd03-7488dfa08296,Residental,0.4698101995320394,9,36,547,1184,637,42.541907078663876,6627
40ff5994-d3da-4bdd-921f-82e7b72245b0,Educational,0.41444959280178617,8,32,475,1422,947,18.015551962988916,6992
5202f65c-7743-4e31-9d80-2372d1431f98,Commercial,0.3122375260163547,7,19,54,121,67,67.5713633668041,1406
27b07e3c-4016-41d8-adb9-e5b0e98b48c6,Residental,0.9823471690831985,5,9,161,576,415,83.46256133153418,5884
646a3c2d-f49b-4654-8554-d722a55ff2f9,Educational,0.4556548153505239,30,34,242,885,643,44.890865463126616,1847
b3a48b71-ffcd-46b7-8786-5af86f0ccd74,Commercial,0.32403556053641014,36,10,341,679,338,28.893182197127057,4032
a826168b-01f9-408b-bac7-03221aad7cf9,Healthcare,0.17483759199650262,1,14,536,987,451,33.94472370225471,4718
d8184061-ec93-4a82-a6fb-972a2c03f81d,Educational,0.5287803229767258,22,42,242,340,98,50.27350549826874,9048
e83cc731-8a96-482a-98fb-5237cd5e131c,Healthcare,0.4114951213672018,45,4,242,662,420,67.08728781865943,5828
aebd9bff-b141-4b48-87f6-05501700bd9a,Commercial,0.17032913927378424,30,21,228,903,675,52.15687391644391,8388
a783e495-1216-4312-8a7e-2a5e2332f961,Healthcare,0.319127255715282,36,17,183,1029,846,84.1666415856858,2555
ab341f7a-da4a-4bc1-9ff7-2d300b05a90e,Commercial,0.8179969718890692,26,27,691,806,115,32.50722786437168,7562
75cf1f5b-9f4f-4b55-a377-a14f7653637b,Educational,0.4015957212251936,14,47,598,1395,797,85.55156724892016,2346
fccc56f8-ed4f-43ef-a078-8dc3270eb0f7,Residental,0.6267176221813239,32,45,17,1225,1208,68.81066901274099,2265
212f0987-bed1-4db8-936c-b993f71a8d00,Residental,0.4443454288395514,7,50,11,981,970,29.73166392749045,5030
20e53692-37d6-4e26-8721-c13343add290,Healthcare,0.988752541948957,2,35,371,1274,903,12.844935325828684,3377
b6349f13-75e1-4bc6-9a7e-8a123258cb7a,Healthcare,0.4710756799742669,13,1,368,1216,848,53.320433547128246,5750
814afe5b-2fe7-4856-86f1-ba45375c49ad,Healthcare,0.3136922924460267,39,50,617,1388,771,45.89490332752938,4610
9cc85dc2-9c70-469c-ad33-05b6aa6eae06,Commercial,0.1675108007839533,47,28,628,710,82,69.80996069332375,2488
cffb65c9-d675-4e75-9e89-a4357819fa41,Commercial,0.5454512494490213,31,34,390,605,215,50.182399915474384,1641
b0b64518-64c4-43e6-a07d-f71fdc41cca3,Educational,0.968616133778408,33,47,278,1373,1095,52.177382619329144,2326
78545f5b-900d-4e87-9681-325a689df994,Educational,0.335491244193206,26,47,538,567,29,75.13994575103993,7591
cbf380f7-1eb7-47e0-aef0-aa584bd43a0d,Healthcare,0.4930063934376281,45,6,9,1274,1265,46.26541586457719,4856
180be85a-92b7-4951-81c9-479ef4a599e5,Healthcare,0.2647237599716311,35,2,530,937,407,53.817851197914976,6994
b61bd140-c9a7-48a5-9e0d-a1248796806b,Residental,0.230205863214906,47,30,520,1040,520,27.536918435687408,4239
664897a9-94ca-442f-a224-2b619081c568,Residental,0.9686559444502437,46,31,413,626,213,66.01995794317114,4284
b6744ce8-ac42-41f1-9e1f-7b7939e70077,Educational,0.07387738617570083,47,50,197,1330,1133,37.49253386201927,8626
a1cfe6c3-9655-43be-9aff-c5b78c7d87b3,Educational,0.04673187954167901,43,14,193,1151,958,27.400129212122582,6313
e7938f8b-6d75-49d2-b6f2-d70e9f02facf,Commercial,0.17903690781101123,32,8,524,1356,832,85.51879418726627,6362
9cf0e38e-2f14-4ddd-8983-cf44696a27dc,Commercial,0.6695242180006562,19,9,619,1216,597,48.32255367835962,9073
18deaebc-8794-44f4-a625-d910cbd0203d,Educational,0.21521531910837222,21,33,141,792,651,15.091909460635339,3051
4d671149-13fb-4866-b368-4ccdcbb865fe,Commercial,0.6142841407211747,23,5,291,630,339,10.246724364975345,4275
0278868c-0f2d-448e-b52c-71f3dee98a2b,Commercial,0.1814146932583902,29,38,336,1371,1035,92.54397282876666,5510
f82cc2ec-b1ba-4f9a-8132-88e4becd13de,Residental,0.4717208995057346,46,28,416,1096,680,41.19579335231768,7724
174bd3c5-7fb8-48cd-9500-7d298df7de05,Healthcare,0.09772906945301874,28,18,156,359,203,29.951775046316655,1323
ca88d777-add8-4757-b249-f63f60cfebda,Residental,0.19622370047272786,21,24,76,1338,1262,15.847468609735161,9555
4e6467e0-1c35-41bf-9636-547c58be3ed8,Commercial,0.6388801193391043,11,38,187,1160,973,88.55331275867039,1885
6b8039b2-afcc-4b4a-a990-a724ac46a997,Healthcare,0.4227376274047433,48,2,530,631,101,68.0583591738042,8758
2bd778b8-0e88-4b53-9802-8487600670a5,Residental,0.36189059181089656,5,38,85,1180,1095,77.39172949087887,7534
c7ffd1da-969c-4e3d-b83d-e0732ea51864,Residental,0.6592795162355083,22,5,70,82,12,78.71388595894656,6775
3b55194d-d819-4744-b9f0-1d6f8e331b7d,Commercial,0.6568876462196731,39,18,568,1328,760,37.89952678618709,3349
a3266d9d-3697-4501-b3ee-0703b074fd6c,Residental,0.7499986524414498,33,22,330,1130,800,19.10500806603175,8841
3c9bd3b0-8514-4ff4-bdf6-491885281848,Healthcare,0.00414560826015542,2,32,678,1437,759,98.55251635941333,2198
dfcee9bd-dbde-412e-a580-38f822ca79f2,Educational,0.4515756349544655,27,48,400,600,200,79.00782824973635,9437
5131ad2c-1e4a-47d7-aebb-109af501860a,Healthcare,0.010255360548993897,21,21,528,608,80,97.65183027980036,1205
dedce329-eeb6-49f5-b51f-1a97cfa08b8c,Residental,0.8246675382074171,22,5,115,1292,1177,98.40401232299622,3523
d07d956f-bc60-4c48-98e0-2325df4bd536,Residental,0.6506073560375568,21,49,43,1115,1072,92.13668787713583,5799
98168028-0673-4224-8290-e31887c57ede,Commercial,0.7150772697306342,46,40,519,582,63,66.59773963257979,1407
5296761f-06f6-49cb-8685-e0d827433f0b,Commercial,0.3776542956138733,2,4,475,910,435,52.097309243800865,7982
67278b6f-6ae5-4848-9a63-e2d0141211c4,Commercial,0.32868625049969524,29,14,700,1133,433,55.00555134278239,3969
6170b2de-7c47-48ff-8ac0-499fbc7c382d,Educational,0.3404084696361821,7,14,100,1058,958,65.18083583801294,6067
e59ce480-1e7c-4654-ba25-6ab2c3de02b4,Healthcare,0.5006496293951985,1,44,38,762,724,91.38295164877744,2296
3b8c914a-9884-48cb-8414-a9c14d6559fd,Residental,0.3726798852963664,13,5,261,309,48,55.17946252123736,2653
c959165f-5f88-4aea-b1d5-2441811bf1c4,Educational,0.42414122713905034,36,7,85,507,422,83.40004190688384,9751
0552b33c-5a51-43f1-ac55-e1ced7083f7e,Educational,0.23098387882949079,47,42,41,94,53,75.36078553132504,7919
b31844d8-d9aa-4cfc-a8bc-2bc844c84f6d,Residental,0.5130884926116305,20,2,613,1324,711,66.5883235816653,3494
48f7ab23-06bc-44e8-8a61-c45618fec16b,Educational,0.9632362263434123,18,47,297,632,335,78.70651943040454,4059
ced68494-574c-4d06-b746-d4e8715d108c,Educational,0.27054426124965836,47,28,451,1235,784,46.35810891665141,2370
27d0925d-5954-4d63-9eed-7d610bbee8c1,Commercial,0.37965341624383064,19,36,212,342,130,28.555959219833998,4950
22ca8311-02a3-4d36-9430-52a8a75511b1,Residental,0.0022994156838131996,31,17,530,1030,500,61.27958536363761,6147
55eae5d5-9528-44d7-9ceb-1171d300d00a,Healthcare,0.2697259089591979,14,3,3,76,73,95.08717414083495,5045
1f9b8bbd-356b-4670-af89-5f565bbc8c61,Healthcare,0.5684913893193346,11,42,144,472,328,29.57924163517421,2831
fa1a63d9-d512-48b6-b289-43c65885a9cd,Commercial,0.9210619677080881,8,36,609,1372,763,34.696703591175165,3350
6e629cd4-cd49-4efd-a5f1-23344b498702,Educational,0.3704936644579252,28,28,71,403,332,95.40251199051048,4713
413813a9-4ea9-4f79-8ece-9c936bf38833,Healthcare,0.4818813534440728,27,46,652,1187,535,64.32816458596392,5200
098d3760-82be-4c79-8ceb-82f8b0909f73,Residental,0.4279683907029149,47,47,637,674,37,78.89593306390074,3430
89239e15-ea5b-4c5b-b894-237d834c4659,Healthcare,0.06406427372284462,21,46,25,818,793,94.80264949898903,8539
f3e4298f-19c8-4033-994a-4a4d0a567470,Residental,0.13532595626080413,33,16,108,1420,1312,14.58531456647366,1982
7d5401ed-d009-4aa4-96ad-5a7d87f1fab0,Commercial,0.11089631926355714,40,37,350,1074,724,57.68350450340328,4162
9aaf8b48-375e-4a6d-abf9-a9d5d3315689,Residental,0.18497790460632368,45,43,579,1215,636,16.592910852563904,3554
01c2b712-a7bb-44c1-9bd5-f644749eaa1b,Healthcare,0.8094053947939347,17,14,262,822,560,97.6249857526413,8042
c61e6272-7da4-46ad-836d-31d9a22179fe,Residental,0.9096269321563552,3,8,233,1058,825,78.05277128813356,8058
a6422a26-ce8d-44f5-9c3d-ab6b0fad6f06,Residental,0.6120138158024028,36,20,625,1436,811,64.27684184333751,5773
b378e0ad-e453-499a-972a-6d762d2fdbf4,Healthcare,0.9583972063131763,18,7,369,377,8,15.770903628441864,8044
97e16ba6-1b75-4566-ae3f-ef0c0d2c8b6c,Commercial,0.485577279086589,43,21,507,786,279,14.045356134181954,5552
0d21643b-91d6-4df9-a556-f377cc5480e8,Healthcare,0.7021086438372267,48,41,435,583,148,90.36526482820587,6550
3581cce8-6a71-485d-8146-a9387725a883,Healthcare,0.5927777308337211,47,12,212,569,357,21.45111712554764,3357
bfe3800e-fce1-44b8-9420-fbd644a68eb8,Residental,0.027085382132999936,6,48,94,1133,1039,33.525362022884295,6481
b24aebc8-01ec-4522-bbb2-36c68626dcc2,Residental,0.055928049057385576,49,42,358,1066,708,41.16462585937481,6918
4bbf43a4-5f70-4dd8-a4da-1100f3477374,Commercial,0.1357903572542819,19,4,425,441,16,98.03369745899941,3525
89f44003-8f86-4000-97f1-cdaea8a7b051,Educational,0.9648149842446004,7,16,401,1205,804,13.526529130686404,7286
0f14e5ce-bf9e-4771-88d6-83a366492b1b,Residental,0.2360352961511588,35,32,697,1011,314,55.16174521069878,1569
eb8add34-0d19-4b85-92f2-bcc1b48c5f5f,Commercial,0.5679776822531516,36,31,713,1052,339,90.09018868240112,8023
0681a7d2-e051-4690-a027-9bfc8559392f,Commercial,0.3847847305339671,50,25,668,812,144,22.981285775080988,2585
fd4c69ce-7db9-47d2-b9a4-fa85053bca5e,Educational,0.47365231686387266,28,33,454,1393,939,90.14032383131536,2469
792bb6f0-ac7c-4995-9816-9dfe787ddac3,Healthcare,0.0887690854799883,17,26,528,756,228,80.04554583290448,7287
d9c8025a-076d-4d5d-9190-2aa96cba6b1c,Educational,0.2620432832275933,18,9,634,1401,767,19.992905206101337,6204
42959935-1844-4024-8d98-bd0f75024af0,Educational,0.7729234105546207,35,8,436,586,150,31.356674536404054,2021
bd7144f9-28d7-4378-b91f-6da50f5cfc7b,Residental,0.9106467512205926,17,2,452,1071,619,78.14350233910986,2481
c306e9b4-2322-4868-89cb-ec8961624ae6,Educational,0.7229327219905789,3,14,34,1414,1380,36.33626919552306,4642
734b562d-3ae9-4aaf-ad1a-e0d87699762a,Residental,0.3537780689987662,43,35,422,534,112,21.56783566227181,6039
a33b3eec-0dd5-4532-8ea5-3485a0512ba6,Educational,0.10196660646668176,24,1,509,614,105,25.34329927933607,6454
20dbff41-c768-4d7e-be07-f1d76a53b679,Commercial,0.4502002811363769,31,28,298,1019,721,58.92483868415846,3664
38f8af45-a5af-4db9-a164-5915a682aa22,Healthcare,0.889395219635786,2,6,89,358,269,30.390671144510684,9029
7e28e409-7ebb-4ec9-8d87-292d5bae92b5,Educational,0.8516905901228474,37,15,106,1111,1005,26.382314536274702,7095
ef5ad1fd-5bec-40fa-81cd-b7aac567a58e,Commercial,0.4255788288598116,45,6,67,1390,1323,35.65604792283537,1457
386cbc30-d71f-4146-97c5-a2ed97302ca2,Residental,0.8769834315081768,26,32,364,456,92,85.55276756317014,9422
9691a480-c11c-4637-9aa9-29a4ef7b4781,Healthcare,0.9196320257372808,49,19,448,464,16,29.102769866498292,4775
594e55d8-a327-4e15-b8fc-8471cabffa67,Commercial,0.220567687047162,42,17,708,1277,569,69.16912324722193,6724
557b4849-d635-4e4b-9744-8be2d327c950,Healthcare,0.23139510095888383,47,34,57,383,326,74.2771930209291,1285
009cca87-300e-4909-a82c-e103b78051a4,Residental,0.27961753827789193,36,14,468,1257,789,18.449909019363645,3219
62a0e3f3-25d4-4fb9-9ef7-5b690fd056d6,Healthcare,0.9358040919782318,10,11,208,1114,906,55.5298300530356,9807
bf10f154-2a34-4415-824c-90b33f63d147,Healthcare,0.8228833313584917,38,49,60,399,339,87.1936200721731,6257
1e2a4f0f-d0fe-4929-809a-3713af769f60,Healthcare,0.01713267151591391,19,8,244,1302,1058,55.167561754105336,9810
cb4c99f4-e583-4d42-8246-d856fbde626c,Educational,0.7597354583478597,50,27,170,537,367,83.20276537699014,7191
b36a12ad-5349-47a6-82df-9fd9bb206ac0,Residental,0.19963306028666206,3,19,488,724,236,37.829114838482724,5498
7e63a452-2941-445e-bcaf-8443743d5543,Residental,0.957309394317078,41,50,674,827,153,93.60192897232564,3914
15765620-a8ae-40cf-abbe-2c8dba4e8036,Residental,0.7408456606954057,10,35,167,1334,1167,39.439608357120136,4382
57b200f5-4dfd-402e-ac9d-e4fcfe0cd0dc,Residental,0.07717553644267883,26,37,544,1218,674,35.227267379519866,6401
8cae423d-2bea-4bf0-92cc-0df0ac0878db,Residental,0.6962925939969071,11,39,656,1321,665,47.519397209572254,5764
ff897fa5-63cb-4dfd-9605-ac372090f24d,Healthcare,0.17320021760654747,30,4,216,1415,1199,61.35850435276115,2209
38d1b9e7-d318-4d5b-99b2-6c33901546e9,Educational,0.23976475668954778,12,35,171,1094,923,74.62399802976253,4273
29b443b6-e25b-4a2e-a2bb-47d8be870942,Healthcare,0.2531769982519664,28,34,493,560,67,80.96990593625974,9445
b3150641-1b05-4d5c-82cd-749fe68fbd71,Healthcare,0.824610040792304,44,14,496,920,424,45.65673274333526,2599
00c7c3c3-9b37-4a2d-add7-87ab40984e9b,Educational,0.5247785039272063,28,39,31,799,768,41.51892239358865,7696
68e5dec9-47da-44e5-8982-b7049be5e1b5,Educational,0.1706835100905132,24,13,576,752,176,33.96831453027602,4628
70182aa9-ecb3-414a-92b0-90b3b52049ab,Residental,0.0034411475226866495,40,30,461,1267,806,77.51595487481858,3423
79c93413-c30e-436e-ab68-65cb39a6e6a3,Healthcare,0.855666664265574,42,28,457,1414,957,60.1676217617658,7392
9e396731-d5c6-4c0d-b561-f2cc610ce358,Educational,0.589855492172068,15,47,259,979,720,30.0109405354458,9537
c3ee119e-c9c1-46b5-8133-1d3fb0938395,Commercial,0.18362789950232683,40,13,398,971,573,39.28294381277844,3646
668fd4c7-67e8-4aec-87e3-cceec0048f3f,Educational,0.031419762767508685,16,26,125,233,108,86.95155550087676,6282
007c73ec-e3b7-4add-9c1e-a6bf06767238,Residental,0.6608870720791682,33,46,704,950,246,98.3747906720272,7066
c27108ba-1f3d-4ef9-82ba-d3f803d02570,Educational,0.1682201439492892,7,12,364,1224,860,52.68379803981172,9636
0292462f-5aac-4219-ac66-14f43ce4cfab,Healthcare,0.8257616398637201,36,18,522,1342,820,40.36218545229906,5185
1bf1e6dc-b029-4cb7-bedd-79a676f5222e,Healthcare,0.8153550377130465,39,42,526,1325,799,74.26654927375398,1463
48c3c78d-8418-46bc-9348-23949688524e,Healthcare,0.48435141785292113,16,3,675,1383,708,83.29534446366976,6906
2b87f950-64ee-42ba-9ea5-151ad7e5df13,Healthcare,0.14676799415782582,6,49,98,684,586,85.49111450546151,9878
b83bdcdf-dee5-4fec-8e4a-3093481aeb76,Residental,0.4416340735703803,47,4,305,677,372,84.54373945241711,4948
ad40e108-03ec-4537-a583-93fd4ff9568a,Residental,0.174661526944776,8,16,193,1110,917,89.24264751054159,6515
3c998d06-f4b5-46fb-83f8-beb8c9041036,Healthcare,0.5621460962556895,14,17,687,1371,684,30.007929127601074,6681
000cae0f-3674-4f7d-adc3-5f968538fc2c,Educational,0.6704746270460291,28,49,67,860,793,66.44360744244582,1738
e212c963-7ef4-472d-969c-bb9f28d6487f,Commercial,0.8651074637688894,11,20,2,742,740,32.970490528871295,2832
05137212-e0f8-4f8e-989e-5a37f3b80420,Educational,0.15621883856093866,13,26,54,856,802,87.35235256560146,2303
aae2b151-fc53-4d42-88c8-337806ccd190,Commercial,0.189355301691275,21,22,338,380,42,80.1494766876281,6970
04e722d4-c1d0-4f7d-b7c2-3f866bd78e73,Residental,0.38499015268114667,38,16,62,419,357,21.71247673755846,5873
1ebb9f6d-0d97-4593-974a-08556a9d8d36,Commercial,0.07374964081632629,27,42,70,1430,1360,38.00202343326487,2980
d7679add-f040-4822-a47c-a8f2fef871e2,Residental,0.3314905987579382,41,23,585,1298,713,31.552648783328294,5263
7fbdb191-1f46-43cd-b2ec-9c92577ee845,Educational,0.061228572696817696,22,30,581,1250,669,27.5890070395892,4530
1b20fd05-c297-4a56-9309-d705b443d4c4,Healthcare,0.7256620766611455,39,27,67,695,628,52.62780769158202,1782
d707904a-a9aa-48fd-8db1-4f7ca0899c52,Healthcare,0.14368784682992897,49,5,282,1148,866,46.566629964581104,4949
4f457336-96d6-4a26-aeba-d173cec5d450,Residental,0.9161824364302921,8,5,521,1348,827,28.139961862854722,3878
12cb808f-87a5-4e89-9caa-6af368ff0d75,Residental,0.4239760243605569,14,2,604,701,97,14.661926871156675,9479
a34711ff-bef9-4d0d-bd58-06f6769bda70,Commercial,0.9244482251484252,22,14,153,1230,1077,84.60429925248884,1585
724b2599-5a24-49d8-9529-4ad1d5c56d0c,Educational,0.03297908691861451,37,26,135,254,119,94.18866517341941,6802
b0a8306f-bf3c-4664-9f26-7bfd46a29b2e,Educational,0.2286643909456536,45,48,646,660,14,40.81212989615996,7408
9d3037e9-5b76-407b-adeb-cf8c73bdd683,Educational,0.4027609599210439,28,3,669,960,291,24.08528118822388,6184
ae26a678-1b0f-4c99-ba73-983d764d0481,Educational,0.8233172804071811,46,20,139,821,682,43.385363731799295,1990
d3d355bd-1206-49f2-b1ff-196c607e72a2,Residental,0.839295128683067,36,4,645,697,52,93.14015269548307,7779
b64e68c2-ea7f-416e-bbce-17816dc26690,Healthcare,0.47222758769591044,15,26,673,1217,544,72.0813820293996,3811
64bf0aa7-327c-49d1-9809-510e63fd21f9,Residental,0.1725934442018705,13,25,80,1405,1325,49.78522104826234,7039
60bf3615-13fa-48da-bc00-c03a62a15d79,Educational,0.2304730123392683,3,14,697,1388,691,48.024178455993464,7887
59e91a4d-4f81-4b91-9a67-aaf60fdaf87b,Residental,0.8221102638901748,43,34,223,968,745,67.37804594014494,7745
983c1064-b4c0-4ce8-bb83-5dc03b914421,Educational,0.9081562790855546,43,13,134,592,458,89.28069900262244,2624
6418afef-7901-4437-b20b-b373d871ccf0,Residental,0.5864626996806445,41,11,344,696,352,56.261146667581585,8347
843e71b9-09e4-434f-808b-ed965f63da75,Healthcare,0.7749236592398444,14,30,126,654,528,12.925856773124085,6711
14c5e26f-fc81-4fc5-b803-bd4408fe4496,Educational,0.7793232694478925,26,44,680,910,230,27.627687974921223,9115
65e01f81-d6e3-4fda-bf45-902c17381c46,Healthcare,0.0004671007084890988,33,41,664,877,213,32.14389405724363,9600
e6b23ad7-9135-4953-9239-b42c8bce08cb,Healthcare,0.5037275937597379,9,19,633,1316,683,70.33455680370281,8236
fec9d103-282a-44b9-ab64-6d6140fd890a,Commercial,0.7079750446516517,16,18,593,1178,585,53.812907357988536,2908
093c86c3-d79a-477d-8c74-b390e0fc128b,Healthcare,0.5456581745458022,5,6,104,1118,1014,13.25997298627166,5314
7c724b5b-58cb-4236-aa4d-0e233e4e64a1,Commercial,0.8316156879233388,44,19,466,753,287,10.882439974187255,4137
9ca3367e-0c4c-4834-bb81-cfa537c848e1,Commercial,0.20978154012892425,22,50,160,1395,1235,57.44311915512784,4807
08953906-a063-4a23-83e4-ab2017fd0fa4,Commercial,0.6089931789859074,46,33,9,453,444,85.30381992515419,4383
38c4a6e7-070f-4133-9411-f0447416bee1,Residental,0.30801246647046865,35,47,115,1231,1116,61.59377804125492,2545
ca54c1ea-93d4-4efa-8eb7-b3b41a820da8,Educational,0.6906623297084503,39,5,627,982,355,76.05192648015365,2151
2aa9b487-59c0-42bd-9af8-60de5660a778,Residental,0.7958893271816293,49,9,346,1225,879,66.43973944484364,5166
a7ac5416-6d4e-4941-8e02-1da2d778a6f1,Commercial,0.9487042283823235,9,48,562,1144,582,10.05988533948527,6202
b2d987f1-6bd1-44d4-b7f8-04d9115acbc2,Healthcare,0.953869100426528,26,29,528,1067,539,43.22155543739588,9619
5b12b941-feff-4b38-bc4a-4dac00f9e03e,Educational,0.580476945203205,23,15,310,742,432,53.06842908988989,6706
f63f59a3-a734-44a6-b666-24ade296634f,Commercial,0.8932640432287272,22,37,458,1102,644,64.53028690318189,3150
ed1c0a96-ab6e-4e7d-a089-13985c29a7af,Healthcare,0.9780934036454662,48,5,639,944,305,62.82772959589255,8305
e034f174-2b7a-472b-9682-6815fc5fca4b,Commercial,0.08358324723222255,7,30,426,470,44,38.994570212748755,8922
fc434bbe-c480-4fcf-8acb-91894ef91c3c,Residental,0.8956642957661983,24,35,631,1283,652,85.43055522859126,9059
4a5f0792-70c6-45ec-9927-83b7f6eca9cd,Residental,0.12893040897510988,15,44,154,1223,1069,76.54563182596516,2646
89237d86-1bc9-4af8-a55d-9acfc5b2e8eb,Healthcare,0.3178719378211655,23,30,86,839,753,10.399809529059782,6464
94a1bc3c-4a5d-431b-ba22-ad0e15223340,Commercial,0.7298433416212712,24,40,110,1192,1082,40.46345488033417,2830
05f989b3-baa7-4a47-bdda-719887e4c482,Educational,0.6641125383163102,48,41,59,1213,1154,67.62086455611382,3109
175182db-21dd-4005-a957-957a56d10d45,Healthcare,0.8309406615539532,45,38,347,372,25,79.80109835924664,8550
62207e5c-9a5a-4044-a4aa-60a73293b165,Healthcare,0.8152449384272581,12,31,485,889,404,15.659860008529694,4226
154e20ad-674e-442d-8b71-a7620ffdbb5f,Healthcare,0.7977518849684965,17,4,261,1024,763,14.6456608402945,2933
4961bb91-4a4e-43f1-ac3f-138446b3b02e,Commercial,0.5485628782742383,25,19,352,1092,740,93.94543129270279,7334
9e48b87f-faee-4536-96e7-e0e2f1f8ccfa,Commercial,0.8033851816246133,27,11,114,894,780,75.71616504328989,9026
283c36d6-cbc2-47d2-8d49-fbca0a9073bb,Educational,0.14647116908780844,4,41,553,1192,639,62.81340467486842,7446
bb7239e7-0e4e-41fe-974b-706d27fb1950,Commercial,0.3020184865445238,10,50,79,644,565,80.69198508369283,4493
6db49474-a0e8-4239-a93e-b6f39d3f8693,Commercial,0.23183853080290184,6,1,378,1206,828,76.46415871507538,6597
044e931e-fec2-48b2-907b-6e87791df167,Healthcare,0.37892266991798196,46,48,549,707,158,38.80893981609788,4991
4c6cf198-a802-4a9b-ba91-dbdb71d9cd38,Healthcare,0.4765730305874746,31,30,522,1410,888,71.39101010842276,9878
b5d012a5-b795-4814-8424-c4002a9b67d4,Commercial,0.21369502727667256,17,34,142,367,225,73.37530569452959,5019
7c30861f-61eb-49c6-9bc0-d35f5e71c16c,Residental,0.9498300572511797,37,15,553,941,388,90.29790933104807,8303
77b213b4-6444-4f0b-9066-bc30bdb52900,Educational,0.9839876257707809,11,4,323,765,442,12.270875662787315,7601
a98526c3-602b-4111-9019-031fd3f495ad,Educational,0.9444071111777257,25,40,475,642,167,50.39293630012019,6430
6b258cb1-4ba2-4540-abb5-087c6921a968,Healthcare,0.718767683495854,15,1,306,338,32,24.985848195361626,3397
fbf0dc3b-c5a6-4b0f-ab57-8b53ed3c39b7,Residental,0.0008550637429615149,7,22,147,1305,1158,97.19015666120096,6189
d6437231-4f83-4de4-9bb4-be3f5e0edbde,Residental,0.5235542851662928,49,48,40,1099,1059,37.40193745444644,9381
f9790c56-e5c7-49f1-8b1f-c5f6555d8be4,Commercial,0.037923840352358185,32,45,429,877,448,67.56261292319486,6039
dd6da420-c224-4580-9f5c-fe97811b442b,Commercial,0.11803263894135774,47,20,269,436,167,28.912452180731105,4832
f3940522-b1af-45aa-99d0-15816caba1d5,Educational,0.9338127801792473,23,18,197,1363,1166,25.516062217235923,7619
14b50a06-6afd-41a3-9058-387cca28372e,Commercial,0.631730187623079,17,33,368,678,310,45.924126972115964,7575
87ba3e99-b7e5-481a-a04a-94ba441f82b0,Healthcare,0.2985622700413494,48,27,714,1069,355,95.3711762505197,9869
f5b41eb9-8d40-454c-bd41-729e4d83c6f6,Residental,0.21858444712875047,29,47,706,831,125,54.61790717998322,2385
2985a456-0665-427d-b12c-eb1147954bd1,Healthcare,0.8955472663536209,34,43,124,511,387,58.345238445988876,5028
508c8c5e-a136-4ceb-9215-1775d4fe052d,Commercial,0.4267468124873224,23,45,189,1200,1011,51.217585819281055,6052
50df2556-633d-4a4a-ae48-d3c212974cb5,Healthcare,0.9156024155478388,25,1,411,589,178,28.902999072247102,2074
a52a266b-e984-4494-ab2a-05e973879b91,Healthcare,0.9610398236448392,12,18,529,1414,885,97.54893746829734,2782
11777bd9-1d2f-4a57-bba5-5531886e83d7,Residental,0.05284682367031224,32,14,396,518,122,92.11721632371487,8478
0625bfeb-1e3c-430a-a4a9-de2819f58458,Residental,0.7871053007482941,21,1,122,1274,1152,15.740330898033937,1871
582f3726-2153-4b06-bf8e-b94245c70cc1,Healthcare,0.32449296683445594,8,4,299,962,663,23.105806826523754,4734
0b09d37a-cecf-41d0-b9e1-2cd4e28c07ba,Healthcare,0.4919729991234405,18,7,48,476,428,75.96243861903017,4990
334fee6e-daa8-4173-b44a-3e34793cef98,Residental,0.21433529454107447,43,29,501,854,353,88.18622564604776,1077
d9859620-0009-4643-a65c-e745612d6bd2,Healthcare,0.3367223188989069,24,11,254,961,707,11.06922924801454,8730
ded2001d-2cf4-41af-8630-77b1d5720a86,Commercial,0.2120567461561731,17,11,34,669,635,67.99274102775419,8267
a46778d3-cbb6-4c32-851e-b9bbd5cfc255,Residental,0.03329533519515482,46,34,582,1285,703,96.37960907022685,8409
f06efa49-cc6f-40b6-80b6-81aa3ebd5ee3,Residental,0.481953182324258,13,11,244,755,511,64.53328301898276,3029
79f0879c-be88-479e-9a21-5b9121654269,Healthcare,0.2484838786839595,4,48,322,754,432,42.70680558341304,7536
7e32be54-aa2f-410b-8720-57a7f2e219c3,Healthcare,0.9409108070756333,16,12,204,507,303,70.47570005558784,6753
8f09f6fb-44f0-4116-8413-76497527ad37,Healthcare,0.07999002314670833,29,28,46,363,317,19.183712859951278,4783
b3354253-7c91-44c4-9e86-e91fdd8e5df8,Educational,0.039093444560464485,8,3,83,1432,1349,82.95565544544034,5819
52043880-fe50-4830-96d0-8f15ca1f7372,Educational,0.007821817393417585,4,34,394,707,313,37.39294029020331,8740
64fe33af-2382-469e-b200-4003caca1aa7,Commercial,0.10294228116096305,48,29,604,1245,641,30.07705186693493,4361
b648d327-f906-47ff-aa59-b8a8c33e54e7,Residental,0.3057180453385784,38,31,51,139,88,65.96966772684871,2573
11300c50-c92f-43f0-9142-d2f35f0d9c7b,Residental,0.9162210871848608,26,12,617,1174,557,76.63974011279431,3988
8986b853-8042-4580-8591-da1d68edd8ce,Residental,0.783059819979772,15,13,401,902,501,36.188129329518084,4972
de9dd1e1-c6e1-46b8-b37e-6fd977666c5b,Commercial,0.06859732575681676,29,37,514,1294,780,31.23799704431482,7759
64646164-9512-449c-9806-4ba77c2a6c73,Healthcare,0.7547609115257029,6,17,693,1018,325,70.62143797509096,3977
c4a88a72-537d-4d8e-8616-669d1f6da69a,Residental,0.2613379627736667,22,9,206,1136,930,70.41660919768583,8788
01506883-7b11-4d4f-bd4b-e116bcd0fa4b,Commercial,0.10915755786950276,25,46,206,1231,1025,34.53613794002647,5615
a67e024d-58e2-4afb-a000-68b39efad715,Healthcare,0.02798235312333719,23,5,634,740,106,12.233218300517484,2358
504da480-c490-449d-a9dc-8e8b97c0cb60,Healthcare,0.09007536016636408,45,14,518,1251,733,13.112621960750525,3712
55f54ed3-52aa-491d-81c1-9f5bcd8a8245,Educational,0.04690618453218476,39,11,108,1019,911,81.81613514166901,1380
3e2f15fb-eb85-4076-8a9b-354972cc6942,Commercial,0.5540582452233631,43,13,255,546,291,42.93914247454218,8427
9573784a-d54f-498f-bed0-30303ecfa558,Healthcare,0.7967869103661013,4,19,560,696,136,46.43276623877232,7811
dfa51056-544f-4917-8691-3159d38d50cd,Commercial,0.12011122659463025,50,29,169,481,312,58.74013769798252,9910
86220a53-013e-46bc-b8a6-07531dd05088,Educational,0.70989716116221,38,25,679,881,202,50.44184131028557,8994
908fbed9-0640-47ac-8737-fcc9d11271f9,Healthcare,0.5879071332707962,36,24,288,1333,1045,64.04384586147677,8715
2933e3b9-628f-4dff-af88-3a8baaffbb4b,Healthcare,0.849609075689861,37,44,78,856,778,83.692629952926,8184
d1b0a200-19d0-4305-9dc4-be0112568104,Healthcare,0.6995475373179092,8,40,292,545,253,93.03101814988307,1129
57ec962c-b967-4be4-bd0e-e7256c256e23,Healthcare,0.2328024952638159,29,44,526,598,72,38.089649584255326,8079
68ea5813-9b6d-4a84-b8a2-6af3f451057b,Commercial,0.6487433441149419,49,34,629,1110,481,77.74151498312057,5430
17a2b1f8-5984-477b-8a4a-3459413e84d0,Educational,0.9105249996684417,7,31,130,908,778,21.419189095775955,9174
8a96a7c5-3b80-419b-b477-529a9d0f85c8,Commercial,0.44237939958012473,47,15,34,398,364,85.99015701313056,3917
f16d99bc-3b88-4cd1-87b7-f6fb9fc7fc8e,Residental,0.26427036754780986,28,29,208,902,694,45.884215108275086,4378
0ffa5734-bbad-49ab-8869-54b044a697a9,Healthcare,0.6680124714794405,13,6,199,1052,853,28.233787865845198,7639
5f0cf1f4-8397-43e6-b666-44fa38b521c4,Educational,0.19684902618073463,19,26,422,997,575,79.27835893164614,7527
7fa0ce2b-005c-42b4-b2fd-40cf2030f404,Healthcare,0.15485085796293696,14,33,688,693,5,28.944235002322348,7228
4ec4c3a3-b39f-4086-9e59-1f370760430b,Commercial,0.667985611378756,11,40,31,380,349,57.45208216688046,6364
e9d1679c-f463-4982-b510-ae47650da175,Healthcare,0.8429071158541684,16,23,277,571,294,49.526641909186,2711
5a19d617-d415-4d8a-9d25-fabc7960caff,Healthcare,0.055703122551049145,3,33,687,1405,718,79.02345634663749,9914
c6b3caeb-239f-4c34-b3de-94b8d2ba6233,Residental,0.4977120450986888,8,5,284,1211,927,66.71442145098021,6006
3e6a0c93-386d-4b17-8b01-881ac3a4ed67,Commercial,0.39934876241165473,38,20,490,1430,940,43.88114234298429,2741
d323efb2-4c0f-47cd-bced-647ca7e5db2e,Residental,0.9777924559340965,4,17,382,1060,678,94.11472023958078,7890
55945ff2-ec2e-4b56-b382-bc382d0e256c,Commercial,0.5345373030696203,27,21,498,855,357,58.48450638722289,5715
925e7e30-c56d-4d6c-af2b-5731921cd214,Educational,0.1773040494344038,7,20,140,1337,1197,97.21920489165547,1854
5ef63eef-b998-41af-bfc0-37a64e1d52e8,Healthcare,0.4542867188308063,13,5,450,1303,853,86.73888411711044,7692
13a35700-6c83-44bd-ba51-e3c40454bb30,Educational,0.11848516196468484,48,31,62,970,908,17.18308798243494,7941
606b13ba-da98-4f1e-832f-85bf648dfd91,Educational,0.243151405417246,28,48,586,1117,531,31.623130881441305,5897
8cd8ea37-0d52-4a21-9eac-7f147f5d4feb,Educational,0.16328617272959023,21,2,193,416,223,68.5975330238219,6572
51b13f83-79a2-427e-9e53-0e5a5dbd655e,Commercial,0.16924576566615768,31,18,498,1220,722,72.79560658580618,1454
e2aa2847-aac3-49f8-86aa-c45694ee44d7,Educational,0.6315612871590877,4,19,525,902,377,98.06469864298369,2792
13662941-2324-4282-9e57-7a7d61414ea6,Educational,0.2501399070966893,31,5,53,984,931,54.351802752781765,9960
ddc32f59-429c-4ff0-96c0-98de2947791c,Commercial,0.28894640123363535,29,26,369,704,335,31.091756248670507,9276
2432a387-526a-4df3-b6eb-e482a354ede2,Educational,0.23717197121673994,31,19,148,216,68,55.997069774665434,6320
af416cbc-dfd8-4f90-809f-55dd1fffbc2c,Healthcare,0.39569994618723425,36,19,113,909,796,81.73697567547832,5376
2e72f5b8-7af5-4e41-9d4a-5e84b875ac5b,Healthcare,0.009460922824396145,15,15,685,773,88,32.3764361077464,7267
d6a7f8f7-0d46-40d3-bf3c-882a0d41934a,Residental,0.4504678981297616,42,7,239,849,610,53.90400670187669,9415
ffb7592d-d4a0-40a0-914d-aea3884d4109,Healthcare,0.7563983489329302,10,50,647,1354,707,38.36015130895272,4892
accdf9a7-cc9f-48fc-9e6b-e962f97df927,Commercial,0.9609519103906495,31,4,185,1153,968,76.86445252118453,3507
8ad913b3-3395-492c-9e49-58eaf94073ea,Educational,0.580798987152917,36,47,514,1343,829,12.909697881114859,6329
cddd588d-2eb2-4e7d-b1ae-39356d3a3d89,Healthcare,0.9112027602714057,48,28,23,79,56,28.387661611253147,2470
2a071410-ef92-45e6-8a33-e43bd2240826,Residental,0.16077559769966387,35,25,323,371,48,59.74761412256436,1091
8f064e51-0dd2-4c68-97b6-8a96910a6ee2,Commercial,0.4891366987410186,40,7,348,547,199,63.997680349673765,8290
060b3c74-e5f9-41c6-bbd6-c4d90c0d298a,Residental,0.5847052408656042,38,42,617,1078,461,72.43534511648579,8850
fc5a8893-56b7-49f2-85a6-9617423cf46f,Residental,0.5371873541673253,19,40,257,1046,789,29.481672852939372,2908
e65be2fe-1dee-49e0-a08d-bfa4d71c6187,Healthcare,0.9267332987902045,15,38,583,895,312,11.83314258773177,4141
1969696b-2d93-4012-a660-0ba0e9ec4c57,Commercial,0.013162199879152348,45,2,227,1404,1177,18.830736252189176,1043
70c7689c-7fbd-4bd4-938f-4d55112da48b,Residental,0.04865899433845178,12,17,122,1400,1278,70.54015285205787,6629
2ce47920-0abf-4cca-92ff-67683db4f6d9,Educational,0.4606240527472144,22,49,35,1146,1111,42.15640270360762,8301
fe56155a-07ad-41ac-86c7-c3791598f0dd,Commercial,0.9095117809834301,42,43,182,456,274,83.97825793205595,3403
b04f2ec7-3403-43b5-9ca4-3c17e6a861a9,Commercial,0.7659937538158681,36,31,247,596,349,77.25951033803311,8274
74343b46-1abe-4a79-bcf8-98987a3ac283,Residental,0.6390664520935824,41,47,539,1051,512,82.31417243509024,7261
90701b10-ec3f-4f88-b9fe-cf23f4bbd0aa,Commercial,0.15792821126124756,4,39,8,182,174,39.930022348824586,6305
8d1fa33c-9492-439d-80db-3e83ed5103da,Commercial,0.754707099615048,23,47,438,658,220,60.756322671628894,9460
16c6a3b3-fbaf-4c28-9fb9-a3a1bcb2ed34,Commercial,0.890277923744498,33,9,379,1171,792,78.91445924432357,9385
09a08b07-bb25-4d87-9314-7ba2f1549f4f,Healthcare,0.1928043334870927,3,9,96,740,644,92.38448445972124,5410
ea6ecb0a-54d6-401a-8399-c8ab259e930f,Commercial,0.8932764310274869,34,40,328,534,206,45.1734622541085,8554
2b673b01-71d4-4dce-ba97-4b992493dfab,Commercial,0.06074040375685985,35,2,602,798,196,80.04829854120372,1747
17f53fdf-7a35-4f4b-ab99-968c41cfd333,Educational,0.4940168833560329,19,30,241,604,363,78.93597905345527,8883
ad44a1bd-2f9e-448a-b419-beb1b6f60261,Commercial,0.03355307111793293,47,21,273,1137,864,91.6226706211352,8745
8731ec0e-24c8-453d-b38f-585fe152250a,Commercial,0.6864083361000517,45,6,107,1064,957,60.464028597935375,6637
a999946c-f209-4659-8697-1c9dc15564b1,Commercial,0.008753476735232746,33,12,700,1196,496,72.38705276556342,4255
1527a227-b8e5-402a-9128-f6c4b2b0883e,Healthcare,0.6465893985745548,9,1,340,842,502,84.86627598489117,4804
5bdfe82f-4ce7-4f34-a8ef-fc9c720ca30c,Healthcare,0.737394155455041,20,34,85,1164,1079,96.27764402071278,3780
c6598de7-29dd-4dd2-8f4e-4baa83041d2a,Educational,0.29358464682916363,49,10,209,932,723,32.044509769403405,7991
26c125af-c4c0-4f65-9421-70649b1add96,Residental,0.5791591738668646,43,1,305,838,533,96.38981620395288,5757
c4ebcfc8-c5e9-4d99-8c4b-2b3639b43fb6,Healthcare,0.00597832009191035,44,31,447,565,118,39.367181840209035,3503
0f6494c9-a820-4d73-9f2d-ef42ba9bc3ca,Residental,0.1484220360210794,2,21,472,1348,876,47.71398301722297,2995
dc08faf0-68bb-4bef-bb2a-3360dff0d9ba,Healthcare,0.8055909019456147,13,23,3,323,320,41.200689749891154,4814
38e2a40d-b554-4a7c-b431-1317a9db9beb,Healthcare,0.39134598541194876,11,44,244,785,541,34.27125740844409,2259
bb6e93a8-5499-4229-8718-891f9a46b382,Educational,0.36989517223682256,46,29,662,1129,467,69.35613763006158,7920
b6052c90-a782-4b8b-86f4-b2b3ed8cb5c2,Commercial,0.003887980273493463,43,42,313,432,119,23.9498350452007,7859
bc07d7e0-8ea5-45d4-9537-5375eb70a0aa,Commercial,0.5073468303890752,1,23,557,1035,478,38.55362333713116,4271
5b50e36b-af98-4502-95fb-7873c2af70af,Educational,0.9739286928922958,36,48,241,461,220,55.89797762955764,3462
afd72c1c-7cf1-43df-82b8-dda6f1e90b93,Healthcare,0.908287415839378,4,31,601,1005,404,50.26711535077292,7409
1f0ed93a-01ab-405a-98c9-6f79b36ab75e,Commercial,0.336527664837337,25,49,383,1354,971,71.83985381436054,9584
802d8e47-d878-47ec-a4d7-c605112ef83b,Healthcare,0.298022462520369,48,32,98,289,191,77.75132359062525,2589
929c9f90-d1c5-44f3-9306-3f5c6d5870c3,Healthcare,0.06273238249438107,30,31,251,360,109,80.788470947692,2794
687a8311-29d7-4ff2-b24b-1e7a133bd793,Residental,0.5199450675731497,2,5,630,1058,428,73.59014992581278,1954
70ab07fa-dd8e-4a3f-9352-5e11691504ef,Educational,0.8729772431283082,35,22,48,71,23,40.721724287603024,2163
46cdae7d-5807-4ef5-8997-a795a959ddf4,Commercial,0.4823839486813525,20,31,112,342,230,72.31139132994876,9522
00d392c6-5774-4082-b779-fbffbab14c70,Healthcare,0.9642647192013575,4,27,639,1397,758,83.49596485191867,3089
ed90a554-9faa-457b-960d-aa6b8b5805a9,Residental,0.010347118631368946,32,34,534,1029,495,44.07660594599155,6462
1b6776c9-7769-4d57-a421-6bf96aa5d655,Commercial,0.8471999767794368,37,22,712,1398,686,69.55890715692979,7489
3e8f1946-882e-40b6-801a-09ced4a0f6b6,Residental,0.52829964992452,45,34,463,852,389,41.960103808583334,8958
0cc05f69-236d-4134-84b0-3754783f3ee3,Residental,0.06280540937478918,24,3,317,596,279,42.48440890340673,3900
4d76906c-0162-4bbb-ad92-47f74644c598,Commercial,0.5821194384792648,35,16,637,1431,794,88.17291502704788,8529
a8b29960-2f3f-4f0d-b018-82f5b60b91c0,Commercial,0.7359385531101315,40,2,580,969,389,49.51060043888324,6432
b96e4c77-cb91-4540-aae8-cdc0789fce35,Educational,0.865272981205816,47,48,376,1296,920,99.78575934807434,1030
eedd16f7-1214-414e-a6a8-ad0f10797bdc,Educational,0.32806364394063015,42,6,338,629,291,19.91393042396027,6820
4dde7dbc-1ca1-4b4e-a46b-69be362037b8,Healthcare,0.5921407625562575,13,19,592,903,311,89.19801189015278,3345
b29c88c8-ced1-442d-9b1a-37732ac5ecd4,Residental,0.29075123645479384,28,7,299,962,663,40.069390936283966,1413
ba93d497-aa58-438b-9396-f98628597d9d,Healthcare,0.950603132164485,43,20,521,1006,485,19.16860175875923,1201
838a5bb8-acb7-4ae7-a1ae-607340d596f9,Residental,0.4036324591268651,7,24,638,792,154,78.84600305362764,6030
6f8dbd9c-4f1c-4f09-a013-8f4aafd0d847,Commercial,0.8140083981515864,46,9,231,1361,1130,93.65733063879645,7904
92896e5d-4185-4bc0-a6fd-d698e6d735d9,Educational,0.6942870731555564,26,16,199,486,287,49.65547805027358,4913
7b5a30d8-ed32-4495-89a1-b3eb3dee9b14,Residental,0.26700934673998766,5,15,141,477,336,93.94245936928742,6139
858d66ea-9042-418d-b62f-ae1e337eef9f,Residental,0.4900749802603003,5,46,444,1175,731,38.26165804375522,7612
218b5bcd-0338-4a89-ae1b-5d4dfb41c621,Commercial,0.7595688300070104,31,5,482,882,400,70.3089093233393,9160
7f2a41d7-5d5f-44bd-bdb6-e6a69a538605,Commercial,0.8138094378811347,25,18,691,795,104,32.33266408385663,6615
08d7869b-3b73-4a5b-ae5a-cbd56a01aec8,Educational,0.42217489448748,8,30,41,416,375,68.92441868901156,8322
105ba057-b803-453a-99e3-575d86ae36a0,Residental,0.6622342344470392,45,21,692,762,70,46.05093118487259,8780
c82d978e-a9a0-49de-af82-b9cdf8c517eb,Educational,0.2689973894520946,1,5,375,837,462,54.57957793905042,7734
f7b8a922-6d48-4937-8343-7655e765ba2a,Residental,0.2142086752928316,42,41,658,1345,687,82.35105216695288,3549
4d103b0f-6c93-443e-9498-7f6c858366b2,Commercial,0.248133146036698,20,5,689,777,88,54.75790916651227,5543
b71872e8-1427-41b3-8ed1-0d073bcedf21,Educational,0.016203878896178137,13,38,462,1118,656,27.21350640493905,6884
2841174b-ff1f-4b64-b398-de3e4df1cc2d,Healthcare,0.06901163181609216,49,41,169,705,536,40.55088594935721,9235
4e24dc6b-33be-4b71-8070-0cc9ec934148,Healthcare,0.923422028406957,35,44,660,1138,478,19.849212117583654,6817
69d100e0-8d4f-4157-b654-688bb19347e6,Commercial,0.8943854880659071,23,21,119,1424,1305,25.948888706563643,5074
a0a89829-94c7-4896-8e79-f750395384ca,Educational,0.7374977573485265,6,45,289,560,271,51.12963647967713,4143
32f4c953-44fe-4ef2-9438-dd8e4f1f2e1d,Healthcare,0.06188830918808863,49,35,605,993,388,65.86443476959045,5474
ffd42fac-0e40-400a-bc12-f262b395cc3c,Educational,0.8178659826350958,50,29,547,973,426,19.77877169097136,4875
6d365fc2-c4d2-48a8-9f7a-042cd5b57e37,Commercial,0.1107645242318871,41,32,226,636,410,62.59710859161312,9290
df0e70c6-9d9c-4903-8ce2-eeb50c624051,Educational,0.6973344919106206,49,11,86,409,323,44.9913650382045,2997
164784dd-c542-4193-b9c0-ea27de5deb12,Residental,0.9972021084721457,23,12,638,697,59,22.838955894200506,5645
782f2a10-f62f-4b50-88b5-f3bf4c144227,Healthcare,0.5740245481785079,32,36,19,1238,1219,27.569519757701908,9961
773ecd4b-ebe7-460e-b227-b6dfd98fef6a,Commercial,0.3835272691032595,36,2,699,1019,320,90.77925583498138,8676
60cdf62c-0783-4848-98fc-25fe7b683a36,Commercial,0.450488522396127,20,25,131,505,374,52.430999002146024,4629
6aed90d1-a10d-40f3-8d65-947f9866250a,Healthcare,0.425401412394979,18,7,583,1004,421,79.85388656703758,8290
eccbb6e7-7dd5-4234-8fae-1de7e58935f5,Residental,0.5291099429241901,33,20,77,278,201,16.603282118298875,7417
f1072a77-bbdc-4c7c-a5eb-f335c972da95,Commercial,0.8446741418727846,43,33,451,1394,943,97.97097923414692,9512
bff9310d-1d79-4a25-8943-292add85f819,Residental,0.4308984582887486,44,45,45,702,657,14.271941438064518,6783
25b9c15d-333f-413e-abed-cca549c4c2f1,Educational,0.7275738830891715,23,41,265,741,476,98.76475673534384,7215
df819054-7dc2-4cd1-ab96-b28e71057520,Healthcare,0.8377335845844804,7,27,268,650,382,54.93464242547661,3573
a8d2a627-43f4-4693-9e9e-9271377f246d,Educational,0.007947246848558742,7,3,687,1027,340,60.111449522203074,2695
a591ca69-5a6a-40f4-b6d6-c48fd901cf1d,Residental,0.8708756202471879,31,39,111,239,128,75.71251190332752,1661
be0a9135-5a23-4f8f-a2dc-e12a1c6e83b0,Healthcare,0.3346628916130705,5,36,510,899,389,87.61493163969355,9331
8c31ab59-ea7f-46c1-8db2-e1f34df49b4b,Educational,0.493121344976136,50,39,653,1248,595,41.972723910713405,6330
31ebb19d-e2dd-4878-afc6-7402a834b93e,Educational,0.7066754542630688,5,12,698,1313,615,77.28961854207188,7627
689b7fb0-8102-495a-839f-fadfc7c270f7,Educational,0.24533269417486803,38,10,474,1230,756,95.457743293892,5276
2e71ebbe-60d5-4b9d-b6e0-ef7540430dae,Educational,0.10966643520705943,12,37,256,1161,905,57.69777471452893,7043
6e509130-7b18-48a9-99b4-d546997cadca,Commercial,0.6708112406731681,29,43,215,1420,1205,64.49435534972827,8779
cbc54c09-d197-444a-b73f-de7a8d0a47db,Healthcare,0.5023007604012798,35,13,233,990,757,80.37229711349556,9447
2cc08064-958d-48de-99f1-4eec59efc490,Commercial,0.1899325773887679,25,26,294,556,262,37.50796238783218,8813
a61a0a04-c2d7-4456-9018-2bd6d2a5718a,Educational,0.8982622912885185,11,42,379,397,18,52.371636859388026,7722
747d3505-7257-4391-933e-82430a4b77bd,Residental,0.4134439823299827,26,9,405,752,347,30.244746441529184,9424
133eaab5-2c6d-4f05-80a7-b25feed29557,Commercial,0.33008324818680945,39,16,229,667,438,32.675304746129314,3091
d03d2c88-79ab-4bfe-9ad4-08467b6670c8,Residental,0.09109529982591213,26,28,641,910,269,10.091478678395639,9584
11ebb652-7cfa-43d2-8af0-ff844571887b,Healthcare,0.8974567843911614,2,15,579,1183,604,75.62342981880406,6307
f144af80-6658-4d57-a534-242a97bcba0d,Educational,0.13444448661097463,47,10,311,623,312,31.780545035148563,7455
35d1fe92-9b9a-436c-bd06-1cdf980c92c7,Educational,0.22344311609735046,42,28,464,1296,832,45.25735811271254,9042
ee0f15de-7ad2-4dbb-8044-a2f0f4333384,Educational,0.3511625921054474,23,49,398,780,382,66.81744795669528,3162
a3ba77e5-ea63-470d-bcf9-a37606a81976,Healthcare,0.9083353902514044,38,33,613,1183,570,71.72067246606116,1997
24338f64-4dda-4f51-8f4b-31563b6be9c7,Commercial,0.7956448152093816,25,31,359,926,567,19.167262249369813,8181
6c5f4f34-c85d-444d-b68e-e17f55210e5d,Residental,0.15719974866277708,2,40,51,1293,1242,14.058340605226299,2784
56f60dd5-f952-4744-9a2a-7bd7439fda2d,Residental,0.3827881953156862,29,19,162,1326,1164,52.60153819532131,1851
3c3d9ec4-adde-48f4-8c46-1ec360f7e41a,Healthcare,0.5604613430322745,7,10,669,1226,557,11.16001792853886,1112
053e74f3-9c27-419c-9aed-24ab6ad12e4e,Commercial,0.021744591558454207,37,19,245,261,16,15.802991362513222,9035
ee3cdebc-6fea-48a3-af2b-ebf90aaff022,Healthcare,0.8644713024166797,11,46,694,727,33,24.163962198147377,9408
ae4f4a34-57b2-4359-b6ae-513db83337e9,Educational,0.8039164671712584,37,1,720,1104,384,58.74453335467374,9301
bdab9337-854c-412f-b8ec-69161da1f286,Educational,0.2482824354154891,44,30,312,1384,1072,44.289128878926654,2743
0541f263-2c45-4981-a778-fcf14e816134,Commercial,0.8937227704432978,48,11,444,1246,802,34.609593986308816,9785
e7d3a854-43f3-4539-9df3-e645c15a4f88,Healthcare,0.14782102714912004,27,11,358,1276,918,92.1053882855265,5660
7b609457-31a3-4109-9822-5680560b8a38,Commercial,0.9970712498225918,40,27,37,290,253,89.1382394064305,7289
8d3fce8f-2a3a-4558-9e99-1fbf622956b0,Educational,0.5200658337925578,41,48,45,600,555,54.25055046089142,8313
1c513043-af82-4c0f-a663-f869b0873025,Residental,0.6956095553325272,43,4,614,1215,601,66.97529894708056,5016
84456e8c-2691-4f25-802b-ae70b6b9b78d,Commercial,0.0035608769724279066,48,7,533,1435,902,22.686706450073473,5923
b9975487-14b5-4bb7-9042-6fc04cf6b32e,Healthcare,0.702906647409908,19,22,427,924,497,36.383746225555484,9780
bb23e60a-5f08-4199-ac27-b0c4a78db3a2,Commercial,0.055258038333795945,9,34,63,382,319,22.894168281551412,2749
9eb98f88-d189-4b81-b4fe-6418b032adc4,Commercial,0.039889815497118786,49,15,555,1068,513,73.72790237113307,3384
c1486a78-7bed-4296-af47-dbd9c0809086,Commercial,0.659585231402877,17,46,282,359,77,92.49959409087498,7697
bc3da40c-7aee-44da-9ece-b722bf1889fb,Healthcare,0.3142830449584423,33,13,605,784,179,97.32674348626543,7094
626d240c-96f8-4375-92b9-4e7e96c7eb2b,Healthcare,0.7395770666255944,33,25,453,1256,803,58.864103826155656,5636
a2c6a644-175d-4b5c-8c54-f1e64d18354a,Residental,0.05176759182814461,30,17,361,1115,754,12.081332166345113,4673
09ad0a68-5ccb-4983-bf30-11890c012916,Commercial,0.37072086408484617,9,25,150,1398,1248,75.24975677116225,3990
272d4af0-0735-4bf0-b495-544df4086820,Commercial,0.8071021230860957,45,35,10,910,900,81.37362334271549,5569
c87e4843-e335-4495-8b75-5c91cddf7be7,Commercial,0.8632118121342425,15,8,143,1171,1028,79.94123574490114,3413
3670a634-36c0-4aed-9b6f-39807f55cbb9,Educational,0.981245142127161,14,3,4,1410,1406,69.8311401794846,5136
5a66aa9a-5727-4b92-b186-dd7376dec591,Educational,0.9770501068775589,40,49,654,1249,595,69.47620304660549,9555
b8eea627-a86f-4fac-8bc2-8b46215ae4f7,Educational,0.20410774603982507,13,50,631,732,101,60.598340118150226,9660
63448c6f-6815-4808-97d9-0472944d8407,Residental,0.12979345618606597,26,8,310,1100,790,85.85389991011502,8512
fe9636d7-9c96-4ead-bace-7f6b593ac20a,Commercial,0.9014890723028827,41,34,695,726,31,59.58139586492696,4395
e03d03b1-0029-4a7f-a1e8-9db20121d8b8,Educational,0.6103651822530977,15,23,311,1044,733,83.41762761582784,5155
7b527343-c93e-428f-ade9-0e59620c2e14,Residental,0.8546049373696682,8,17,582,910,328,23.666591074714106,3223
268b4c1d-12af-4231-b54b-ffc4731dad16,Educational,0.8364825755214976,34,44,120,959,839,80.0559849101161,4710
d4db8881-5429-4bdd-be33-de93636e94e7,Residental,0.6367422060943405,7,7,341,867,526,10.265319072061919,7063
183a3c81-48d4-4dcb-b5ae-78ab0964ff60,Healthcare,0.2479830292404811,15,37,683,1347,664,38.70610390814177,8936
3d85bc0c-a6b8-4257-a8f5-dd7a889e2b40,Healthcare,0.7053106519383329,22,9,437,972,535,70.13641491163644,5820
aa9584e9-e567-4f6d-992f-b73c844ff24d,Residental,0.18907679269747468,16,19,312,1254,942,88.82592406370047,2666
c48966e4-239b-426a-ad80-90a646334c8c,Residental,0.14280483984390469,30,10,671,1010,339,85.42066493219488,8093
4012c203-fe80-4ba0-ae06-f020ae518f7a,Educational,0.17826037322960153,23,6,233,958,725,43.740028077619364,2401
fb6fd016-d2b0-4ba5-8193-eb2187e4373c,Healthcare,0.6440984775610327,26,16,150,166,16,81.48366080739406,4853
cc914913-c014-4b9c-b281-a175cb8cc2e0,Healthcare,0.6642966204037151,3,48,276,673,397,38.44998879767701,3415
93fecf55-6a55-4595-9457-c80c4f8e0d0f,Healthcare,0.4028760782502415,46,21,90,447,357,39.70851986223221,2576
3d4d93fb-3fb4-4b58-b200-61e11a8a1ce5,Healthcare,0.9754620019048754,5,10,169,687,518,25.230403107836644,5519
441ab4ec-b9d9-4a44-b12b-5abe23600db3,Residental,0.9834850426240865,36,13,143,429,286,96.55012337081948,8692
3171e91b-5179-4296-b29d-535e0f49d08a,Healthcare,0.8228679710987015,49,41,437,680,243,63.963154900231494,4261
b8d13126-2a26-465c-af9e-37a40a9d75c2,Residental,0.6282428796895367,37,28,569,1017,448,39.23835624092909,3497
795fe2e7-a0f8-4de7-bf09-3ac7c690de90,Educational,0.34884652119382675,38,35,708,1401,693,67.61445464731142,9107
2c976f16-440e-488f-bf47-b9f74e0115ec,Residental,0.44275249944599093,37,30,83,302,219,22.49831373915234,2700
d834b677-27b7-41bc-b1a7-c05d984ce250,Educational,0.41233706417348115,31,21,279,651,372,33.166719609696,7489
85432244-6be1-4e9a-adcd-5528d0a8cfcb,Educational,0.8803272092774906,1,1,377,957,580,51.09773282595222,8730
41bf68c9-68c8-4065-a107-aa0f22a88bf2,Commercial,0.9297133715570328,14,21,412,927,515,36.18542711577358,3932
b5956ab9-0a21-4ce7-9819-d895c633241e,Educational,0.2685298009577962,41,30,286,1042,756,96.39074687408109,6588
34263702-299b-4ae0-8503-5657867eba34,Residental,0.5485002303156266,9,22,620,1104,484,52.99342016904779,9273
0cff7abd-5242-4505-a71f-ca55962eb335,Healthcare,0.6139390678341565,47,44,172,748,576,15.874285733672595,5849
b50a9ebe-f601-43b4-9f71-21948a347a55,Educational,0.8457822175148171,11,22,328,1331,1003,23.892781847349056,7550
ebf08ab1-053c-4d59-97ff-63d922bf695c,Healthcare,0.27638867292071645,15,48,601,829,228,93.3962476956233,7181
4f0eea86-7ed9-4f62-b029-200f3724036c,Healthcare,0.5373420504714703,44,22,95,1014,919,84.84174570130708,8958
d7e6d0d5-b2c4-41f4-8637-98a3d1f5d686,Residental,0.35937034352526676,50,47,248,1175,927,68.84310407630294,2101
f3fe64d9-58d9-48e8-bb93-1ad14ee984c0,Residental,0.8859451576591926,13,28,42,1181,1139,57.16760911791834,8056
394adfdf-d0d9-4e0c-a942-a67d1cad3b9f,Educational,0.6664809340757116,7,29,646,878,232,26.527596304250174,6019
190572f8-3732-4435-8939-7df2aeeb3c4b,Healthcare,0.5068238013169404,26,32,122,1357,1235,11.80344580345968,1154
84720b32-421c-4e95-81a7-3536f28da4af,Commercial,0.5671704210565416,2,12,632,969,337,19.868313562291092,1169
7ffb3d82-7100-4fd0-bfcb-9ff53daccd47,Educational,0.6228617638667744,14,41,449,462,13,95.8729489607149,6417
09f75bac-bf2c-4b5b-9e5e-b851b731948b,Healthcare,0.03020679122758818,40,23,483,1344,861,59.1208104234455,5177
7e24f689-8ecc-44e1-90df-d418d9c5b8d5,Educational,0.05949576080051888,28,31,520,1439,919,58.42279547759321,9246
a13aa683-3c36-4085-af81-7e757daf6db9,Commercial,0.5909675847829328,42,47,326,422,96,67.8239978865575,1899
ccd1e79e-d002-4884-a79f-ac50e9a2d631,Residental,0.5858288683069836,46,36,285,1067,782,80.65437121168662,4426
c6220125-cbf0-470d-9f65-f6647f1caf00,Residental,0.5212755499049486,11,25,38,866,828,91.97283614356841,9750
9b900b0c-9971-4a5c-9e64-d5cc90bf3ab8,Healthcare,0.0006159717231515316,48,39,492,921,429,27.33717287318239,5863
01797b62-652c-4588-843a-1cc0ce94d412,Residental,0.4296444042444362,50,21,675,1103,428,34.782440733427364,2918
2fc28d75-8d6a-405d-9be5-fd4fae182680,Commercial,0.5993881629030006,39,49,594,1120,526,81.03191543595307,8347
7483ee47-4b7d-45df-85ed-888f9167e65a,Commercial,0.785705353927652,15,37,108,351,243,55.86684814294785,7629
4b99365f-9d93-4c22-9087-ddff8e2ffa28,Healthcare,0.9431503587295846,38,15,128,624,496,55.6819002383999,9531
124e338a-d1db-431c-b381-2cb1ae35bb09,Educational,0.47130578329788164,28,1,577,593,16,37.15130363761927,5797
480c3316-e99f-4855-bd44-888e0e12e948,Healthcare,0.12112554333460968,33,47,352,1335,983,19.460997119895943,3811
d97844df-c87b-43bb-8741-83a12330864d,Commercial,0.7291356313029342,8,41,673,718,45,47.610558644024024,9252
3b198595-ac7c-4262-9c02-a004db6f4a78,Educational,0.7437948281331934,27,18,486,1362,876,93.34114660331247,6374
a4b79821-fe81-4af9-9f8e-bed207a1fcfa,Commercial,0.5484547220259198,49,50,573,990,417,69.32465999246497,5898
82e49ca7-8552-4bef-80fd-9332ee844613,Educational,0.9016569030172162,25,18,273,1316,1043,28.568620256307124,8760
6c6d5fe5-ac9f-4f59-a508-333c2b8ca99e,Residental,0.6444217244549901,22,47,659,952,293,57.211299378373695,9562
770060c3-55d2-4d26-943c-df29b3a42f23,Educational,0.5578480725786706,31,46,614,1059,445,56.66556876792763,8185
4918fa56-b27f-4b39-a853-dda2e0da9bd9,Commercial,0.8301922618876278,13,14,685,1181,496,80.88320442383174,4005
bf0871fe-7b6d-453f-ac5e-ac09203f28d4,Residental,0.9675181612584939,24,44,152,1322,1170,66.36189717736022,7414
830e2ca6-607a-4db8-a3e9-68daa4f08065,Residental,0.30807671010302107,12,26,633,935,302,89.50214071955364,9975
0bf444ed-58c7-4348-bfcf-297441c6f62c,Commercial,0.9310597609316309,41,28,380,1069,689,54.221978183898564,7172
d374b833-0562-4e2a-9c36-8d713b99587b,Commercial,0.9564964733741197,29,5,254,766,512,83.92013247293707,5803
eef35de2-336b-47d3-9f96-2b26d9e541f4,Educational,0.3751203190836191,43,40,145,376,231,37.30787880154461,3742
6d9237ff-6a78-4282-9bcb-7581978778f7,Healthcare,0.9376293640173005,38,45,616,1379,763,60.985184752968166,1214
37f9f5f9-b601-481a-a0fa-b3f05c744325,Residental,0.3417352131615867,13,34,131,544,413,63.074003649495914,1095
5adf4256-2215-443d-aa7a-1bb83770be5a,Educational,0.8734298236666205,23,27,18,810,792,93.99744771426231,4768
ea9495ee-e096-4635-a9a2-82567ef7d741,Residental,0.8898968950325236,29,23,397,808,411,94.86694734552681,8030
407e6a0f-a933-4089-924a-1941803764d0,Educational,0.6436483489210059,17,24,546,1295,749,62.75870996636147,8225
c212fba8-afcc-46c4-9eeb-ad3e5bac725a,Residental,0.17169538222970016,39,25,299,1005,706,68.75163645714156,7752
32df26f1-4c99-4b93-8261-b702f55b2ca2,Residental,0.43829621492086246,50,30,378,1097,719,47.09514326663874,6244
d57e7678-3108-4d8d-ba57-d3b5ce435ed4,Commercial,0.411868283103089,49,43,66,906,840,36.586395699375394,2092
7466c700-d4af-4d52-b541-76e7d320e7c6,Educational,0.6922185867449046,37,41,393,688,295,31.658049828427682,3529
1abf3cfa-9298-4ffc-8f65-9e928e5e1734,Residental,0.2883943697486634,19,28,436,621,185,89.77933375884545,8547
8b0e02f1-b93b-4c24-bf70-4f735dca1657,Residental,0.5588032271824751,17,48,460,1176,716,13.70316427048751,3589
931d5964-ce5a-42d4-bdaa-15015dadf592,Residental,0.8101673448967108,14,12,488,971,483,62.57953177586706,8180
4cf4fd09-ee71-4efd-b3d4-138de7b5e78e,Healthcare,0.10486038006075715,49,28,436,882,446,24.11428664415428,5104
3e249b95-b80b-4cc4-80b7-56f77125c7a7,Residental,0.978143099628095,23,36,501,1183,682,54.6416904239002,3203
179787ff-24f5-4836-a66d-4842f8e9b933,Commercial,0.2801354846642691,23,8,569,875,306,58.232380674586395,7919
fb341aa8-36c2-4490-b8f2-6e251ea8c78e,Residental,0.2217650542220383,38,46,459,813,354,85.55482326166664,9882
19fed1b3-5780-47a7-bf09-f166df1f59f1,Healthcare,0.1167964524949201,24,43,245,340,95,42.90924538773536,2953
b4c9dceb-4e20-4ed6-a1eb-92c20db03dc3,Healthcare,0.022231025758566725,31,47,175,364,189,63.373138093993276,8064
e06df6d8-bf49-4083-acdf-2444155b566d,Educational,0.49528772035488167,46,18,575,1344,769,36.96265327376419,6619
d550355a-6267-49b4-a113-5748e5aa7965,Educational,0.4309765278342321,44,2,169,1437,1268,24.25898520345723,6136
79965c4b-bfc9-43e8-996e-01c00f1bf447,Commercial,0.5280165883835266,14,34,666,708,42,58.84946829795633,5119
b410c814-5892-4847-ba44-d422209f60cd,Educational,0.9475642107473535,11,11,217,1391,1174,42.35666797896543,6808
72eddd93-ce6c-426a-97fe-aa857357af1f,Residental,0.4626488257852619,14,16,441,783,342,73.93007144522551,6078
bd1468d3-5088-4780-a5f2-0e2052bd4af2,Residental,0.28279220153613993,48,25,702,872,170,95.24029302120563,8384
89c81080-c896-4d80-bd5d-eff997495660,Commercial,0.12455912724805329,50,9,471,998,527,90.35795351395949,7485
ac93ae08-1171-4f6b-a8d2-6909c1ca4a4f,Commercial,0.0988044659175833,48,46,233,1027,794,84.97433197717606,7261
a5b36ea3-5b8c-4326-a61d-4e834cddd52c,Educational,0.12701505442287198,44,21,705,1068,363,39.00636062661816,1815
c4fdf999-74ce-4459-afe4-4965d60a3d06,Educational,0.19218265082329022,41,27,115,724,609,85.08328233788309,4541
0721633e-1462-4ca2-955d-900cd44f292f,Commercial,0.1450463674653606,35,48,118,1132,1014,95.26038397591684,2574
150f6ec5-1493-47f1-908b-ab1e97abe032,Residental,0.6177993067990438,23,24,549,1266,717,30.486839817202625,2313
4bf46b37-909c-4314-9b67-c1f54ca4661d,Commercial,0.08416392360880942,3,49,452,1424,972,66.99593203386115,4623
2cce9329-208c-480a-accd-010045e7bbb9,Healthcare,0.3779094498474118,19,17,493,1268,775,67.72592163156065,3285
9afaeb5d-bec4-4e47-879a-6cdb5aa28d81,Residental,0.7197623387237547,3,11,530,757,227,23.34175225885225,2573
4595894d-1c2c-4505-8403-3054e8f8ca41,Educational,0.4486950519289745,5,4,634,1193,559,61.897886208846096,7049
6d553522-3b88-4e5e-9a0c-3f14fb463bb3,Educational,0.6584470167976554,18,27,706,912,206,74.92616297949303,8909
547b227d-7b51-44c6-8829-9cdb48ce1774,Healthcare,0.21932564885688322,2,10,253,1380,1127,27.913212035105747,5247
8e8746ad-a55c-452b-9bab-8dd4545ab2b3,Healthcare,0.16028904492418428,19,32,48,830,782,75.470444177702,5630
9108785d-ca5e-45db-b1d4-f4ad27384852,Residental,0.4839843955223878,19,23,309,1116,807,12.57116027074681,4160
6c5bb30a-9570-4928-a98b-0b655c825db1,Commercial,0.7837941471695166,12,49,350,1072,722,17.718131224719233,3338
62c3e387-73a9-4a50-a0c1-ae93065417d8,Educational,0.4114067399728487,4,40,248,830,582,27.447504979349794,3746
1819ea27-7266-478b-a793-c20b76813749,Healthcare,0.3602874626938296,1,26,490,1208,718,11.27090627493909,8447
6a0c497f-d29a-4196-bebd-fa087fd2a113,Healthcare,0.5707573930981183,11,36,212,441,229,63.71301066355694,8432
f4448bf9-eff8-4583-b8f4-03f18e8bf6fd,Healthcare,0.719978408396979,30,18,80,183,103,37.74973915004133,6524
a1d32e5c-3350-4f11-ac74-4ad44e6a3ec1,Residental,0.7014913884333173,2,34,154,923,769,34.17480448454583,1133
4e47550e-391d-4534-86cf-692a65fd5a86,Healthcare,0.9732198553698002,12,9,390,1331,941,71.62399776062857,7006
409840da-dd97-410e-9c7e-4013f8a50fdd,Commercial,0.4737818835184455,12,38,55,1380,1325,20.102275843638814,1667
14944e59-115d-441a-a0ea-63cbc6addd43,Commercial,0.1328347178466892,24,22,130,451,321,78.596161542873,9178
ec93659a-feae-44a6-8f2f-004662715b5e,Educational,0.2979471956851285,9,2,22,34,12,68.06382018346552,2662
f3e3a82e-e062-4f25-8a7f-4ea96014207c,Educational,0.892804009715731,35,23,632,1014,382,74.22199629006627,9985
c944d3de-803c-4b55-a317-04be73f08cf6,Commercial,0.8008946139849766,22,7,34,291,257,72.94575768295438,2846
2004d020-af34-493b-a069-e159ec375f33,Educational,0.30090593070701466,20,19,79,308,229,75.62284711665455,6136
e8a5fb21-cabf-4cd4-b8df-bbe7b9c8fa40,Residental,0.9073827308041487,17,41,675,1274,599,58.32795981494552,9859
52f0205a-10a7-49f2-bc92-19e0845baec5,Educational,0.33912887283022086,34,38,660,937,277,65.44140501719409,2393
a71f8b43-d41a-4625-ac96-fc8682def459,Residental,0.28635524955691916,40,48,632,1340,708,76.22496485835899,8306
112986a2-3b40-4434-8f23-7c3c1016c788,Educational,0.008929877108091677,29,29,355,1363,1008,67.71454117481713,6984
3061aa51-95c7-42eb-8df8-a90923b9d938,Educational,0.6018738330472633,34,24,405,724,319,47.372537213776404,6812
4211bbb1-6b56-407c-bb72-9a2a16222272,Residental,0.13476498380127033,19,27,100,611,511,51.44885951891386,2085
ae5293b6-5b38-4167-a5bb-b9f309e3fbbe,Educational,0.528564777796107,11,15,334,1348,1014,71.73837695896437,9508
34117d55-d6f5-45c9-ac9e-7f26386370e2,Healthcare,0.685961957967827,12,42,266,286,20,55.12939693070595,6353
637154cd-601a-4a60-b1f3-f7d9a22eb596,Healthcare,0.5001920380567825,38,44,445,924,479,63.88701690778463,8833
cb913835-263e-4d9a-95b1-cdd683438da3,Educational,0.5117700656349496,48,15,702,862,160,43.39747331067209,8097
d7539e5f-3730-4ab9-b7b7-3803b146d97f,Residental,0.2731647149202585,29,27,601,1321,720,97.51230004086106,9924
9bd175da-a8c2-42f7-b07a-2fe3e8ebc53b,Healthcare,0.15418768910418235,6,26,312,833,521,18.166205495397406,5477
a286b5ff-aa63-4d3f-b50a-8608bb8a5cef,Healthcare,0.8465338356137262,28,32,651,1345,694,65.41783094812237,8478
f7597c92-2c48-488b-8dd4-9cdcfe80640a,Commercial,0.14057604212391717,26,23,394,501,107,23.96566938661765,9974
2ea67ead-713d-4f9e-8fd5-b329a437ca9b,Healthcare,0.9423021507970979,10,27,516,686,170,52.52731966048889,3268
72063d9d-526e-40a7-a845-e17f35726417,Commercial,0.6461977567614124,35,13,7,14,7,65.05793864914389,4384
368a7ce1-076e-4623-a365-68b26594d27a,Residental,0.6639656509832121,9,2,604,1248,644,45.63886594369455,7910
375809c7-1611-442f-ae22-490b14e193c0,Healthcare,0.9081061982313299,13,14,357,360,3,11.131705515662926,6760
6349a0f3-b54a-4898-ae8b-6a70363347b5,Commercial,0.4627522714189196,37,43,320,1173,853,45.317910202236945,7476
2c724c75-b16e-487b-accc-fc8314935b3a,Healthcare,0.13148598458034955,25,26,598,765,167,57.81799837746732,3565
95094b20-c8ec-45e7-8a47-39e44c5d9c3a,Educational,0.03458374856442015,47,9,100,1052,952,11.015624656890479,8545
2c7b7dab-3c44-4af6-8038-2b0104c1060d,Educational,0.6649948279655469,40,12,387,1121,734,90.59115315567004,3271
6ad9f12a-d3f8-4947-b7cc-8bce4c81ee87,Healthcare,0.8986927479867263,50,20,229,368,139,50.89841216926891,2552
c0f7fd8b-78cb-42c0-9660-f67d98432743,Educational,0.028472172628054015,8,43,272,364,92,56.53767563629114,6923
fae7316b-66ad-4900-ab13-4f75c241fe3e,Commercial,0.30161005775025207,23,44,1,982,981,91.87663237702692,5901
253a8342-d469-4ab0-a6d7-966afa54d8b2,Educational,0.17891285837463744,50,43,86,726,640,23.49683898233363,6898
ef1b2814-ee2b-4f56-83f1-4a61568cfc96,Healthcare,0.7602008228154438,15,42,130,161,31,61.65756894060123,7442
3991e7fb-391a-409d-8d12-9f2161436b2c,Commercial,0.7876929580220953,47,34,84,276,192,65.02090610247951,8806
085937ac-fbbc-4b21-9c4c-c80b5da38a16,Educational,0.3580413337743342,41,28,27,477,450,67.44769203590228,6573
39543ff3-11ad-4870-a473-94e27fc8d9c5,Residental,0.5309468963348534,19,15,233,500,267,45.92344823372606,1734
7d277857-4b72-482e-b3b9-c72f3806fb83,Residental,0.24605658825029986,37,47,455,1305,850,46.68303427804044,6938
9e3ae209-b3ec-493f-8430-952ff97a330c,Commercial,0.6088635004596009,27,10,177,1341,1164,41.23348970754466,9131
1e63561f-8c98-4df7-8e5f-0ca69944c72e,Healthcare,0.2651996789414294,11,18,532,1320,788,30.42655301924239,2702
2fe018df-aad7-43bb-b33e-758300d9ff03,Healthcare,0.40500812490904947,27,35,607,1388,781,16.4840649584123,3108
3097da94-94cb-4095-8243-4db131e464a6,Commercial,0.1563560647741301,50,50,360,1065,705,17.71685596011247,9537
6ff5d8cf-566c-4e5e-92db-cb8415a116dc,Residental,0.8921770781229669,11,47,115,1249,1134,12.42847067169087,6555
6f2727c5-1acd-4511-936b-0f9596d13ad5,Commercial,0.16084536305245234,16,40,270,491,221,84.86227104169743,2911
25d939b1-4d0b-45f8-97dc-8020e75167c6,Commercial,0.2746988946422122,13,48,674,1163,489,65.54029744478322,1978
ef25b6b0-29f5-4f89-b70a-a52b92f2c523,Educational,0.8989115422871737,2,7,611,1200,589,30.108088155768012,8906
c465866d-149b-41c7-a479-11e3415d1c8d,Residental,0.8675690058853976,20,32,175,1325,1150,11.175329130360899,2668
85104211-712b-4ec9-b7b2-e937b9ba332c,Residental,0.13330592965452537,50,42,562,784,222,76.50248196139681,7576
12efd590-62f9-4ec7-9430-a535d6a60ad8,Residental,0.1301093112646834,42,37,683,833,150,68.14887141708545,9244
cf0570bc-c70c-4f7a-a69c-9da5d21c0225,Educational,0.37486106890710835,26,50,144,648,504,95.9754921643167,6951
855bfee1-648a-414a-85b4-7d6cfa59cc99,Educational,0.3060932832390292,43,31,384,848,464,16.93864544343215,9107
c8211f93-d26d-4022-96aa-419e36372624,Healthcare,0.6439159748283311,15,13,348,647,299,36.55557911799308,6728
ef9c7102-2b58-4f02-8879-95fe79715960,Healthcare,0.8842324194602222,49,30,27,920,893,84.06405277436436,9896
50b7834e-2991-4b50-9741-9c59efe31887,Residental,0.38458260441101255,15,9,590,1156,566,59.54869740984698,9308
93c8481e-460d-48e1-a371-2bcfaa5926e8,Healthcare,0.3842708244280093,46,41,426,1338,912,79.26668565505108,8523
8ba6bee5-7225-45ec-9535-b8749023384f,Healthcare,0.6555185759293622,50,23,144,916,772,17.288762688802954,5101
8bac5f21-5575-49d5-b459-60196425f603,Residental,0.8324741055746779,35,50,531,790,259,48.56699926694377,5442
506587ad-843d-4c90-b640-9a6ba56a9701,Healthcare,0.5425481464266564,32,31,106,547,441,65.75524938308885,3957
fd2437bd-9fa9-4018-9944-87d3b7023eaa,Healthcare,0.6581098678253811,5,36,595,1166,571,70.43713837502412,9889
55a9da13-0563-46dd-b7ff-3c33b0ae86ee,Residental,0.37949820302177095,27,38,167,221,54,25.53418251967907,4449
a952a92e-86a4-44e4-a7e8-156f6eda2307,Residental,0.6300797395896561,13,38,403,1192,789,58.329703153759766,4676
1a8c8d13-21ec-441d-9fa0-655870d923a4,Commercial,0.764688482566157,36,7,238,1376,1138,47.862566043981175,8573
405be02f-5e5e-4685-a622-fc577130c9bf,Commercial,0.4590599871194718,40,2,18,834,816,36.79382911985391,1039
d088272f-8753-4b48-9d33-72c454b20620,Residental,0.07734833521333162,36,19,624,696,72,16.819374410758037,3594
dc279cca-4afb-4c7d-8294-ed3702ec5333,Educational,0.43135324726147406,39,45,460,1047,587,29.34635502604605,8735
9b6d70dc-e58a-4bba-a036-3800b7918e68,Commercial,0.38618265490554315,45,40,712,1016,304,68.37097748580464,7150
2632f22f-3543-4f1e-9011-cf5894e6425c,Residental,0.6831559567001587,22,43,365,923,558,66.37238433376497,5805
9bd97c63-e805-4627-ac66-51b29cb4a57a,Educational,0.6749977741522433,44,46,353,883,530,46.36224220625465,5481
16cc6187-16b7-4ea3-b632-542e7e386b77,Healthcare,0.5930904122805974,47,1,692,778,86,33.41967601437348,5668
79bd65f2-d9fb-4841-ae92-0f1a9c0ee5ed,Commercial,0.8757011310216587,16,44,350,1077,727,19.24025668444441,9783
a5ef1665-a75f-41f4-8a39-ae897f3e1d15,Commercial,0.08897635923266767,17,20,585,866,281,18.350220911772453,1703
701eff83-5c89-4640-b878-230145fefbed,Healthcare,0.569437740963599,28,33,260,1007,747,40.89781727245245,2244
e7ab9527-81d1-4a44-81a3-4a0e26e33bac,Healthcare,0.5833686413077956,31,33,36,1432,1396,72.16127382808787,2305
e67be789-0d23-4a31-8e53-50e7540d5b73,Residental,0.7402904597112813,20,9,104,310,206,38.01754334594489,3265
2db7acb4-9645-4a8e-963a-419453483726,Educational,0.7716463776601004,10,42,203,589,386,84.17793366500779,9986
1fa952fc-d26c-4f74-8a94-f0654722908a,Residental,0.44973011640238725,18,48,196,1274,1078,39.31577442623668,2699
b0eb2620-be32-495e-8b4a-629134f4c6c2,Commercial,0.8407968642413789,39,11,465,971,506,53.17880323085547,6758
0501d6e5-ae26-44c1-a40b-52db44961a20,Commercial,0.2680464082590057,12,48,94,1165,1071,11.502938841646763,4910
d80cc447-bb8d-4bce-bac3-70c63bc360d8,Educational,0.8214624107268094,16,9,292,1253,961,58.03833384608652,6830
6a46cc65-6937-42f3-ac7f-b8652745bd48,Commercial,0.546601378682766,21,43,43,1247,1204,94.93801401909069,5296
98e87a1c-d355-425a-adc8-ac76e9b00a7d,Healthcare,0.15698499564118318,5,3,129,218,89,45.04284058354375,5391
61c40692-3b39-4c84-9971-59ec30a50a4c,Commercial,0.8686647000823052,31,6,61,731,670,73.07182502075986,8458
9bae410a-56ab-4aac-9f7e-91a42f1f32aa,Commercial,0.2574056453626229,5,22,154,1093,939,89.44053622892818,3851
6c62813d-73d3-4a70-9d62-be6a0150a002,Healthcare,0.5571637533671951,32,19,409,509,100,12.034750902464175,5056
f8c1b95d-5683-4fdc-a024-8d11846a7b7b,Educational,0.9764155620288161,15,8,111,1081,970,87.42530428567032,8709
44da2d85-bb86-4fa0-998f-bb92d68d153c,Healthcare,0.3465240173365768,16,11,274,276,2,10.591457091146978,8720
e1f900ce-f16e-448b-adc7-813b58bf62fc,Commercial,0.9439705573365331,36,39,237,721,484,60.99843881771604,7122
cb84d944-c988-4eda-ba8a-2bf4c808f32d,Commercial,0.7854107954733971,24,44,445,1220,775,99.71535021298192,7254
d743d6b8-8002-48df-b5c3-5b363f27b77b,Educational,0.09036342949668053,13,1,128,336,208,60.054017010514556,2577
a4b635ed-7c13-4063-827b-11b6f34a2a2f,Educational,0.07856031222646787,8,13,416,1260,844,86.40176197158922,1565
ae116c04-a6e9-4cb3-a5e4-4f09ae61a1ba,Healthcare,0.2884168876854668,18,12,100,1053,953,79.6450690185003,6520
bfac0d59-4fd9-4aa8-8632-47561a22a31e,Healthcare,0.3208681699492505,40,20,47,483,436,54.33642034557694,2195
21a5a93a-02a0-4a78-b050-62d7fbf0eab1,Commercial,0.7047776526804141,39,50,641,1084,443,59.672559688951374,2246
140652a6-02eb-4e7d-8ffc-125b78449aeb,Educational,0.8597338424201849,11,5,23,283,260,89.60595260273638,1994
909830c8-9996-4a12-9b76-3cb96ce83329,Educational,0.8225991722314596,8,50,184,651,467,31.34451087003168,9505
895c9d1b-2421-45cb-87ba-45ba6d4a1a76,Commercial,0.23984649397131508,43,35,277,1108,831,60.14852233317441,1321
db9ff522-a564-4144-9513-a2b9802a7f09,Commercial,0.9165626171738772,12,46,71,869,798,70.15817927740645,9111
482c91dd-64e7-4e01-8a36-a6382126bacd,Healthcare,0.35845163351124587,19,5,577,1296,719,79.23421064035546,6882
0f47db71-2eed-4fc0-9484-af921ce8b325,Residental,0.2612221551544939,5,30,320,624,304,15.443425350441036,2452
fb0de917-5648-41a8-ae4a-ebef73c30eea,Residental,0.5364075359564616,39,25,503,1386,883,70.9051798737946,5260
2c248320-9c8d-42f5-ab6e-a8a2587a044c,Healthcare,0.11200974497081184,45,24,562,961,399,86.95331339810012,8438
b4aaa2f8-31fd-407b-8932-54064351bf2d,Residental,0.7874322279806556,46,23,165,276,111,62.832686148785946,3566
fb46bec1-dd4a-418c-a650-c97e4835e09f,Healthcare,0.2545494258752963,48,9,292,791,499,64.45588073284785,1745
a606d797-1dbe-4843-8e72-8d8db537f472,Commercial,0.6047034545766824,11,42,399,1102,703,70.29009336990472,9492
0a2b4a9c-e11a-4547-a255-055e5903b70e,Educational,0.6518054174905437,36,11,84,1103,1019,38.72884783307609,8923
d0ea7ab4-b4bb-45dd-9dad-b6d4e8729c8e,Educational,0.2089394074643216,14,24,562,1299,737,78.80173921555235,1294
a000a483-bc4d-4a3f-9510-f8595160d07f,Educational,0.6514032255949684,39,8,394,936,542,22.29477701394874,8111
5ebb6681-f607-4eb1-82da-d20af6f7322e,Commercial,0.31242597380470727,22,30,342,960,618,38.13904063602783,8105
7d6797fd-774f-4aef-b940-c85dd7dfdd52,Commercial,0.06252557761902311,1,22,361,724,363,54.28030729869614,4830
36837a03-483c-4b5b-9281-75cf080966f9,Residental,0.017309597216901174,39,12,332,338,6,32.784565323122855,9890
f66381cb-c4a3-4d66-8bda-feefaa23b8ce,Residental,0.4673211051275282,28,48,508,919,411,34.941873226921075,5926
bccd5457-e316-4ba0-8e8b-96a5001625c1,Educational,0.7988577855879877,38,42,102,1209,1107,30.49634297324967,9411
827fa48d-e176-4759-b319-2c9d285eaf39,Healthcare,0.055975920193798934,13,35,144,1360,1216,31.848673245546006,9579
81af7ef5-e074-4e35-a3a6-c5cfe4cc02a5,Healthcare,0.5959885377877187,1,19,676,1192,516,27.284878800155777,6422
cccc2c17-74bb-4345-ac86-56e8c84d274a,Educational,0.4905912878227632,33,47,330,1293,963,52.30474412968732,9385
380f26b0-e697-41d4-a5cf-94c63975805e,Residental,0.2502916367224406,24,41,393,1207,814,40.7110123564546,8854
6e6b4b79-16aa-4b83-b812-05f53c522a4d,Residental,0.39709017604226826,43,47,561,1288,727,71.01134557245908,9857
8f751d07-8656-4751-81f6-7a366154bf1f,Educational,0.18627044587388286,12,39,470,1420,950,86.94442603783108,2213
d6204424-bae0-4484-8a46-91b277d70cce,Healthcare,0.6252914035519449,23,41,154,366,212,29.456894402986144,6895
bb80d20a-5524-43aa-a3c7-2240932fa08b,Commercial,0.7287583259890112,16,13,29,600,571,45.097901395572265,2223
f750cc30-71d5-4253-a0c0-4d84c1a0647a,Healthcare,0.9633652291842404,36,26,476,1375,899,72.47695928963569,8590
03400121-33b8-4650-b3c7-7b83bdaf82c7,Residental,0.8220501097280484,31,12,659,1380,721,25.063448851016304,2313
5669bb00-81e0-46ed-bbee-f32f26349f61,Educational,0.8852154586709331,6,19,136,438,302,35.17144276871995,5696
5a8e4c35-7d4b-4ba7-967c-3249901fc471,Educational,0.5521509886272461,44,35,365,445,80,38.542767049833586,8916
94667cff-e453-4b75-93fe-301c7203e9ec,Educational,0.7986052792846705,37,28,282,1385,1103,17.679192256683223,4032
ef55f20e-f4a5-456f-801f-af31109e8583,Commercial,0.1675251618195145,18,47,25,1371,1346,93.26534378564112,6718
2e39d629-b6ee-436a-91af-375d25521982,Commercial,0.655855537558758,46,12,418,1311,893,34.012276295457546,9759
c611f3e5-69e7-46a3-bdfa-6c7fa8d1fab3,Educational,0.1584957115841249,17,1,446,1064,618,82.55438742890695,5386
eaf9db43-9d86-489b-b3a5-5059e8e4c031,Educational,0.9956647356483556,30,12,367,840,473,72.47413128136822,4481
e719ddec-1acb-49af-97b7-cc33f942a0ee,Residental,0.14641956581210336,20,26,679,1375,696,76.89284408913147,4489
40ad9d0a-675d-4380-b96d-8db85a6f9797,Residental,0.9889869085513263,1,43,717,1009,292,27.075115653324467,6247
4ba0a478-f9e2-4c2f-8660-5099b4b0500b,Healthcare,0.6971763330884038,24,46,404,1010,606,69.64638843498847,6278
ef12bb8f-a91b-4ec6-ad0f-d5daf678eee9,Residental,0.561550505729148,13,10,604,700,96,36.430923877220245,9425
5d1abef0-c344-47e2-b4d5-181559952f4d,Healthcare,0.5662105071376029,34,25,379,1121,742,82.54245797530832,3527
e72ae2ff-9b16-424c-85d7-7e6330287007,Residental,0.7905874732074102,23,25,150,1293,1143,67.74638456695976,5025
016ec471-d74a-40ca-8772-a41159075265,Healthcare,0.8077052869101008,32,26,229,609,380,57.70106783345263,7457
db78a2c3-8b93-4ed8-a8a0-d87ccc9fb4b6,Residental,0.8090446364904953,34,29,73,949,876,44.69604814600623,3628
3eb87de1-2df2-4ea9-a132-0488858c8bfc,Commercial,0.5903572472226798,12,44,42,347,305,12.092352765216274,3129
6c0e2b7c-20f6-42a2-9387-bd57d3a32d07,Residental,0.631414660942731,33,16,598,956,358,15.259574702855456,1706
fa50d847-a126-480b-91cc-1e7d8b5945fb,Commercial,0.9159388216637202,35,25,288,1281,993,63.04631853848461,1981
d2137de0-7d1c-48e2-9507-ba88ee8db3ee,Educational,0.5307524192393756,37,32,161,530,369,86.1503991655878,8352
9952a97c-e4a2-4fab-952c-2471073a92b3,Educational,0.3237223467872602,15,14,331,950,619,16.80944283321454,6041
94cb2ca4-f998-467b-8ce1-376f00965673,Residental,0.5151802226710438,35,17,34,1296,1262,58.18291707024852,8952
d0308bc0-dfb4-4810-9bdb-8e30bd4c2e59,Educational,0.95708854673496,48,17,462,1338,876,24.18902453180294,5659
75d1b9ed-d2d8-40d6-a8f3-c3162dd84400,Commercial,0.6531702548178434,50,48,105,753,648,27.729408679209563,3494
13933c9f-1bf7-432f-a268-4acaa22df890,Residental,0.645052138287126,16,30,11,629,618,94.92341489857365,7663
72a75d1c-ab1c-4586-ac10-05211f8e5a82,Healthcare,0.7712696506614097,11,45,669,1335,666,76.30254343772408,5087
8d7eee4b-c65a-48b9-a4e5-50d4dd12caf2,Commercial,0.44258804537920526,20,41,273,788,515,72.90692037993708,4239
ffb194c7-e7ed-45f6-a965-64dca9fa6dfd,Educational,0.13960984520190034,34,43,110,1220,1110,35.19916039181865,7075
3051e8df-f2cb-487c-9463-8654a8ea17d1,Commercial,0.5642453344764049,9,40,530,1079,549,45.603173244783065,9945
1d318868-5b96-42c8-9b01-a47a9930d079,Residental,0.8041770463225412,37,44,11,677,666,49.835146761363056,6061
45c05364-6475-4ce2-98b7-a49ea2688539,Residental,0.49610790837698393,17,40,695,1065,370,45.94318773297457,4299
1dc28ca4-5c3c-4c84-a9c1-4ffce0a6580c,Healthcare,0.19423962425640362,49,22,215,241,26,90.35446292158069,6149
f99e4552-4194-4b90-95d9-03c41a16b926,Educational,0.39242092293437847,19,2,537,847,310,64.82902145819928,7160
29c0e3e7-9247-4785-b561-d62b7c65218f,Commercial,0.5479564377554978,45,49,252,765,513,85.73950322611127,2310
306ba354-abf1-4b3a-a2cb-cd26387513ab,Educational,0.22791273732296824,39,16,204,1187,983,83.11233303174532,3258
76658326-1a69-4b86-a68f-4c00897c1882,Healthcare,0.567940938518606,36,10,96,590,494,91.71239920787637,9746
5a20d4bd-514f-4870-9c9b-03518fd3a956,Healthcare,0.023522954025189113,41,35,74,1282,1208,57.29800331647539,8664
2ba218d5-64c8-4d01-85ba-4d4a7a4b5b01,Commercial,0.36696157157236586,30,15,144,342,198,61.09936708271233,1790
efa834f2-5ecd-45cd-a382-fe9387c6543f,Healthcare,0.8222596698870892,2,7,350,938,588,16.958990855004426,2419
f3ba0c50-1fc4-4e09-8061-391eae1e22ba,Commercial,0.8221440832212928,25,38,624,1072,448,86.59619246108915,2700
f417a097-7035-4ca3-8c13-88118e35580e,Residental,0.34800810403595317,25,49,205,337,132,91.89133833494199,2855
71b06fb3-4c76-4fc6-a6e4-ef3a0a4fd983,Healthcare,0.7547497148904729,7,5,101,179,78,10.188917390730115,3170
d7f3b022-b690-407e-b57b-5b6c84631e6d,Commercial,0.26595917920053236,45,25,1,470,469,20.729372535216548,6116
ecb45e6b-62db-494e-9d89-8cc3c8468457,Educational,0.019455687235712227,5,11,330,749,419,59.19597555598391,1414
03a00f17-1f79-465c-b185-2e94448af255,Residental,0.8221300151096147,42,6,152,835,683,80.46625916879779,8829
a8284132-8b76-437b-9a60-b02832f52624,Educational,0.9126608923040888,15,25,656,917,261,53.400373363303764,2948
da8937e3-a22c-4217-a8de-3c9b4ba1a642,Commercial,0.16272480587742966,50,12,593,762,169,98.94243452854143,9970
2683b85f-3945-4aac-ac6b-c91109a1fb43,Commercial,0.45968517323047575,15,21,414,984,570,13.82388991645809,1842
143746cc-9c20-435c-9a88-e0b4f48d5daf,Commercial,0.2760571289351894,15,49,1,1114,1113,10.123216853138862,6824
4ad7c8f3-0f03-4315-999d-c5eb15978086,Healthcare,0.5723423445275485,26,31,472,824,352,17.155621582870324,7485
8ce89891-3f06-49cf-93dd-855b9ec0e0cb,Residental,0.23602423339660328,7,49,409,1142,733,36.22475032684642,3427
8e67372a-fb81-4d7b-9062-d257d9f9e494,Residental,0.2748072677845206,11,46,348,981,633,41.072874762766105,3442
8bcf5afa-0bec-40ca-944e-83829d6f2d8a,Residental,0.2266988459698719,23,5,705,732,27,99.37432511946699,3997
80c922b0-5e51-4b87-b006-51ed6d1ef6b2,Residental,0.988602412136112,37,28,674,915,241,95.43916411765795,7535
d59bbffd-c2f3-48b4-b066-61ee1775b411,Educational,0.3239044193178441,13,5,558,861,303,90.67652250283699,2063
a925760f-eee1-4cd7-8543-4180850a526c,Healthcare,0.26808776550501934,17,10,328,894,566,97.02411408895061,7588
a368f911-863c-47ca-9024-c8d9fda9f39d,Residental,0.7226188665878992,11,41,77,1140,1063,80.74909390338892,7514
5a823bc7-503b-4027-b341-7925eeaf7f5c,Healthcare,0.20714221932694754,24,46,210,726,516,44.695460049294454,8184
8333d26a-cb3f-4f1d-bc38-664b17f42eef,Healthcare,0.10678878889569621,39,20,403,1282,879,61.44414635550149,4873
5ee86808-e62a-453b-8fca-2c562a18f24b,Commercial,0.9197770943353184,43,10,211,240,29,12.294950575885347,5095
cf628118-f19a-49ad-aeb9-1619e2dea115,Residental,0.035446902015512816,5,11,557,715,158,37.42898591158429,7067
35894892-f89f-4601-abfd-e95592bf9efd,Commercial,0.9875887092246717,33,38,194,1348,1154,37.859820574020645,5434
07a4a316-59f1-4e1c-bb61-a78829415396,Educational,0.5724086226310352,24,1,671,1285,614,63.636531309743695,2386
c70f383e-37a8-485c-a54c-e0f48e4e6797,Healthcare,0.6158690617683223,31,44,474,654,180,65.17407101089815,6270
4b0a1484-be7b-4725-8470-6512484f13ea,Commercial,0.5968517172066011,3,16,52,133,81,30.44357908559793,2330
41d449c4-4185-456e-baf1-a472713df0c6,Educational,0.8295039671566456,28,29,234,790,556,87.93735974897828,9373
a9721032-79a0-4257-aa8a-d0ec2585de69,Commercial,0.10873903557112563,4,16,397,600,203,72.26424973059478,8561
36dee3ca-6b6d-403b-b68e-92d341ab3c87,Commercial,0.9428338224965719,8,22,514,1116,602,97.75302673496454,7005
d1d81a2a-6723-430a-af74-994663288410,Healthcare,0.27910232911114996,49,44,601,899,298,73.90898330502418,3182
c54c0f5d-e16d-42e5-a820-a3c68c599e42,Commercial,0.9868779680847297,33,9,182,287,105,94.65572021940065,3821
8d6b52f2-afd8-41b7-b8e8-cd5169e9c774,Educational,0.5493165962897236,43,10,381,1364,983,58.0036784188537,7142
414a1918-1b2b-4595-9a51-33509833dd13,Healthcare,0.9702846788791291,16,41,582,976,394,97.60038277075807,6308
089c6a57-95ba-45ee-9bbf-14c121970acf,Residental,0.7274851718965084,36,2,213,974,761,94.36178478761309,9457
d6ac59ac-6c4c-48ee-9ae1-fb4c7e0552e1,Residental,0.5220318927945167,35,38,669,1333,664,41.45629882382084,6484
cee74b76-32d4-4eac-9bb1-b2b680ff6ec7,Residental,0.0061144183621770765,29,19,527,730,203,65.01269138545831,5444
e65df067-7423-4d75-831d-74d2453dbfe4,Educational,0.5467425229144786,37,28,687,917,230,46.63800194535135,6059
7d9689e3-96f3-4098-a562-fdb878d6bdbf,Commercial,0.848327226230339,49,17,642,1310,668,82.1063703113183,1528
a648d858-0541-453d-9ea9-9e00ddb5e008,Residental,0.7611332643181711,31,17,244,1042,798,10.064742532891152,2160
eb5c4ce4-1120-4227-a0f0-835f45af554c,Educational,0.3428836485872181,32,31,596,1299,703,59.5164704561906,3197
e4938f3b-bc9b-476a-a63f-f4e03edeb2fe,Healthcare,0.17188152183183536,9,28,698,1254,556,10.691979173973134,7075
95f21ab5-6cd8-46f6-9245-50efaa57a85f,Educational,0.7721101482417438,44,43,473,1183,710,11.973979814199561,7610
5992c1da-bcc3-4acd-a89c-3cd98e0de3d7,Healthcare,0.8839943480537189,50,13,266,415,149,22.1398162115329,4300
39e9165d-4ab0-4dfd-8492-b84b57629696,Educational,0.38362263355908255,3,9,139,1365,1226,56.088426010745486,1618
4d7e4d1c-2524-4d12-bdf1-21c5ec806e14,Educational,0.0011382549691030253,36,39,448,1122,674,45.51673124408749,4604
101b15bb-c514-40e3-aba0-86e7999da957,Educational,0.18029307598861788,38,26,427,611,184,55.475996758170105,3737
e88fdf4a-5968-4aa2-a44f-91aa887a9e50,Healthcare,0.48655764747122054,23,41,443,890,447,93.19642529247983,1015
8985694f-9e3a-49a3-83a9-c7b28fb27d5e,Residental,0.917675737532089,26,14,95,1367,1272,75.28252156564488,6429
d244039e-02f8-4a94-97b6-eb96d4aa775f,Commercial,0.5238145728137379,26,34,282,1109,827,43.227378710230774,5896
06392edf-b689-48f9-a246-badb6af56838,Commercial,0.06500174848564222,2,26,351,792,441,27.5000949741051,5380
ffd4e038-aa14-459d-87c9-1942df7309ea,Educational,0.011922716776180065,9,29,616,770,154,63.74233474495952,4896
f84756ac-63a0-44e3-a98c-220cdfcd571c,Educational,0.4743552364457102,9,26,625,1101,476,39.56681778834185,8139
ac1fda41-ee42-4b59-95f7-7643c19b2cfa,Educational,0.10967895110477377,40,2,649,1298,649,78.78553283524546,1127
b4a261bb-5001-409f-b077-c05d2ff04560,Residental,0.9858759917483116,12,44,566,607,41,69.5329525127998,9111
78f5201a-be8d-4dff-ae9c-91fb3aa593b3,Commercial,0.06281477375564859,21,32,118,406,288,17.944855382687255,4103
4f83672d-a732-4b89-b637-5dfbbf52e0e2,Residental,0.22656435834415067,14,47,172,496,324,13.696689514833443,8158
95d0c32d-379c-4295-bb2c-dd0d93178932,Commercial,0.957646263691263,12,3,681,823,142,96.15606853145088,6732
e20dd73d-fe84-42b3-90e7-ffa82358a999,Educational,0.7718442710501314,6,41,88,712,624,42.21145303033885,4231
8b888586-3027-45d8-8410-dfe19c29ce6b,Residental,0.45725665300735274,16,16,297,486,189,70.23418844731142,8677
c2087479-5465-4b2f-821c-47f657c220c1,Educational,0.8587699230456781,12,30,514,704,190,63.56670218911473,6631
b02346eb-aefe-44c0-beb4-a8cd95041795,Healthcare,0.34397014809854776,38,35,161,1094,933,79.0025594881033,9969
e4ae0176-e88c-462d-ab06-e161269aca75,Commercial,0.26054053147992506,19,39,631,1051,420,14.384328216718696,9920
4fe9a411-c204-4b0d-a356-1a508584eef2,Residental,0.2781887063332892,47,43,621,734,113,31.57572020698858,6894
ed9e9776-6add-4db3-b68f-3dde535d4e31,Residental,0.38898247329562297,39,5,602,1060,458,27.415348658706208,1489
77f60b79-5351-4a73-83ed-b0a04001cf55,Commercial,0.5670976739911151,47,25,268,384,116,67.94411413062174,5266
beafeb9f-b005-49f0-b5fc-0867c702da1b,Residental,0.598776241578634,38,44,285,1218,933,71.4925821703676,7782
f5ee1110-12f7-436a-b2b9-498f1c7a926b,Residental,0.7246804320583841,49,3,148,181,33,44.46742269875707,2210
a0d799f3-10b9-40d4-91e5-da2593b22709,Healthcare,0.4227324892044909,40,14,20,59,39,16.88665607041859,9067
172f2910-3d44-415c-b328-9014b7424352,Educational,0.8234081374732249,43,1,275,1280,1005,92.27055896174394,2831
7ff6ca71-b7e1-424d-81c4-efa7e93086ba,Educational,0.4206442385755116,7,45,659,1059,400,91.04910039756643,4213
eb6a71f9-e944-4e71-b268-03285b38acd7,Commercial,0.27571038176361584,36,1,554,1320,766,95.51442624385172,2392
4af014ee-6229-4b0c-a83e-c9f26e9bfe14,Healthcare,0.6544116097023317,47,42,466,1405,939,82.48798867248779,8568
d49e9928-4c6d-4461-9eb4-c231fe914024,Commercial,0.6163949610691924,24,24,60,360,300,75.67279641720313,4925
2697f1bd-a65d-4394-9e1b-9c7a29416adf,Educational,0.9684689515015994,48,27,61,526,465,13.151673867682163,8700
b9aa0c63-8ce9-439e-b529-2ffec1143928,Residental,0.8107591607469334,23,39,675,1199,524,22.161623711501548,9556
048cc245-c36c-483e-849e-f734fdc402f1,Residental,0.9543071169764519,34,12,649,1296,647,12.066591824246355,1379
9d75f2fe-6870-4332-b8ba-59365df934fd,Educational,0.9941016832623356,28,33,161,711,550,39.036931150021985,5753
897d578b-1927-4451-aa3d-0258cc2f243d,Commercial,0.7149971467979842,15,4,485,1148,663,14.50215245644132,4000
f80d1048-9723-4359-a3ad-acdbe81c62a8,Educational,0.30054188773258683,19,36,96,364,268,42.17391051862907,9728
98c77635-74d2-4760-a321-849e2dbf2cfe,Residental,0.29000337150089184,1,28,80,957,877,12.078665528371147,6395
40373592-5211-45b9-b782-eb91376ced2e,Educational,0.5907130044033476,10,11,510,859,349,92.47502611160778,5385
0c8b561f-4cd0-4318-bde2-385e6ed620bd,Healthcare,0.7113157517077756,9,32,568,763,195,89.15191624148801,8889
f38c5f8c-c5d2-4279-88c5-eaa22a528abc,Educational,0.5987366084770052,33,9,174,1422,1248,59.76403353355055,4607
d1f86306-f9bd-491e-ac12-6105377a09a6,Educational,0.3548959428587364,4,27,677,814,137,10.361224677758015,8283
588fd88e-5a04-407c-8b17-79ba52274c4f,Healthcare,0.9061439968468016,22,26,126,429,303,20.183835153230746,2164
285159b6-ee69-4c0e-b55d-fd1e6732566d,Residental,0.8139362245539365,2,33,410,552,142,30.54253545346582,4328
ae961ec4-3dbe-4672-ac32-1f2f09cd08f1,Commercial,0.9806125776989425,47,43,73,412,339,55.61540267875844,8488
bf7e9d7c-d35c-44ee-a736-aaee6061142c,Healthcare,0.6385365650794952,18,1,214,1048,834,61.40120452920344,2416
3a1463bc-02b8-4ddf-99cf-6a860e4fc350,Educational,0.273740890696181,24,9,250,1235,985,20.25895079046888,6576
62dfa4e5-6790-485a-83c2-da646c114c40,Residental,0.3077364713463707,1,6,151,756,605,31.502201371307446,3109
d7fa6f72-e3db-40c9-955a-dffb71d25fd4,Educational,0.2446671329347322,5,5,93,914,821,87.84043661578953,6607
9287c957-49b8-4429-8b6b-bd3b5100f846,Educational,0.09988120967921998,43,5,297,1008,711,91.47839095544072,9908
fc566ddf-ec14-421b-a493-4af9a455d5f0,Residental,0.9888755465952062,40,41,697,1267,570,85.60726394678726,5361
ff4b5bcd-79af-4dfc-b27e-eaf152a1750d,Healthcare,0.11397530390911026,13,13,19,798,779,90.5304816781217,9049
b3eeaab2-beed-4709-92a7-6518ff9867db,Educational,0.18851153848715418,14,29,514,1113,599,59.31048961761662,8492
82003cd9-70a7-4209-b73f-f0669d04cb00,Residental,0.973028228227281,14,26,31,324,293,75.09144019435854,8135
dda1179b-5979-443f-a1be-45b16f6ad4d1,Healthcare,0.7531729579328494,40,37,534,664,130,66.12195516575517,9301
7411f69b-c733-45e4-b602-51c5dc52e2f0,Residental,0.22052803914356256,17,33,517,1069,552,66.34874853543064,1220
5a1630d5-4692-4ff4-96f9-d86cb6e6bde9,Residental,0.22902110870214887,15,40,246,495,249,24.17605354136982,8382
7f08603f-ee69-4ae0-9dd0-fcfed26f599a,Residental,0.7000611287261833,35,14,153,569,416,54.15144780158336,5407
34b04a35-3e6d-4006-a766-9a2f926c2966,Healthcare,0.44543176964835773,24,7,705,893,188,87.40102597715699,1750
b231a8cc-0b24-4ebd-b03e-43585e2afa2a,Educational,0.7709851613471187,22,21,354,893,539,27.25973655010939,8229
8a13feed-ea89-4e76-93c8-8b6c530411e1,Residental,0.399730754484399,42,11,102,150,48,96.69674513323389,6699
f34772f7-b567-466c-84dc-3f062989c1d4,Healthcare,0.8064961888602165,21,45,74,657,583,86.290113062539,1113
429cd47b-eed9-41fd-b81e-90c7b66bfe46,Residental,0.5708967729563285,36,40,660,696,36,67.15801464332705,3377
f99b2cc6-2467-46b7-a690-cefafd6c0714,Commercial,0.9413358168464855,32,15,19,655,636,14.002137568489868,9597
4d8dcd63-377c-42b4-a035-f70b02c2cdb8,Commercial,0.7306696367138314,41,24,274,937,663,86.31426411367379,9375
f048b669-ef3e-4ced-beb9-2db365e0f9b7,Educational,0.17059188571908956,15,1,643,1126,483,63.315753498257514,4911
f263d66c-ccac-41ef-8f55-b24fbbf9baef,Healthcare,0.027273785350042212,3,24,582,1248,666,44.81572973707429,1722
aaba57e0-239d-41a8-ad09-d56835aa38e8,Educational,0.011498396216331974,48,41,377,1060,683,50.849838568882944,1653
8065d67f-5f59-4e10-a437-8c2e02f17613,Residental,0.49657268873226224,31,3,149,799,650,48.60081756967222,5167
14aedcb5-a658-4211-8f6f-7e767178b25f,Educational,0.8955007272839769,28,46,465,1374,909,16.92928920620839,1972
95a1f27f-42a3-4dd7-94e2-33a96d078079,Educational,0.14265036293757904,29,43,683,878,195,53.56604120999588,3102
f5419d4b-2dbd-4d66-b1c2-640b2d93a796,Educational,0.4437875855481287,8,39,560,734,174,32.70467533801375,7532
3c996bb1-252b-4dfb-a35b-7e356121fa27,Healthcare,0.29701712348650033,4,41,32,151,119,77.83833416736877,8783
f058be60-32aa-4ada-bc7a-0d05470fc6be,Residental,0.41762423324226494,23,18,277,370,93,46.00543753729274,1986
eac8362c-a969-48d4-87bf-87c37ac68662,Commercial,0.6704133232838301,15,37,163,1038,875,17.212759835124274,1245
36c28ba8-628b-4c85-8d7f-eb6ad32282c4,Healthcare,0.15151068380976307,12,36,46,159,113,29.5765143188094,4327
816d3b54-e17c-4a7e-abbc-8dab6aac04c7,Commercial,0.7113362619712901,49,1,523,958,435,14.588557530094302,9011
6230d05b-ff28-4df0-9dc2-a28db59801e0,Healthcare,0.18080612968520804,28,19,207,1175,968,75.15923907911893,3920
dfa41aac-d824-4c91-b590-2c09ad0acb69,Healthcare,0.47427346945936255,44,14,94,326,232,35.456038175107075,9794
a03f0223-dce1-47ec-b96c-a643aff4bcbe,Commercial,0.3490158065327553,11,50,260,409,149,29.72020918468401,2818
8e628698-620b-4300-aa18-924a5da6ee44,Educational,0.6480741270320903,15,30,358,1298,940,45.09213170114614,1027
ca40fb42-7af6-4897-83e4-5c812f8843b5,Educational,0.5976720694439579,37,16,431,588,157,15.625833405384723,7482
b543078b-a5fc-4087-946c-6c73ad1f7b5e,Educational,0.9766944211029135,21,42,641,1421,780,14.998601295133213,7072
a27d08c8-5673-4a06-b4eb-520901fffe4e,Educational,0.37621779423696144,21,30,647,714,67,17.100721579435334,2543
eb0638e8-6a0c-4f8e-984d-b92ee6f04719,Educational,0.03160006551925332,50,32,131,1034,903,44.99833161648562,3884
ef479bd4-79d2-4da0-b950-33fad8795150,Residental,0.21812899883808956,19,47,83,322,239,81.61025085762051,5706
a600b17d-7433-4150-9e74-1bec094abb39,Residental,0.1710843492346612,1,41,408,859,451,70.03925938721893,1881
0d955c0b-f89a-4508-8899-cb5ba2d16d40,Healthcare,0.20060426415665644,19,39,661,1048,387,76.97982214880226,2190
34487164-f1ea-4ca5-a2bf-2a13edd70d4e,Healthcare,0.8744402645902558,34,39,514,825,311,22.294301625245772,5889
1841d1c3-e12e-461c-a0d5-c72427eb5d36,Educational,0.9439428670287939,23,41,248,384,136,34.25112508718409,3541
8043703d-f450-4f36-b293-356af7839984,Commercial,0.6689773280687853,39,20,236,960,724,39.47945716397271,9427
bad3d513-0f35-4d0a-881b-90548113df61,Healthcare,0.5531078958855437,36,25,603,1209,606,44.69604748658585,9334
32f0195b-5b10-49ba-823d-79772d70f227,Residental,0.6532156979196136,26,31,561,740,179,14.13876519209433,4317
9bcfdae1-83d5-4128-a0d7-aa0415b42371,Residental,0.06916107335308763,36,35,173,1357,1184,35.25022375240421,8541
22f0fde1-163d-4770-bf59-789ca4c18f1f,Healthcare,0.5849751026313067,38,17,157,752,595,21.33903075297585,1438
a94f1d20-85db-4f13-ac60-b4c0fa46491b,Educational,0.9951088672477956,37,19,625,1028,403,82.31939853061914,1232
f48feab0-3188-4512-bc95-f062f87e341c,Residental,0.5715125745129748,38,35,548,1332,784,51.81777542570144,6700
cfd49dfe-bbe1-4029-87be-c9df7e694b07,Residental,0.45684363783223325,5,4,565,1432,867,93.65671462126994,4675
c34e558f-9b22-4079-8c89-c355911bf4f8,Residental,0.4556523930092041,13,2,132,680,548,76.87630738738866,6426
ec2833ad-bbdb-4578-9c36-71e7f6d20e9e,Educational,0.9029021203223778,3,2,691,1433,742,92.06789592964311,9599
d31c686f-93c5-4e4d-8ee3-ca9ecf10fa25,Educational,0.2514172944774494,28,6,430,1074,644,54.02005079032914,2864
3fddf9b0-f151-473a-bd7e-fb6536536cde,Educational,0.019762642370483863,41,39,326,485,159,29.317346933550738,9545
f19b46b8-87e8-485e-81d2-634f259e98ea,Healthcare,0.9080184608430575,26,41,493,999,506,12.085782635401966,7686
5e02d373-b4a5-48f8-b56c-06f8843ad0f4,Educational,0.8133686091513308,46,9,507,1202,695,15.233808827943701,7450
44959842-f676-48c9-b4d6-84e4f5870f9b,Residental,0.29396248530329616,49,37,123,919,796,60.0436390904175,5067
97460f38-36b6-440f-90a5-7db120f32c58,Residental,0.5959643815471132,7,8,92,1012,920,34.10463754989229,1263
52697fe8-3388-423e-8cb6-8182dc5753d2,Residental,0.08158130643209416,49,4,518,1228,710,54.88016465919218,1248
d20b7257-0741-495a-8fa3-506674999e28,Commercial,0.08512080808832645,6,29,128,291,163,71.39798446713768,2436
4f93a8fc-9ea5-4a61-895c-425e611ba3b0,Residental,0.8930936079979616,40,1,701,735,34,66.51854727983283,8667
990c05bd-6006-422c-86e7-acadecfd0d4b,Residental,0.635533483599726,26,42,52,598,546,93.24998830171334,2329
77a2e23f-8bd9-451b-8b93-3cf4dd747cfc,Residental,0.19846613694718662,42,33,174,781,607,61.103805969061945,9352
5f1c1b5d-cadf-497d-bff5-8c46f767c79f,Commercial,0.6198482946048325,47,34,281,937,656,62.28523796072622,9493
ca02406c-f2f4-4613-83f8-13597f62b2e0,Commercial,0.9288150187307469,34,41,451,1397,946,14.77350093613145,4067
4dce6827-4bbe-4e47-846f-dba113228939,Residental,0.5084395170307379,25,24,704,775,71,68.28228721343436,8194
0820c74d-060d-4f45-a867-03ddffabded0,Educational,0.6510337893868302,26,1,450,1415,965,14.365057194563494,6360
fef2a165-73b9-4f8b-9e0c-b17b5a3c3783,Educational,0.49690903612480686,4,35,300,1231,931,23.837117967694216,4777
f7da69c9-b3c4-4eb6-916f-cb0470bc3afd,Educational,0.8170971277153034,45,40,459,1318,859,82.26546118473699,2692
e680eb96-d71e-4fc0-b5d8-7de725970a83,Residental,0.03750707361869021,24,25,486,1041,555,47.757963666327726,8533
3a3dccb5-86d0-4932-8208-c83323c2224c,Healthcare,0.036555007152432095,37,31,427,446,19,67.52704971756822,2479
bc293b49-9899-416d-b174-e73b3d7dfdc6,Commercial,0.3458983099515538,49,39,275,548,273,90.35873575709377,7919
ee5a2b0f-32d2-4910-bd89-d25ddc0702d6,Healthcare,0.8870293484013025,22,24,624,1171,547,44.54662019472822,4608
ae40eb10-90d0-40f4-92ad-4ba441a3e14a,Healthcare,0.6647023559414923,2,32,387,936,549,92.10453938731976,3774
6d492800-c212-4853-94af-1de54a446b8e,Commercial,0.854525814252304,39,18,31,581,550,46.87718633944426,8242
c28a9bfb-b2dc-450d-ab2f-7c882f921f84,Residental,0.6387164210136137,37,28,545,552,7,77.96503623721023,1388
57cf210a-9a47-486f-9066-ffe26a1358a7,Commercial,0.12392202906993721,33,3,617,1364,747,44.99308297955401,2788
9ea202de-fa92-46cc-a018-936f93f51cc6,Healthcare,0.25354572884266113,12,12,467,718,251,48.3074194321785,7584
12e43f2c-dce4-491d-a5c7-ec0e4236123f,Commercial,0.23767481486095587,15,41,234,440,206,26.09963286231139,9070
a6d51338-f355-4cb7-a6d8-ccc0d3657c32,Residental,0.963642310198076,28,47,623,724,101,98.06451151808325,5786
15707769-0748-4706-8c06-55b306623920,Healthcare,0.20444114676248404,16,3,623,1072,449,93.36632160557643,1743
bba7bc88-28b5-4174-969b-88c280d257dd,Educational,0.4329213387740314,27,13,529,1311,782,68.24445822438616,5062
42314fa7-75c7-4a53-82f9-080360c1c100,Educational,0.2003509288574563,22,34,541,1046,505,34.20382098972151,7868
698c3ac0-66ab-4421-b1c5-daa8a5723e45,Educational,0.5379556955283823,20,31,656,1016,360,56.793855270639206,9985
df412cc0-9469-43d6-82c5-195109b331c6,Educational,0.9012540967825828,15,4,416,1333,917,67.76634457180799,4645
f5f76035-243e-484e-97d2-fabed0f300bb,Residental,0.5304751200164404,20,29,627,1049,422,40.730891892115096,9630
382e4385-df5d-4378-8062-440c73659544,Commercial,0.20788059391933955,25,28,221,1341,1120,96.66900470276299,9202
f411cacd-83c3-4cc0-8ce7-0f498651d2ec,Residental,0.6041431575822589,46,22,324,700,376,65.55131131325942,9969
be9ca6d9-0738-40ac-a0e1-c0f53ed74014,Commercial,0.3193841829100874,38,23,309,744,435,85.28184803119439,7140
33cd85f3-1579-43a7-836c-837447720557,Educational,0.8155871339597989,1,23,464,1014,550,83.36807209454406,4911
3b2d8178-a589-4018-84f9-6082a609c320,Residental,0.3157219674103007,43,48,291,850,559,68.55389151987805,3230
09d725c0-6040-4615-99aa-5f6fc130e581,Educational,0.6476878821806481,26,35,264,709,445,75.15459024013052,2422
a4ab3e5d-5818-4678-89c5-7678c7269fc2,Residental,0.7966429973725163,37,39,461,910,449,40.384828695432425,8058
f795891f-efc5-454e-82a3-c57fe4d2131b,Educational,0.9549002497174124,41,28,199,435,236,49.69306838896495,2033
cce25ab7-09db-4d40-9e4b-620892cbad8e,Commercial,0.08158332219445563,39,31,198,1054,856,57.30696356953483,2910
ffe864ed-15a9-4dcd-9bd5-5ffab36bd21b,Healthcare,0.267097712224005,35,31,120,497,377,61.10083535587141,1625
7fe4ee89-1105-496e-a9d6-3873f425de77,Residental,0.4182027233490925,35,19,228,812,584,66.61167216465985,3679
1b47e24d-b03f-4879-a5fe-f6470d1dd972,Residental,0.6738912859387737,39,6,596,1063,467,32.88570899290142,9286
7d6bc104-f41b-44d4-bb8a-a45d820ca44e,Healthcare,0.43689537978928694,29,35,604,1221,617,57.286106887088735,8560
5eda73c5-6a46-4bef-9316-15e48b20857c,Residental,0.25630893034705315,37,21,11,73,62,82.38364748220062,7185
f0041ad4-38a4-4f90-a4fd-f585296fc891,Educational,0.69909935177402,25,10,48,138,90,30.461033405254945,9545
1c6a893e-0413-41be-8cf0-d73b1efd3391,Educational,0.019945197998058384,23,25,9,836,827,46.42993134365812,9369
d8e9005e-c5ae-45a8-b0b5-0953c379ce3b,Residental,0.5814692716415076,47,34,575,986,411,15.227169220167148,4076
7e312127-aac6-4f42-a761-bf91671d047b,Educational,0.3671225200774596,20,22,80,256,176,45.96158496761893,2030
c69f0c82-8b69-415f-8262-e7ea79a29f95,Commercial,0.2332431722826478,14,6,692,1252,560,26.12548630032815,9183
a8c4a7e2-d071-4edf-abca-82d5ed75d83d,Residental,0.1623468617934859,6,10,138,756,618,18.091706120552146,2564
954a2c12-a248-4e17-baaf-f90c4e0beba5,Healthcare,0.494814710958594,34,41,658,693,35,50.82742137894798,5568
a7e250e4-05e6-4493-9115-7e9fc3501137,Residental,0.2758770830520977,4,37,403,1344,941,96.51120626854755,1480
91dafa3b-b09f-4f52-90dc-3537b445724a,Healthcare,0.3103520306241969,39,38,161,925,764,11.581186205443979,5240
79e90b75-6dcf-439e-970d-fb5d94d9ccf1,Commercial,0.6132601727934223,24,31,185,1347,1162,37.16780614692808,1646
9e56704f-5fc8-434c-af40-bd05c8861ede,Commercial,0.3984378213518811,36,34,70,420,350,40.32522135583569,3481
b4513976-b874-4ded-9daf-7461bd6cfe66,Educational,0.652712695000354,29,5,100,241,141,85.8254115542499,8975
ae2a3ae8-3185-4495-b9a6-a869270218d0,Commercial,0.9542582505256273,5,39,436,851,415,76.55853381741,5125
23fddc5f-0066-470e-973c-1b78b753bac8,Residental,0.36658143160077183,3,29,567,1189,622,78.26743952910235,5582
e034183a-6e80-4ba4-ada2-d7eb3d3fd8f2,Commercial,0.9909451236838321,43,18,541,556,15,70.71549184668004,2771
96f8c185-bf74-4d94-8e02-95bbe334caa7,Residental,0.5047208577948777,29,49,356,1356,1000,68.97040712733417,4206
e1817dcb-43f4-4e42-b282-60f22a61f1f6,Educational,0.2521668179482064,25,45,577,1132,555,43.31300823125393,9929
9f16e679-34fb-404c-a914-ac772e07df69,Residental,0.23723415571722495,50,29,72,1416,1344,72.85452427930616,7437
76846e64-a1c2-4d94-9114-7a626782c1bc,Commercial,0.7260040764665161,34,1,462,485,23,16.33458789944759,9727
5b6dcf58-15af-488d-a608-cffe601ae838,Healthcare,0.5129483732067773,45,14,247,963,716,52.79398949941474,6846
bd2af388-4f7d-4ced-a84a-d54d50b3bc13,Residental,0.7519580467596874,23,20,21,1108,1087,37.15298899510649,6864
beeecdf1-3dfe-432f-9be2-3eb933a15c42,Healthcare,0.43828698421733836,28,19,113,277,164,38.87332152241591,4001
e7343792-800f-482a-8f3b-fba39adf806f,Commercial,0.8257653095323155,33,49,482,897,415,77.55063194548384,7026
f4fd92fe-44b2-48f0-8e54-ae2aa08efc40,Residental,0.896815454525154,26,48,242,1002,760,57.32664998310232,8478
81093fb5-5be0-49e5-ad7f-dc9b36dce6cd,Commercial,0.11582114988517567,45,28,151,1396,1245,96.51892126271245,5003
81d357b8-3974-4ff7-8be9-b5adfdb4fa63,Educational,0.02549253823396269,8,9,547,1129,582,92.95831785238327,7507
3d883148-d4f2-4ec9-998e-e24ee530a746,Commercial,0.7681425150011018,42,13,278,323,45,32.714116673528935,6919
2a5727e1-f7d9-46b3-8565-83756e282492,Educational,0.3034260904926098,17,21,650,1184,534,10.136846831394418,8812
171e59c5-54b0-4009-82ba-7242f3c76ede,Educational,0.6431315459599878,25,35,601,1235,634,94.72462591678826,9275
951f1e31-a78d-4cb4-bb48-d9014e85e6b6,Residental,0.24244809206057838,43,50,630,1198,568,20.767290935471117,8870
03e3c8eb-af68-40d1-b2fc-6f4d12f11c5b,Healthcare,0.4431226874219245,42,47,432,1390,958,75.20443586298519,4627
a2634f04-bcec-499a-8c46-9aa59dac1d9f,Commercial,0.40164101576358535,49,25,68,261,193,30.632862207887488,1551
9bbb2ad1-8c73-4117-8a04-fa264987b794,Commercial,0.1840606796472447,12,2,491,916,425,77.78773781371288,5510
8b0a679d-90b8-4c83-b773-066c452165e0,Residental,0.739225991420762,50,21,1,1057,1056,19.33991077893711,9087
7a45d5f0-af2a-42fc-8d67-57a6f0f9e1ee,Residental,0.13913927585649033,7,4,336,880,544,85.03533739914701,4794
eeaa0a68-eac0-4ad8-a998-1447cf69c451,Healthcare,0.14840980512204205,28,2,579,635,56,58.01767440990983,9551
531715c4-1daa-4aa9-ac4b-6de1cdb26e3d,Residental,0.9974458897443409,48,11,585,893,308,57.030606970700504,8715
67f4151a-df66-4bd2-8992-81ba9898446c,Healthcare,0.20759863149163138,21,7,697,886,189,46.14594041196804,4639
06c85cca-6b64-4c01-a988-8643bd8da3b8,Commercial,0.30464275340618896,48,7,505,640,135,19.949691846460553,5732
14b49bbd-cb58-4188-82d3-c4d1c203441d,Educational,0.1506137818792599,23,4,58,293,235,46.78624723995948,9372
8d444375-f129-4f18-9063-157ca94a227c,Residental,0.18279618349279803,7,41,143,531,388,82.57416503741499,7384
fd7a5609-0594-4a14-b118-e4726a0a92f9,Commercial,0.6023210495258186,5,25,158,433,275,14.516702357171301,7445
608b1cb0-f4fa-40a8-9445-5b59961868a2,Healthcare,0.9104162692603947,21,28,544,1391,847,94.57053135123981,4734
1e2edddb-8a48-478d-89c8-e19553596e57,Residental,0.20450486964079706,20,17,547,1124,577,31.546207103910778,3068
fa759778-a10c-4b6e-ad36-886430f1e645,Educational,0.36177062464906173,44,35,270,335,65,44.0627487145847,9672
8cf60a16-db7c-47e9-b439-8fd5d092992d,Commercial,0.03680652440515986,10,16,328,1066,738,10.415040945974662,1238
cea14cfc-2246-403a-8f6e-c0ea2ae406ad,Educational,0.6011324342934092,23,28,305,1207,902,20.05036834294569,5536
25c3cd95-bcf3-4b98-a6be-838df8717576,Educational,0.2842259939009575,20,47,91,103,12,71.63067938636289,3611
8e443579-7d14-43e5-be1f-50a9eb6464c9,Educational,0.9034387854685052,22,15,632,1429,797,38.55384572382362,1962
47146014-6102-46d9-94cb-f7e9c4f2876b,Commercial,0.789867466591907,23,20,175,326,151,91.70229012662094,4381
c7dce30f-45bf-41dc-97c4-91b2195e5661,Educational,0.7105266348470257,35,23,341,467,126,10.565693791483199,3683
680dc8cd-341a-4075-84a5-138264de3de6,Healthcare,0.7625619775818712,20,12,358,509,151,80.49908166958637,2888
33eff1b2-7438-4082-8ffe-46bb69b2473d,Healthcare,0.9793474457371719,5,13,89,768,679,91.40937306692484,4591
ad39c9a0-0e60-4163-9f0b-76ec2ee2d414,Commercial,0.7579316456562726,33,21,268,1427,1159,49.87841464863126,1946
502570dd-04f5-4125-b2bc-7c4a4b29add1,Educational,0.019712165649193203,4,46,643,820,177,91.37296548401133,8230
6200e785-0e3a-4258-86c5-4fd6d6ae9e2b,Residental,0.44864655133978926,47,6,146,1409,1263,61.80261615666854,8435
f50142f3-c7b4-409e-b2f5-c2983d46ea57,Educational,0.5885639260669111,49,7,49,1115,1066,72.76561298661478,1147
d3dd76a2-d3d0-482a-b368-a79c9a92e0bf,Educational,0.6974113875315651,46,33,375,990,615,43.897315564327464,7083
3aa6099a-c79b-400a-a9b6-7d483f57b377,Commercial,0.18952998856165193,6,50,634,1055,421,84.22055839301865,8476
f4f6ea4f-8045-4b3c-8d97-7cefe827738b,Commercial,0.47647378094802906,36,18,477,1306,829,57.84667165440312,8652
4baf6dd7-0668-41f0-a6da-c7d054f16abb,Residental,0.290155409898443,46,18,119,1230,1111,49.97394372454732,8521
d4acab3b-587f-497b-bf96-43e4e8396786,Commercial,0.3673351692872897,18,26,253,933,680,44.721535609541526,9502
5ae328ac-05e3-4ca3-a686-ccf8fcf0cc17,Educational,0.3309131397592172,41,7,162,1430,1268,79.08795965723546,8513
f663f921-9005-44aa-bb01-927fbcc7cd79,Healthcare,0.22102365524708711,44,49,143,516,373,44.0389549832708,2638
cd48331b-72f6-42b9-82ad-64723a43d821,Healthcare,0.9289109379935454,44,49,423,1157,734,47.75846056608381,2637
d744359c-f9a3-4ef7-becb-5e1507d711d4,Residental,0.353377054131607,7,9,103,480,377,68.10172348538255,9204
8ee2f8be-d29f-416f-87b3-b4c8f8e27c00,Educational,0.7280100410997219,39,49,422,468,46,81.76175631722161,5289
e4dbdbf2-6f0c-4c94-8818-9c9e18b45caa,Commercial,0.7530662160878706,7,3,117,1144,1027,21.93400985206474,5090
9a766a0d-f8ef-43cc-92e6-e646259cbcc8,Residental,0.9212866969613679,48,23,192,384,192,49.172718808691855,8031
9d583ccb-3b4c-4583-bf44-8ace6391411a,Educational,0.17240593532338866,29,12,717,989,272,67.19881487184949,4283
c66c983c-6eae-46b9-ad94-efe928edc3aa,Commercial,0.7788507109000729,6,3,378,1259,881,40.10065127191052,9415
b8747aca-8264-44c6-a779-d0de82f82602,Healthcare,0.368160688959861,21,20,280,868,588,73.13670195346744,3354
f1164195-1447-4004-8108-55b183052372,Healthcare,0.4417564335989772,27,30,368,700,332,53.49834682486056,1562
959b940b-93d4-46e9-9d92-4629a0584be3,Commercial,0.48382286006467956,9,13,181,650,469,70.38157941314965,4626
93fa0220-0cc3-4852-a1ba-0996be8d2458,Educational,0.06313707422502035,16,27,189,1008,819,38.879744546737854,6078
38fd9eb6-0f0d-4287-85bc-44d51d2ea623,Residental,0.24161584326616492,30,43,221,864,643,19.741657586643946,4119
1e8346db-bb0d-424e-9b25-e9eb5a48834d,Commercial,0.028397765254990714,35,33,538,658,120,67.36220012201663,4197
5be3812a-43ce-4578-922d-0b890f309e50,Residental,0.9131138495781123,49,4,41,333,292,35.520710540675246,6001
4ccdf17b-b61c-4bf8-8c64-eb16916ef685,Educational,0.6438161148091278,23,18,63,677,614,36.96021272990811,3532
1df63959-05cd-4b63-84e0-21f4a59a2ab5,Residental,0.19041084062401803,46,27,414,509,95,81.11232150520541,8815
ea4bebc1-2190-4d3f-9186-688e30f8a1f6,Residental,0.631110002205671,23,6,250,402,152,98.82073393847928,2290
4f202923-5f72-46a6-86ab-20183ab14986,Residental,0.17385379214036856,21,32,206,543,337,40.537499495615734,3800
2080be39-b6f7-408e-bb9d-715ba1c8d448,Healthcare,0.6669611094223982,5,12,240,1098,858,83.59284463298734,9756
530f6c33-7e33-4228-80cd-958e25787b68,Commercial,0.5550908639199333,30,34,558,749,191,19.0403710532688,6223
19f5a665-40d9-4550-a164-dd321fd7857b,Healthcare,0.058539049584685254,12,49,653,1383,730,10.882595084917966,6914
db5317eb-0690-45e2-a664-ef153cac98db,Educational,0.14661840390114322,24,12,561,753,192,83.40482200712175,4559
62c279ab-d832-427c-8513-b04010dfd234,Residental,0.49786331147494456,46,36,114,497,383,81.4404074675982,1114
e77f563a-0538-4087-a6c6-2ae739c85411,Healthcare,0.10897488761493068,7,26,418,1191,773,85.30209989748111,3462
402f42a0-42b5-4ea2-9945-0016af675176,Residental,0.6279619745612097,38,22,290,970,680,54.68779460637671,9279
13990fca-3cae-4b8b-ae7f-ac8137a01d13,Educational,0.8170607551075502,15,29,703,944,241,26.959026021511654,4246
8fb55aa3-d806-4e8d-936a-f7be2a1992a4,Healthcare,0.8746620001577389,8,24,249,1082,833,53.095567359243205,4267
e019b534-0cfd-4a9d-8de6-1e918081587f,Healthcare,0.28073652245208613,41,28,394,1186,792,73.56391333227961,6405
c31f6a18-660f-442e-8031-5a4526c89d4e,Educational,0.4589729893604221,22,23,610,709,99,68.04089201049464,8176
ab5820b1-17b5-4d03-a7ec-da16c2f138f3,Residental,0.5599343046594298,13,14,122,1109,987,39.37085958991338,4962
373fd447-8739-4a83-9ec0-9fad4d807066,Educational,0.30407695469003915,4,23,147,399,252,75.53938409338829,7048
127d8fbd-b8f1-41c0-9084-1b633459cd2a,Residental,0.8120138941956782,17,22,411,559,148,17.46917562717946,2751
5393f19a-7bc1-459b-b75f-557fbac296ad,Residental,0.3757599265351491,47,50,394,1316,922,40.62863497186101,9071
f2fef79e-dd95-418f-8da2-dd6fc8f1474b,Commercial,0.2711078699089857,4,2,410,1067,657,68.44985940903139,8667
133c6e23-eade-4380-ae78-c832f2af85a1,Healthcare,0.5027761958496743,11,45,147,701,554,57.80320130705602,7214
a70cb1f6-40b9-406f-b0ba-2444d9a18b0b,Healthcare,0.9928076516533042,44,24,194,1023,829,60.24353142114991,3830
e5d23a0a-14e6-43e0-83d2-813d5d7e1d4c,Healthcare,0.011808387434693035,9,3,155,1223,1068,21.797099240750043,8922
fde09114-c5d2-4137-b85c-8cb998957cda,Healthcare,0.513833542087479,45,28,670,1147,477,48.635110307807786,5807
0fd00713-7b6b-42d3-a9a5-be4a7d90c8a4,Commercial,0.440679466749597,35,1,342,940,598,49.023107667985926,6219
1b30b430-6dc0-4c3c-be3b-89b1efba1f23,Educational,0.03916861820248285,33,21,116,353,237,71.0089958099606,7780
cd3b614c-30c3-4e3d-b1a0-e6665aafe736,Residental,0.3611112174758876,28,27,482,1150,668,41.72664137254843,6513
463540f5-6223-42c4-920c-0ef0784987b6,Commercial,0.7348664403368864,19,9,441,465,24,42.849198339640665,2941
fa512c8e-807a-42da-a02f-b717da1391c8,Healthcare,0.43146649006916704,34,19,284,506,222,78.65736334060318,7762
964239ce-b89a-4e97-ac6a-f0caa880e704,Commercial,0.4050068121075652,27,14,227,1427,1200,53.460334664428714,4356
fa69c489-e1d1-4efa-b5ec-211480d5294b,Commercial,0.1975477859576128,40,9,579,761,182,24.07972637679664,3791
b6a6b369-e13e-421a-8d3b-6b9b37090649,Healthcare,0.35173179084842676,36,8,269,687,418,82.64902592862487,1936
d58a7c3e-dd0f-4481-9bb6-4bd1a1efa415,Healthcare,0.797661328502744,22,23,152,280,128,51.09372167629085,3179
6b0f7d53-9bb2-44a0-8fa3-ff3f29a7f73b,Commercial,0.8235458834708519,48,7,705,1111,406,72.87678182444222,6578
4648bd6a-6992-4f52-a02a-9b8fb911117a,Educational,0.5545818200317197,35,25,701,1364,663,56.74449003341949,7768
692dfcef-dd30-4b79-9852-9c1e2b63079a,Residental,0.6601783879531283,30,43,86,1299,1213,29.764540950523987,3795
193f5a89-96c6-4823-a3c1-f9bc6d8d5104,Healthcare,0.8285303771712496,4,30,608,877,269,24.658377442657432,6522
0ca3173e-faed-4cc8-80d4-efdcbe9a7e61,Educational,0.19116761883658095,1,29,690,1321,631,94.67483263480749,3683
b4ab9667-f460-48d4-a36f-25e836b22e58,Commercial,0.3881033127952851,19,20,576,984,408,67.38582667569864,6876
be55eb25-ffef-4a14-aaca-36542eb1be7e,Residental,0.24662456404856603,2,8,153,1076,923,67.05280828726814,4860
f7a263ba-2282-4cd0-bb8b-698a61fb9548,Educational,0.7997572500066585,31,5,55,424,369,16.930784077017588,6376
a30a4337-45b0-44b8-a1fe-c4876a9eb621,Healthcare,0.956376141350109,7,18,82,1280,1198,32.53555399603503,5093
d6aae20f-a7e2-4fed-8d42-73bd632d75e2,Residental,0.2399880071294207,3,42,131,318,187,45.78821956212882,2322
a435355f-4faf-4960-b822-9fcf200ac0e2,Healthcare,0.7462458977079006,26,19,542,1285,743,39.855608523392604,3483
5f9fc4d7-11cd-4361-ad78-f5cb7dd1fb32,Residental,0.8983457586634357,2,4,27,498,471,51.00394698836897,7375
06d05dfb-fe27-4630-87fa-1d07f1b4e62f,Commercial,0.7290929832124539,27,2,94,616,522,12.32354909931047,6001
a64211e5-506d-4128-84d1-4640bc840866,Educational,0.45408690379954475,27,4,582,1308,726,36.29498175340456,4430
5ac1a3ed-212f-4caf-b5c3-9ccdcf71da8c,Commercial,0.8614570641339121,28,27,210,216,6,34.568375361924566,4936
71822a10-d738-4329-9051-041640a54d13,Educational,0.5153039657324597,13,3,18,1117,1099,24.899108530219998,9811
1eba5b58-4305-46cd-888b-b3f73a9dce8c,Healthcare,0.9129530554419606,30,46,66,484,418,46.96333463338605,7936
37696e65-6658-45dd-86a1-b1851f69c6ba,Healthcare,0.6116408351564522,47,1,98,937,839,61.77810986919291,1168
83d97931-96a1-4607-9769-9253c966290d,Educational,0.2823622546815844,3,18,673,1020,347,40.961113520898266,1124
0e90eb7f-6dca-4d19-b70b-98abb8b0d3b3,Commercial,0.920058407006162,9,10,579,1355,776,26.092572174337278,3605
d3168485-bd75-4bf2-809c-474d8456ccbd,Residental,0.2931531049317371,27,26,112,137,25,32.95301222258866,5544
8bf4d137-cbd3-4df8-b8af-538db0cef196,Commercial,0.5126532160591664,47,25,486,1118,632,78.7886774397205,3953
22f8c5bc-833a-4ad9-81ce-9cb0ae7d4ebf,Healthcare,0.09092943125824471,18,26,35,1141,1106,93.47096691747032,3172
3295c5fb-d79d-4da1-a82f-92941ccac0b2,Healthcare,0.0862994550260745,11,7,575,1269,694,34.58250138567036,4972
ab35a559-f989-4786-99c6-83292e5af0e1,Commercial,0.2823717277211091,45,20,671,735,64,31.74219337528004,6666
6faf74fa-38fd-4148-8ec1-eba717ff0a42,Commercial,0.9968872403280967,29,8,142,884,742,44.76794734225296,7768
8ca5f100-b4e8-4d8e-a36d-ea3b914d60cb,Residental,0.35447214351987244,49,2,552,899,347,72.47101293777166,6262
7f0c6701-cc30-48d5-9e6c-016cefa71f39,Residental,0.10635984375693619,31,11,273,1227,954,29.350767728115386,2695
8efa0091-3cb7-4543-b650-fdbbbd71e814,Commercial,0.9797204579688684,16,40,17,108,91,95.87937469392544,9505
f965a11c-79f9-4ede-a6cf-e814b97031be,Educational,0.626201930247432,9,1,115,989,874,68.34664119670975,4232
ae18f3d2-9f66-46c1-a5c3-f2c196a8b1a1,Residental,0.5206700745271349,13,37,580,1129,549,92.0480958821228,2838
80d1cdf6-90a2-4105-adf8-e8a3c4392246,Healthcare,0.5113282607247829,49,49,16,1046,1030,96.52502017062191,4477
68b7067d-24f9-40ad-9e11-11bd84f8d021,Residental,0.7424948728061379,21,9,698,711,13,33.17112906086594,1746
5981ac5d-f9fe-4360-bb81-aa04ce4fada4,Residental,0.6946708065438046,17,21,458,1323,865,34.22106841365542,3350
52ac7bd6-0eca-46b7-9230-9b092c4a28fd,Educational,0.6428377305624411,12,11,207,320,113,99.3569751579396,9171
18c8a085-a6fb-4601-bd95-37c878847245,Educational,0.13492473264186056,24,45,6,984,978,99.88533995588134,5356
a7336086-8806-40ef-8ddf-dcef89592429,Healthcare,0.3370618786680646,27,4,690,1190,500,15.66641790337778,8526
3fdc1ef8-5f02-4928-95ed-4b649b5534b5,Healthcare,0.06717774859431314,17,12,682,1391,709,34.63472681019029,9096
e0be54b0-5211-4eba-a9c3-b610fbf62cbe,Healthcare,0.34606878794198725,5,31,158,1301,1143,54.25030642065976,9916
29bcd485-2c71-42c4-b0f1-c18bccbbbc29,Commercial,0.026832512609574977,6,31,54,603,549,82.66238232843473,8914
73cffb71-b5a3-4a2d-b84f-43a0bf87fd3a,Healthcare,0.6797200399253078,32,35,424,1229,805,19.835389595320667,2297
f7b5cd0a-7f16-4a3a-827b-1335bedbe560,Healthcare,0.14617776615283662,35,44,596,1056,460,67.11568348733074,5931
5a047894-2721-4751-9319-2a2986de9f6b,Healthcare,0.031462759790501726,14,1,13,1064,1051,91.84225325954637,6631
b97725f9-2c71-4ddb-9eee-966490c20515,Healthcare,0.8161535146722375,48,7,346,868,522,33.34831111870339,2150
19829735-cfb6-48d2-8b9c-14d741545753,Residental,0.16697069616054416,16,5,600,1078,478,22.17928844503018,5294
73a98688-35e1-43d5-a402-e2162f51d1d9,Healthcare,0.05360206280632407,2,15,314,798,484,90.98700255016159,3667
29da0732-8448-4d5b-a90f-cfb3bff0f869,Commercial,0.6050611386717757,38,46,595,1255,660,33.2201001726516,3235
49493f9e-02dc-494b-8847-285de14dba4b,Residental,0.7582739152126491,13,40,377,398,21,44.81920475676043,6013
a29787c2-85d9-4239-8e24-6ffec3569c8f,Residental,0.16049461397334808,12,12,117,188,71,82.67212114618587,5346
42278302-4548-41d0-b482-774fec764ff6,Healthcare,0.10455348899293904,30,23,236,399,163,79.58472296845926,8428
6235bf97-41b0-4d80-9430-116a9afc0499,Educational,0.5953148085005318,6,21,649,1350,701,47.21397739501618,2840
a4dfaaf1-4200-4ddf-b757-1c9610e33c36,Commercial,0.307383960366177,21,47,81,245,164,74.16035865227514,4555
e0e74883-9948-46a1-ab4b-c17f09283b9e,Residental,0.48337317047545814,50,41,271,978,707,54.0114271450002,3610
9f88d126-df12-442e-91d8-331a77c38ae4,Healthcare,0.6492638821531073,44,34,7,631,624,93.95359674692104,6434
17565077-a6a9-4877-a01d-4f69c05138eb,Residental,0.11167026164453453,5,39,266,1193,927,48.57278538215652,7676
a6cc76fd-a5a7-4455-ac03-65cc4f00d1f3,Healthcare,0.7863495728421994,17,21,63,1255,1192,68.21941417495809,8267
03f269a5-9250-40ea-b651-7abf7bc62dcf,Healthcare,0.6373663109948207,46,46,417,1255,838,18.8512758007878,2597
2bbcc6a6-a9a6-4d24-9c2e-1e9ed7899579,Educational,0.4007678325970624,12,37,95,745,650,26.544059131678175,1035
6fa8cc9b-ad00-43fe-9583-800bef7d99c3,Educational,0.11861511972909544,46,32,263,1226,963,34.132482744923514,3279
6eebaf8d-d874-4af1-8a2f-55aa88925f6c,Healthcare,0.3916202746159497,47,49,315,577,262,47.70851757487877,3070
8ba2567a-3587-4c3b-a6d9-5005b9077649,Commercial,0.7716228894005486,4,5,29,1107,1078,36.25246494389958,2950
7909af8f-b674-422d-8112-b4f298e0914e,Commercial,0.8369257239430855,2,6,361,583,222,76.21447402199392,2392
20925148-828d-4bf0-89c9-2bc004842fb0,Healthcare,0.7453215075326601,18,5,150,1340,1190,75.28804901833571,1542
7dec1b03-efe9-484a-8924-21fe16a174e2,Commercial,0.39213723711220827,46,38,107,1387,1280,18.51597567942549,2540
71212fd3-0c63-41d9-a7b1-1749d2965670,Commercial,0.04403433927843847,4,33,233,1198,965,72.5857841215458,2617
21c770c2-558a-4f79-800f-530472c2ae7f,Commercial,0.5380822452722215,49,20,315,450,135,81.12197663017153,1382
2cd85074-d0a4-446c-a2e9-738b59d8677e,Residental,0.70934630907028,21,22,118,687,569,76.33796393940467,6044
e0092f47-6ec9-40ee-aa9e-76d32f2cf9cd,Educational,0.47247888902898705,47,42,349,1187,838,35.275127814317564,1727
fb05c44b-b6ee-49dd-b58c-eda5072e60ab,Educational,0.041180635398604615,23,48,151,1066,915,69.39404070197759,3612
7ca83100-7e39-44c7-8d12-8af796d191b6,Commercial,0.24868446251380405,19,21,118,1387,1269,84.89698183761979,4495
d0e4529e-b434-4217-9db7-fecde5bb4162,Educational,0.33332753440020224,37,5,242,1080,838,96.17003343183826,3673
2eba8d6c-64bf-4eeb-ae0f-140c1943846c,Residental,0.2942571070201524,37,50,526,1277,751,50.156281714329154,9429
49b88ad0-daab-462a-8264-93db6fe6d422,Residental,0.8641865023548619,30,20,214,304,90,78.47090419077621,1359
818b5536-8e12-44be-adf3-7eeda5e6f7b5,Healthcare,0.9367866802569685,38,27,395,940,545,58.829892781547684,5454
09d98fba-3f4d-4c18-96b5-d361979291c6,Healthcare,0.6532227996834387,32,43,86,153,67,68.6439048489673,1658
666a3e04-cb3d-4dd8-a267-66148ff0c869,Healthcare,0.6523321520911203,42,20,103,1369,1266,69.906919216734,2846
0c86cca7-d301-4542-b6fe-5e2be0901aca,Educational,0.8509160315140367,16,35,667,1007,340,91.52036171014414,6777
a001fa52-2bb5-44a9-ad1d-d5589c497ec4,Educational,0.702375864570978,42,43,479,931,452,32.58686536241542,5084
b86f523b-ded9-4ff5-8759-75ee20642c20,Residental,0.46744535548047594,45,19,429,747,318,54.720166859766685,4011
e5e1ad32-4843-4b72-80de-4978ad6e0eaf,Educational,0.45549575487643235,33,20,135,574,439,55.34552840482288,4344
fc4e8f7c-c06b-4253-8672-8fa3f6a9a306,Commercial,0.1183323312148663,43,40,620,967,347,61.80495675926908,7546
bff41fa7-dce8-4212-91c0-2c18eba09952,Healthcare,0.9459864069719008,15,24,321,1351,1030,36.23922631373618,4730
1396b3e1-53fe-4ef1-8b3a-435b37f5e699,Educational,0.6027761580591968,31,14,259,283,24,31.999030233443953,8671
e717276c-c8de-430c-a838-b920581dbacd,Commercial,0.33627379662562784,36,22,299,325,26,25.8858137961236,7761
b26156c5-daf2-476b-bea4-5412acbe2a51,Healthcare,0.401636558379894,30,29,407,1366,959,54.22113839392589,1949
47545bc1-6dda-4127-8591-0605ee922665,Residental,0.32353189813572625,38,10,40,1005,965,89.18807156822766,1347
7936e3b2-cd03-418d-bd6f-52b9754734ac,Commercial,0.8833516811938712,2,20,225,608,383,84.85265235492565,8308
dae78536-ed86-4e34-b6bd-9b49a2622ed1,Healthcare,0.13099277052996006,31,37,715,925,210,65.61834806504257,2963
a784c21a-2405-47b4-8437-e990eb8ec796,Educational,0.7792178458250316,4,4,159,1145,986,55.935222439514696,7392
54e26387-9df4-48b1-8321-720b4c468aea,Healthcare,0.5338061417346148,42,41,13,663,650,11.60894081271092,9125
4fe6f5ca-db60-47a2-afe5-14765f233503,Healthcare,0.9089551845807277,12,49,48,247,199,23.066579195929222,5295
827221c8-a99d-4cd4-a3c5-9b290544b2c8,Commercial,0.8010761520467695,30,7,406,941,535,42.96692702736697,4415
a94b289b-b600-404a-a4ed-1a8def936620,Healthcare,0.2961476037755244,37,8,625,1352,727,21.675557828062608,1002
fd7c3446-b815-4c07-a443-f47fa67de1a1,Educational,0.36420432583996254,3,39,239,467,228,28.988429861730236,2191
bbe1e53f-a303-4c1c-bcff-4a0e2feed61c,Commercial,0.36923360255027315,41,24,702,1202,500,13.166362742986646,8899
6d09a767-15cc-436f-ac0d-c8139c52e0e8,Commercial,0.10363979739910756,24,11,57,1379,1322,18.244769694805633,5946
2cd8285b-13f8-420f-9f7d-5634b8960eba,Residental,0.8702448551855057,4,37,426,1029,603,75.42958206563223,5630
ec162fc2-02fc-48bc-9f00-905a86079df8,Healthcare,0.6774720294808532,1,21,188,1035,847,19.90528177667065,3698
3498e57b-62ea-4dec-a5eb-8ed6a572232f,Commercial,0.4766621347079797,26,9,418,767,349,75.91069655430833,7419
23118eee-37a6-4167-aca0-39fea269bcca,Healthcare,0.08220023423229295,50,50,224,538,314,45.31055909328481,8287
37cfe89c-3f7e-4303-a9b7-6b2e71b45557,Educational,0.39238276601740574,15,47,81,756,675,97.45261214992304,5916
3bc6a065-fa8a-4705-ae58-d55b5d65becc,Healthcare,0.41557041219535185,44,16,412,1157,745,68.21165014618462,3516
35afaf55-f331-4ef8-88da-a97f2d703000,Educational,0.19597972889083304,23,14,261,522,261,31.850580290366196,8625
9babc6e5-2df1-4c3b-b7af-fab713eb7ed5,Healthcare,0.27367261440845625,45,44,286,771,485,64.25348806067981,2565
1028a579-5912-45fe-a81e-fbdf63a1b2d8,Healthcare,0.582856171966307,20,22,579,584,5,39.673582209468314,5663
8d77bd9f-6454-4013-a0ff-121c18c522ea,Healthcare,0.5270115447296307,14,36,133,594,461,41.79187323446696,7485
6977974d-737d-4bce-af3b-659750db7fe5,Healthcare,0.7128551695381825,10,25,163,197,34,47.830553905644834,6688
fa23d698-79fa-4290-8760-8f386ccac55d,Residental,0.7157499900181535,10,1,157,995,838,15.280070303284832,2984
db2b865d-5415-4553-9aa4-c6f7ea42b9eb,Residental,0.9271330859227301,36,38,554,1046,492,18.21942228996643,7951
20293a74-9aaf-4032-bc54-c5843f5570d4,Commercial,0.15043082617358938,38,14,506,1135,629,61.0104275043551,5132
3d918f5e-f6e9-4fd4-b2b0-3d19e9850f8d,Residental,0.8781003105014984,22,38,556,1340,784,97.03322166133486,8178
92ae1983-6bef-4e67-be46-858868528f5a,Healthcare,0.8768394096142993,33,46,674,1336,662,34.49087817164438,1068
203857eb-baa7-4c51-8b69-1a0d1818a8f1,Educational,0.5184337104800801,32,30,719,1208,489,88.47654535848783,8929
5f2d3849-dc30-4d98-89d2-c94e15908646,Healthcare,0.5844902042914203,46,20,69,963,894,60.996973168750706,7512
bf78ef73-8718-48b1-873e-0e93f3ec4f7a,Commercial,0.8453758201911437,16,39,294,1016,722,85.09224908620148,9967
bdc40111-7761-4b68-a570-c38add3f69fa,Residental,0.485554015766989,10,48,523,1071,548,36.353183038967025,3471
8aa9ebc9-5d01-4bf4-a2a9-bc5077cc42c9,Educational,0.04062909170193274,50,36,107,1353,1246,83.54559785678381,4347
a0acd608-52fd-4745-aedd-2a138b30646a,Healthcare,0.7537177572565145,16,45,507,610,103,73.37492164169349,9422
511f3660-a4e3-4333-af51-54d0e4454561,Residental,0.9358706484199757,16,31,30,1253,1223,39.441403936152945,7379
c89c09d3-c0d3-4ac6-8576-f9b8a86fad3e,Residental,0.35754804213323943,38,7,212,324,112,33.01251306010357,3630
299c7efc-8488-4dd8-8839-7d196ba6bfee,Educational,0.8927392634246016,37,43,107,1202,1095,97.8524654400828,2443
4120f40c-c171-4d9b-af8c-01542eb8f54b,Residental,0.7544911265988268,18,32,663,1366,703,57.38630765926542,2827
6e25bab9-5d70-4ea5-a542-f14db9e23929,Commercial,0.3428349781074894,4,30,488,1144,656,11.441680684770057,5771
70f32478-ff73-46a6-a4be-e999979c8751,Healthcare,0.5643717713510147,8,2,444,1394,950,86.09921530821597,2467
cd5cf26c-0675-41b3-94bc-1c515c1cc81c,Residental,0.5068554703459348,7,24,422,943,521,75.2049312648515,8815
216baf9d-c224-4109-b420-f9af8a25db61,Healthcare,0.958786455718469,27,21,635,640,5,49.40576384462788,2224
33c08350-9d66-4b40-82cb-341e344473ff,Commercial,0.42724034750035844,22,40,316,823,507,53.478584602390775,8347
e3aa2eec-883f-4415-8d35-4f89ab685603,Commercial,0.6592060389166681,40,15,257,1429,1172,88.01169537031063,3813
60269943-b63e-4305-9ffd-aeb3ada53286,Residental,0.48854895377724217,7,35,71,517,446,45.814942852052276,9307
ab6b6359-6d19-4548-bb71-a1fc1bec10cd,Residental,0.15571140380542725,38,5,466,1176,710,15.285767582169067,4719
a1418c22-e8aa-4375-96e5-ddc3b4429390,Healthcare,0.9260042649204203,3,6,281,1320,1039,56.75041205411269,1680
1fac0caf-c56d-4a21-9bd5-0c68979b1877,Healthcare,0.0028843294294468302,35,39,510,1064,554,65.01118700891645,2435
20d58be4-0afd-48b9-bcaf-f5092d4bf602,Residental,0.20707756793340282,7,48,499,744,245,14.827709045473792,1257
81bffea6-b13c-477a-80e6-fc48a8f2d52f,Educational,0.7402641149748,8,1,263,865,602,45.469960369556084,4571
628a705f-719d-4c31-bfad-86e3de197b66,Educational,0.5180665616071288,7,8,180,797,617,41.13645390890014,2701
15f6c987-29c7-4c9e-b3b5-105e9e61392b,Residental,0.9801676536874194,9,38,381,654,273,79.77524028069227,6971
00258237-42f5-4c3f-a635-4fc7817e4e54,Healthcare,0.6256026387111752,27,43,66,372,306,65.9208237535227,4196
d111632e-2938-4a74-aa4a-24b2ad1f9c6e,Healthcare,0.7902759172075833,18,43,485,507,22,74.3429707546918,5062
41dadbd9-2c9a-4a00-9569-516e33b2277c,Educational,0.686619585000413,23,11,431,879,448,43.65936083815363,2505
4be6c199-228c-4bfa-9eed-c2c1f246c806,Commercial,0.8924634781309271,10,11,530,1375,845,44.94837321096384,4875
65913fd0-f7a7-4197-ba13-cacfdd23d209,Commercial,0.610499822328089,47,31,9,1170,1161,77.68426837721493,7224
c29bfe54-87ba-4a5d-99a5-bcaa42ae3218,Educational,0.4268222300540133,30,9,303,1040,737,46.15996778600084,5911
cbfdab67-bb03-427c-a361-d78fcf93f10c,Educational,0.37101070472353215,18,11,626,770,144,12.004734205186267,2104
fa965217-2ea1-43f5-9608-25ee98c482b4,Commercial,0.19359088166805072,8,12,629,785,156,97.52976552198474,1414
d37316b7-88a9-4748-8418-2b1219ea0c32,Commercial,0.23033352006827446,28,50,556,1207,651,26.65641502236639,5277
0db0519c-a483-466f-a903-9826ac1d61d9,Commercial,0.6682652924128875,39,21,561,577,16,50.874860806503825,9931
9b25bc2b-baa0-4cad-88a3-c610f82da1b5,Educational,0.29510649017412705,42,3,290,1284,994,87.41143868158274,8279
2f4e6a15-d27b-41a1-91fb-a67c845afdee,Healthcare,0.864312044985795,45,49,196,528,332,15.789873761962598,3492
867e7f87-d3a9-445a-9e6d-5a2b63f44381,Educational,0.2627451495323644,22,48,609,969,360,33.84695733259342,6669
f7c5d03f-cc8d-43c3-9ba8-b823bddf2a85,Educational,0.7422494617142676,21,19,103,552,449,45.23601461041298,8592
b33b7a8d-f6dc-40a5-ade2-8e053855e6d5,Commercial,0.13196324803999726,50,14,121,1077,956,32.202561881634466,1321
9402c0c6-f88d-422b-b083-016c7c740410,Educational,0.09915816893583651,28,22,265,1027,762,39.27389651727917,2161
a86d16d9-012f-4dc9-91cd-2997ca4aa51e,Commercial,0.8366848358087381,43,48,326,551,225,62.99177290451117,7483
bc2de9a1-b267-4f09-b5e6-1c9c28ec1095,Commercial,0.5307465748319008,21,47,536,805,269,36.71661010763948,2541
3f1dfdc4-2a74-42c9-970d-49a2625ed971,Residental,0.21191171596679415,5,49,549,1402,853,94.12653518641527,4074
1009e53b-80c8-4a02-96c3-d3afec42acf5,Educational,0.06658392332004792,17,34,118,189,71,88.14134679481765,1687
cb73b902-b941-46d9-a9d9-eb79b532d107,Commercial,0.04838625347652303,37,15,529,1045,516,71.20347430292614,3916
41b4cb61-85b6-43d2-9baf-5025cfd7f6a1,Healthcare,0.39072641663442365,29,37,226,991,765,12.106118237080775,5977
37c9aa5f-640c-4ec2-ae95-93e5a33e0b91,Educational,0.6814299630502233,39,46,399,1139,740,50.82636549267772,5792
0ab8cc63-05b9-44d3-8cfe-11cfdd88d062,Educational,0.7027364924201668,20,24,38,321,283,11.466024801412257,2685
522aeb66-8efc-4802-b653-d5a98887e4af,Residental,0.46446156687137774,49,43,259,942,683,68.36154854944192,4743
e5c6b805-26fb-46de-ad1d-7dbe4b9a2c7a,Residental,0.09360796946374994,21,47,261,1311,1050,21.292864820674538,5469
1c12a427-8bcf-4192-9cd0-1236cb2df33e,Healthcare,0.3686640048034141,11,30,358,1156,798,65.86529950399014,9186
8ee8ca0e-0546-4a0d-b002-84c00c9aa3db,Educational,0.098432357747127,32,46,521,854,333,56.507008117605515,4446
f5602b19-dc50-4cb1-ab32-abeb76ab128c,Residental,0.7946762367037468,23,25,136,1014,878,35.9929270132949,5943
863c251c-388d-4c87-976f-73ab58055c1e,Educational,0.36599524336889355,40,47,86,892,806,32.46252427794569,6911
abd69085-7067-4e41-8452-4cc70dc7a5f6,Healthcare,0.9563829206730534,28,50,678,1054,376,28.92135706007775,1832
b87b50c8-a4d5-463e-a1f8-0de148531d15,Commercial,0.48852347012087927,19,33,87,891,804,19.956095761372648,8171
98411159-76d8-4a52-9f16-ac1f450743e3,Healthcare,0.9548184464913075,33,16,561,1076,515,63.32740533040819,4665
11dffb03-22aa-430e-b0a5-91b10b765f52,Healthcare,0.2840256224964802,9,23,201,1432,1231,95.18757405146717,1123
859e3f21-3ed3-4120-a485-cbff75db7f18,Educational,0.02160311039918117,47,24,375,704,329,53.616005369581764,5972
53dd76e1-bef2-44e6-8d80-124f2df29e66,Commercial,0.8127894098378621,48,16,215,1075,860,13.152620284456994,9727
43cd81ec-53b0-4d20-b914-a57fe772e4a3,Healthcare,0.9536109155440746,31,9,472,1300,828,44.83876078612482,2788
4804278d-f2dd-4190-9818-0ffe7774f6e7,Commercial,0.509633508381401,7,40,550,955,405,27.91329878702041,1830
cac8a7a1-7cb3-488e-a203-de9e8c96630e,Healthcare,0.10542562535729372,5,18,166,869,703,85.132803287,7088
6408bf67-d0eb-4236-976d-76c093516137,Healthcare,0.2651687498561647,36,27,555,976,421,89.20175878555952,5546
b4d9dcec-ea3d-49aa-9e07-5032ad31391b,Healthcare,0.22463825763662693,32,31,20,519,499,34.067627811192764,7930
cc82bb98-4393-48ae-af06-716b15d93dcf,Commercial,0.765482744801873,14,7,83,445,362,18.57993486223976,3223
3fd3fe52-5150-41e1-96f0-d08cb216a3e4,Healthcare,0.33668784987965594,25,8,415,651,236,51.771652387530196,2288
10b92011-6f26-440b-b8a3-91ad27fb368c,Commercial,0.36479266292719537,16,23,133,898,765,27.97382584751994,9360
bbc494ad-4ca3-458e-94eb-24e41d4d57c9,Residental,0.5915407604994825,36,14,439,469,30,31.00183245673052,7790
5f38b744-4243-44dd-833c-f350e6b3932c,Healthcare,0.4580679523954243,26,45,546,1371,825,68.58316480184284,7137
46535373-17d2-41ce-9a3b-5ede159edd9f,Residental,0.004437840059124953,21,30,294,845,551,35.88990675265772,8363
ae4a179a-c39a-4a9e-a468-612b16f741bb,Healthcare,0.20048828333233892,17,44,66,1281,1215,55.00730131482479,8244
bfddd681-48e1-46d7-8170-f12e0ec576b7,Educational,0.5552458983341043,22,13,677,1081,404,39.17606156164467,4877
e79a26fb-db15-4bf9-a72a-138ed205bbe4,Commercial,0.6392838654597334,12,15,355,1329,974,29.965708604494402,3061
78b20369-b4df-426c-afbb-e4c40c7b1147,Residental,0.11690042909334275,19,50,676,1055,379,18.374238086777936,2580
3f6d2f32-6781-4035-84e9-b8fedc7cd149,Educational,0.35366979378206653,33,48,311,1066,755,10.726986046694456,8809
d642e36b-ac1e-45e3-8646-83a93412489a,Commercial,0.8139249235073368,16,32,466,980,514,71.18139517032903,7354
1aa710e0-12ed-452c-858a-f449def78343,Commercial,0.5456804014622159,23,19,376,1041,665,75.76906180732539,5264
6f83a0ab-6bcf-443a-9937-e25aa691644b,Educational,0.32881650196660284,8,5,283,628,345,35.79841607758799,8269
2b1a70d3-bb2a-49d1-b923-9cfecff86c14,Commercial,0.2577598257110343,18,23,113,567,454,86.50446523620923,5763
2b63e527-4a8b-4556-b269-2bbf3e566700,Healthcare,0.5092817552647113,11,28,617,635,18,49.13836446448944,3921
9b6dba85-5062-414f-899a-a3421c7be62a,Residental,0.006339184707065515,21,19,605,1260,655,70.36411795082377,8586
2a431eaa-8a81-47bb-93bf-6bc27e87a7d9,Educational,0.5331618067231914,36,47,244,1224,980,33.2692796753263,4969
93c79d8e-c2b9-4f57-9827-93efce8fa8a1,Residental,0.8466761837087398,44,29,591,1125,534,71.6794374846395,9373
a5929012-4ff0-4953-80e2-de04f3ed23be,Healthcare,0.96954215991599,19,9,167,820,653,79.38841667613376,7105
9e243492-b836-4670-b268-4b8262aa59ff,Commercial,0.860177178076044,29,12,354,484,130,22.667251647764225,1440
a5a46529-35e1-4d57-8fc1-bfd7d7a2ef55,Healthcare,0.5024697494339846,8,13,37,896,859,32.47521937128718,6084
c6f2563c-a3cd-4ae0-a50a-75e0d5f279e9,Residental,0.0550955031115663,25,27,155,673,518,82.36478145157174,4587
3e4bf942-b29b-48ae-b4dc-0bff778cc69e,Residental,0.03317935957856055,36,40,15,1354,1339,53.789103538841005,5087
580bed8d-4cbf-4afe-8e0e-3660c90c8fda,Residental,0.2308968128016856,20,35,131,565,434,82.22888700842566,3816
58c4e164-7c71-46f5-aa14-aecab37c8c4d,Commercial,0.8364719783707253,45,27,250,637,387,50.17056445057524,5188
253acf4f-d50c-4268-93b6-14d94c24dc93,Residental,0.9101345074588665,4,10,719,857,138,70.64574496669331,4313
f309ea49-3cfc-4d94-8a52-287b9f1e4c34,Commercial,0.6860616337167252,28,27,226,1369,1143,94.5102342707751,2697
912692f6-0653-412b-8f8f-143b3f8ef568,Commercial,0.10148630374828504,29,36,108,1370,1262,89.14565690121086,7051
c508f943-d495-4d87-9ec6-44c31d802dc3,Educational,0.3186776904579367,49,28,64,908,844,52.09726311722849,6565
388a4c5f-0188-485b-99ab-b506c9e3f424,Commercial,0.9962827852425811,12,29,655,827,172,40.52587883520555,9680
2eed596e-8015-47a8-ae84-d3357d2d11cf,Commercial,0.18975990804315157,11,16,638,1101,463,24.277846591744606,1106
a176bf9b-1557-412f-a79f-c0e159ac4ea9,Commercial,0.13239883923542206,23,31,232,1041,809,48.202987603144535,7087
cb0036ee-c9db-4e06-9bc9-a8a46cd47a62,Healthcare,0.37648245314512463,9,38,43,160,117,58.42127959514497,2626
c7041b8d-9c48-4b81-9746-fb3285a698b9,Commercial,0.5414301779308234,7,16,146,1327,1181,64.43484727375457,4478
67cb39a5-869c-4d69-b189-95795415ac2f,Healthcare,0.12275762474279106,45,30,246,645,399,34.533642045536425,8963
c5d6fb70-0b07-4f4c-ba26-d44372cdc7e9,Residental,0.4192537799540611,9,14,506,1187,681,27.067516885308173,8072
cf06e217-9edf-4b71-a3c3-e0362acdcb0d,Educational,0.8933350563647371,23,40,120,1328,1208,32.54054066575567,4262
e46a4a90-2792-44ac-b054-df865c97abc8,Residental,0.25409529562597977,1,7,424,1178,754,54.98025532616547,2110
14b2dcc7-0dc4-4a64-bc5e-5b70746c52b6,Healthcare,0.9220385902567991,48,47,362,1356,994,74.45571846739622,2859
bbf9ef3c-d8e0-44e7-99cb-3ed3efa3d092,Residental,0.9686906997987268,21,19,404,1440,1036,21.199161782495857,9727
07a82c45-3831-4e50-8332-ed37114726bf,Commercial,0.4306051094978993,40,26,537,688,151,47.72144849998097,9037
6e177868-2a97-4888-8989-cf5fc7abb85b,Educational,0.664000181572443,4,28,557,599,42,71.16917279500734,5433
a114d74a-239b-49ba-87bd-539bcb19098a,Educational,0.3350388922942934,11,29,660,664,4,55.2656611219544,4667
4cf8fe3b-7aeb-4abd-899c-fd65f6c4d38e,Residental,0.3898747571071729,42,17,155,190,35,22.393386818074497,2794
ad5fc895-7f92-4a9a-a559-9afccab8e46f,Educational,0.923323834623291,38,24,693,864,171,85.96561765027663,8188
2e482823-1999-405b-b66b-30b98ddf9aa4,Educational,0.5075674373666393,45,42,12,30,18,75.31770223873414,7347
4af1d159-d216-44fa-aec4-62f7820cab5a,Commercial,0.6953564113363357,9,32,237,584,347,46.58064668421811,7637
941f91d0-15a7-4a6f-b198-559a3e733655,Residental,0.3569264949091757,49,38,463,722,259,88.71399001665878,6069
15903082-baa9-4ac6-bc15-cf045190f4fa,Residental,0.24091241152832266,1,44,302,947,645,15.73528519631025,7404
2598974d-b823-4ae2-bbda-f8a085c06691,Healthcare,0.467213847793982,31,25,113,403,290,19.185908278272862,9980
e2a450bd-90f5-4bf4-a892-5df842ea60d2,Residental,0.6852162451865229,17,20,521,647,126,71.03484876148697,9976
22f43aa2-ded9-4ee0-b24c-a82c73eddae2,Residental,0.5652232950072625,32,18,591,1297,706,13.533651021894777,6383
97e3a21e-89dc-4f27-8e4f-5e78989d406c,Healthcare,0.37942555557745594,15,25,393,718,325,15.121211296595586,7705
791f1c4f-f8a3-4425-9273-c082ca9271f5,Residental,0.43798137194168496,15,5,612,1373,761,24.930158780365446,2469
76906bae-086c-41e9-9c07-34161fff9ff8,Educational,0.3994254940996438,5,5,33,1289,1256,31.915141997658317,1958
52092f6c-a407-4adb-b7d7-c367b6597670,Commercial,0.40760095945563946,47,6,299,895,596,93.23236809954743,9131
b5cd5f2d-a87f-4906-b862-6261b300ddda,Healthcare,0.7826613216671401,2,12,609,872,263,54.9754786310182,4176
d0569d2a-35f1-4750-8493-fef91ac21253,Educational,0.9446637227827708,32,49,239,857,618,14.649567415455213,1821
5307a031-a3a7-4353-9f90-a1bc98feda2c,Residental,0.6161130539164059,10,50,472,1194,722,48.73021246044267,9002
5f36e3a5-abcf-46db-88d8-267a46f1d075,Educational,0.5140802281821496,2,47,385,1276,891,67.43404056822502,2301
877a198d-7e5e-45df-b1d1-f25925b25389,Residental,0.20539551543141332,7,44,335,1222,887,68.56177146177995,3287
c89d5a00-db00-4d92-96fb-7b964c8215ce,Educational,0.797252860656,33,9,501,1301,800,58.833308516131545,1084
c14f390e-68cc-4e99-84c2-9301652ec955,Commercial,0.509206748332943,42,28,99,500,401,43.7664142728392,9234
23911719-adac-415c-ba14-f220b5c33a81,Commercial,0.840100097996125,16,12,75,1104,1029,83.102754025058,1936
233b27be-add3-4b97-92ff-80cf616ae573,Educational,0.017559367536512216,18,20,94,438,344,52.617186057815154,7734
c394bbda-ccb5-47a6-b9df-a62201c34fe1,Commercial,0.4092256745465842,45,50,277,1356,1079,67.68529984561826,4487
8e392e06-c0bb-4032-8f47-14df71f234e6,Educational,0.37635271500436607,24,35,513,576,63,21.287399983433456,4771
ccd51fdb-e55b-4fde-93e0-f53c2c362914,Commercial,0.4085323983649678,23,27,159,274,115,69.82924599282529,6185
9f480a32-0f89-45d7-b658-0d1e94dff4d8,Commercial,0.009676464158889897,37,7,648,1248,600,50.60970185334227,2092
d74473da-77a0-443b-b8f4-bb9a50aab44b,Educational,0.5165989154905283,10,21,296,669,373,78.20798909633386,3393
94bea42e-6de4-46de-8a5f-a29fbd57a0c0,Healthcare,0.7121014856371212,10,45,626,1391,765,49.50271190470676,2766
7f594970-4452-4370-810f-7650651389d6,Commercial,0.7556823739199179,23,1,426,1437,1011,98.2568124191415,6643
5724c54b-f6bf-494f-8101-e35a0be4ad6c,Healthcare,0.40540753986710676,38,32,165,707,542,58.11044423734431,7884
a71bb9be-07b2-4a62-9ddd-e416575d4b9e,Educational,0.2304068009618372,36,3,617,983,366,62.360216826278176,5085
ee3f104b-0aea-4f15-8b74-569ebf1a7c87,Educational,0.7233031035975274,29,27,420,435,15,17.08576533268746,8907
cd4d9372-3215-4eb6-945f-72b9abb03752,Residental,0.9000537724317834,13,24,591,732,141,84.70912541101362,1467
2b36d97e-eb90-4144-a2ca-b11f96fdae6b,Commercial,0.49706683343777125,18,15,145,369,224,24.102530265525466,2778
c8fb9997-8bee-481f-9b61-6ec7d3196fa3,Commercial,0.5438266020393324,39,42,621,916,295,29.293462957517963,1676
a7e52a71-6470-4d57-a929-f4c1ef64f477,Healthcare,0.37455611569011094,4,34,382,511,129,93.48690728596684,3104
f89b0471-af06-4afe-809c-a630373bc360,Healthcare,0.07088940389736498,47,3,388,687,299,67.83368536784175,1446
dca67df8-c4eb-4f4e-851b-d1e6a1916881,Commercial,0.4391337884868324,6,35,131,1421,1290,49.98000536810106,4832
b90eae26-af91-410d-a4f2-0d63c0b2281d,Residental,0.9912750939571744,14,17,355,1066,711,29.00084073998791,9101
4de7b026-b710-403b-a0be-6520b10bb48f,Commercial,0.21424304700658325,15,1,571,1149,578,34.08360395733628,4563
1c5bc5eb-d81d-421b-9f34-9e10a6e8abfc,Residental,0.7405042246799386,33,8,620,1020,400,28.037597763137356,8226
3e5c2be2-1866-4cd3-a54e-92696688b7e4,Residental,0.38335620333224263,5,46,397,435,38,66.65231370641739,3331
3bb18e90-72f9-4749-b04c-f844d94920f3,Healthcare,0.5772747346673203,27,28,253,1418,1165,46.7338552689621,1541
b45d23d1-fb5c-40fb-8ffc-aa7accf47259,Healthcare,0.3122400097175615,34,2,408,981,573,93.2233777299595,6561
dd1a8132-6e29-49c4-82ac-1519e1aa817e,Healthcare,0.5940010936643991,11,4,494,930,436,47.086829183426346,6063
6c029d32-24a1-49ca-b833-aa1d0a7522f8,Educational,0.4496136103041283,36,12,440,1317,877,96.1780096800192,1028
1d1b0cb4-d2d8-48e2-8533-473bd8f1a242,Residental,0.38190355725707437,27,38,62,988,926,24.588591683040978,8901
79591e86-46cd-40a0-831a-78879c790d6c,Educational,0.2963888029870182,37,5,99,862,763,15.043741390442422,8803
59819c68-753f-4dc1-9cb9-26f82b751f6b,Educational,0.46060740616757356,43,27,628,659,31,24.497779941385986,2307
bbfd806a-8d4c-4fa8-913e-79a10b0b70d7,Healthcare,0.2431579285509453,34,11,588,619,31,69.60270864838981,6365
15cf2834-0f6b-48a3-8c86-f034cc73db12,Healthcare,0.5019073225741134,28,14,369,912,543,40.74797931217496,9077
6811fbf8-3c39-4c17-86ba-d6b4052fe48d,Residental,0.36406093305975673,22,34,695,928,233,81.03203007637384,8433
5314fd40-0e49-4eff-95e0-d1c28e244269,Commercial,0.10023280279681013,34,19,449,659,210,54.98669319996826,2695
74737fd5-38e8-4364-b17f-647a7b0868c7,Educational,0.2670508470406868,13,35,80,623,543,77.67080210776665,5381
4029f167-6430-48f2-a694-c5e939c58b0a,Commercial,0.5343930388920788,25,2,539,1220,681,32.84206956082023,5062
590ceac3-4429-4f07-9df9-3229ad0f41f0,Educational,0.50944942142629,14,26,3,552,549,72.57648880039048,4754
5774dff7-ad21-4d08-826f-54874fb4716b,Commercial,0.19794731636226315,40,16,650,838,188,16.931578905394513,7234
38df6e3a-5005-4b93-86e2-dc5865a319f6,Commercial,0.08246049167280489,4,45,405,1328,923,56.13311268832438,4315
d4dee032-c701-401e-9192-10c8244f140e,Healthcare,0.4641009735911523,8,41,591,1196,605,77.32607406649969,6629
83553e2b-f9cf-46ce-9387-db5a8abe51d3,Healthcare,0.4274273116539049,17,27,196,1309,1113,50.094674019118344,3893
9ad996f9-4835-4a07-990b-de3300c2809f,Healthcare,0.3187623085259783,19,11,606,1240,634,87.46407300767518,2432
4089a77b-a5e6-4f00-ba50-d5c500585ac0,Residental,0.8214401157385984,9,44,629,1110,481,13.74971173208456,2918
fffbc3cd-929f-446b-be8c-07e09c9ca411,Commercial,0.7911972722611392,47,7,234,1098,864,10.641824206385383,9234
dc7cfbac-2225-4f8b-a54a-9b5d2c3ab9ce,Residental,0.7134235287342575,11,48,588,1156,568,52.88254781653302,5437
5add1342-ee41-4fdb-88d4-f273759d0867,Healthcare,0.14964541585125268,16,4,378,472,94,35.1797058104718,7330
cd4161da-a8fa-4c26-94a8-337ef86da815,Commercial,0.9440855759793636,19,44,335,837,502,87.703658397488,6221
9f795872-8e55-4832-8afa-c5e025d1efbb,Healthcare,0.5529188846181092,37,27,307,532,225,58.71008757748525,5336
2fc52bcf-89e8-46d8-bf49-eb2b748577cb,Commercial,0.6097035896882407,10,22,662,1148,486,93.02587370122646,4333
1fabeb56-49b3-42f6-b4e8-3e1eaae66797,Residental,0.8458461558556236,19,7,708,1312,604,21.36513336167036,6055
fe49857e-acc2-4230-bb78-f5aa28204c3e,Educational,0.2364477161886539,5,26,712,1025,313,28.478635544135038,4372
dceab10c-314d-48e9-a9dd-ae38e2b666cd,Commercial,0.2792312223001989,2,41,264,372,108,29.028936779569232,3525
12a661a2-88c6-4542-a4a5-68d3a288546b,Educational,0.23001008141422263,22,11,711,1343,632,89.29913411221509,3952
312d0b17-2600-4dca-95a5-eb77c7a596d4,Commercial,0.40408948925322496,24,19,509,1372,863,82.6758145020133,4156
849d17df-6c07-4397-b992-fda80cb75476,Educational,0.30120913802555305,4,7,148,1370,1222,84.80522795924742,9561
f50d5ec0-4841-4853-bc5d-0fb74e5f0ab6,Educational,0.9356810907300058,16,16,686,844,158,91.7842923235233,5064
c93f1ae0-2578-4926-996b-b562bcd7171d,Commercial,0.4439320566924161,46,21,635,1389,754,25.74728837158991,1471
febd20e2-ba1e-43fc-88db-843e293d8cf1,Residental,0.1637453810963002,36,8,342,688,346,25.47478202026491,2578
085966e9-8be3-451c-892e-1eefb26e54b4,Commercial,0.5309123925650016,22,26,293,909,616,10.12064370580046,4269
d481b110-de4b-4bfd-82f8-113b629d1119,Commercial,0.42479659598112607,26,30,50,416,366,48.941223889299096,9568
457da2b9-c392-4568-8582-22f034546b06,Healthcare,0.6939251332889473,14,12,11,911,900,55.47243029014401,6006
463b3e38-5be4-4352-baa2-883a998e5200,Healthcare,0.9939578924145294,45,4,544,858,314,73.62994716231626,5577
f60965ee-e942-4322-a69c-d0f8b22b326c,Educational,0.3888634717883387,22,40,215,1055,840,61.49263208176631,9086
bc6dc14d-c148-4a71-bea5-307933754125,Healthcare,0.7907066645549783,39,47,204,317,113,29.196614716154826,3614
db99cef2-0d2f-406f-8e29-ffc863bac3dd,Commercial,0.86552527702565,17,13,25,126,101,61.67151582598025,5298
f834b5ac-7d29-46b4-8458-1c99edb32220,Educational,0.3866874460460451,10,24,461,1092,631,39.2038965576853,7299
0189c3ac-579e-4080-ba10-aaa162a75d0c,Commercial,0.3245451139563027,39,17,549,1279,730,71.33034410961547,8989
588550d0-d71a-4eea-b6c1-9c37357cad83,Commercial,0.19656892859073816,30,3,530,635,105,94.72065525804675,1573
0ebef7c1-fc37-40b9-97eb-4024d4dcfb4d,Residental,0.5059908946063998,42,6,522,612,90,19.576723400439583,7640
ef73ec3d-4586-424a-999c-88578c0beebe,Educational,0.006395943915762925,48,15,382,1071,689,33.53150968329345,5232
b40fcee3-63f8-4509-b75d-9a43b2314c74,Commercial,0.4850919450838128,10,3,32,209,177,69.72261465194167,6658
66720569-e1c4-4c7c-a8ea-1440ade16041,Residental,0.4148187650740651,36,34,90,216,126,65.19029047143346,4791
b110fb56-2f51-4c81-bc48-9384ab975a24,Healthcare,0.4111885915834461,7,48,627,1369,742,25.984043671428513,2122
8c17b0ed-58b4-47f4-b4f4-9b1b51f270d7,Healthcare,0.8288999541831055,38,18,379,1440,1061,12.914854314442124,7445
89e15e7c-d5d4-490f-9de6-4ca1ad8bc6e9,Commercial,0.14320414083297361,15,25,214,312,98,34.66825716605382,2093
c038e390-4f5f-46a6-ab0b-56e6c4d791a8,Commercial,0.9928515117738974,45,25,69,1149,1080,84.17872633047415,7296
aecafae1-55d4-45c0-a7bb-69a6dad5938b,Healthcare,0.5350877568536421,35,2,402,429,27,54.98817544231317,1855
4136e635-63f3-4c06-9b63-2ccfee768ef2,Healthcare,0.31296104058439034,31,47,363,1002,639,97.1244018235563,2364
4e197b0d-8d67-4c34-abfc-7266369f7adf,Residental,0.8461648541254406,48,8,567,784,217,70.17986765102764,5705
05e2c92e-21a4-46db-ab04-55c4cd805cf4,Educational,0.8827943453142757,28,2,426,1209,783,27.989169693075716,6548
96dd2a1e-b58d-400e-959e-1ba2e2cabc81,Healthcare,0.8018693496873991,31,37,444,1062,618,59.54299806013101,2694
8796a51c-4012-45c6-a8c4-6546686a7d9c,Healthcare,0.4717598352424973,38,13,372,1281,909,57.863609953590725,3427
7eed4c2b-9471-420f-9ca8-044f2bdd3212,Healthcare,0.810133779968702,16,28,564,729,165,70.7524446950388,8539
84a75862-ea77-42ee-bad5-3afd9867b5c0,Residental,0.014087851482129765,46,11,418,984,566,31.64628205723327,2893
9b42c966-89dc-4955-b83f-5c5c70a7707b,Educational,0.45854290457929703,3,17,262,347,85,67.65767346712161,8239
d226ce5b-3669-43fc-87bf-17de956bed1d,Residental,0.5402353417139043,40,29,622,705,83,39.804442869842376,1889
88622b95-1cfe-4683-a21e-56c82bcdaa74,Residental,0.07841717428340078,21,35,573,692,119,81.23875010617586,5136
cdeed3fe-27eb-4d71-9542-284770f92974,Healthcare,0.5695523507776251,49,34,701,1269,568,74.5140925788786,8452
8cf77b29-a434-4b2a-ab28-16dc3d35b85e,Educational,0.7297767170152053,36,30,539,1402,863,11.234051457813552,4870
b9ab585a-d386-4c1e-be06-88cdc6668d10,Educational,0.7598489695542291,5,25,375,731,356,52.47662957394378,3817
eccd749f-1e6b-4980-9133-69f02f1de384,Healthcare,0.7191992018882484,13,40,567,1120,553,84.53597146476504,9804
cb044eea-088f-42b8-82eb-ecf9bcfad9c9,Healthcare,0.2913853820437585,45,6,604,1166,562,11.326298668613795,1116
8107d44b-d568-40e4-b96f-796ea3273fef,Educational,0.018955622491056756,20,30,482,1252,770,20.564893112480174,7996
516729d0-dc5a-4de2-ace0-0c8d8d663d91,Educational,0.3649085937303288,20,18,133,152,19,55.28241705719168,3787
2d9d7972-7b60-4f37-81f0-1d816cdb0012,Healthcare,0.4336440821215992,2,13,324,738,414,42.22539170130889,8630
84cadf87-9e96-4500-9651-70c0de2cafe0,Residental,0.8548603704333854,35,48,666,1002,336,84.21014711877808,4309
cbd2b8b7-e241-45e2-8a0c-972bf8e05e3f,Commercial,0.5034031495117424,34,17,324,742,418,59.26681870864844,9960
b569116f-845d-4947-bdf6-63d501985658,Residental,0.7425569334495239,31,16,645,737,92,99.51858698672314,6427
bdfb6c68-06fd-4e22-a24d-f5af1e57742e,Commercial,0.5815375138414369,47,41,600,1248,648,28.218197888031547,7833
eb9b6e50-4ea5-4e81-a2e5-3107cfdc7068,Commercial,0.3218526476318555,12,13,26,995,969,72.59545648640685,8063
0b8eb647-7821-4f89-9fc7-95b473733afa,Residental,0.35388178298960726,43,41,446,1091,645,46.41840468025056,4786
e0e157a9-753f-48f7-9021-bf2b724a4b88,Residental,0.8024822492038374,41,25,367,380,13,52.564003122274556,4405
589744ad-9aa5-4457-8bb1-dd6d50440267,Commercial,0.5979281219742602,31,35,198,737,539,68.26778701690688,7245
cb2dce85-813c-491f-a90e-7d1737329dae,Healthcare,0.7672557856619779,3,46,204,1414,1210,57.39192355769424,3685
daba1317-ebb1-45d0-8ae9-120e6eda6442,Residental,0.9116850415716651,25,5,597,745,148,49.491439837583535,9054
624df494-39f9-4b8b-b757-25618551dcb2,Commercial,0.4962304441592117,29,24,402,827,425,55.25645171380366,6492
13dbe382-4239-42c9-b5f9-df16c698831b,Commercial,0.9924855534535494,21,11,115,580,465,75.62271913716113,8265
aee02801-1b1c-4648-b8f8-e958d7102836,Residental,0.31997202874835784,17,5,534,610,76,86.25486757164315,3796
f32f0c09-92a0-4fd3-9ea6-89507a4956fe,Healthcare,0.38424345120824765,29,23,210,318,108,29.699412541575438,3752
be3a22d4-179c-4992-8882-92ed3132b818,Residental,0.24758790169285583,44,6,617,1119,502,63.55990782411123,9887
694829c9-aa9d-497a-b52a-e78fc6eefcc0,Residental,0.9199656178888312,20,35,219,515,296,13.467088766704837,4054
92d5689b-409e-4be2-be65-c950c390b3f2,Educational,0.26734484463680663,5,7,658,708,50,46.640913895260354,2925
5928186f-3303-4e41-b80d-615c6b2db204,Residental,0.3486536934648701,48,9,375,1352,977,66.04069053431945,7265
478808ec-168e-4676-b76f-3ed0a710c3b0,Commercial,0.17384590678407696,36,4,517,756,239,47.87034911797073,2208
25aa4145-4d0b-4f12-b8ad-5567ef724299,Commercial,0.5655419740989095,18,49,661,1286,625,50.49997223016877,5087
d26d212a-0b79-4dcd-809e-3df79636fc17,Residental,0.922329336311869,50,40,456,1288,832,75.0397914165189,2438
8b23040b-ffa2-4b87-95fe-722f0db991ee,Commercial,0.6480556773636543,17,7,250,371,121,44.12959187537956,9941
1e513e67-e3d4-424a-8392-d0b702fa5b22,Healthcare,0.09614915569933491,47,11,549,1066,517,20.586450516146176,4274
43855284-2a89-46b1-a833-c37e9f9dc173,Residental,0.5614955040335694,11,38,320,1326,1006,85.22984149882687,4090
1652c208-25cf-4425-b401-adcb61124072,Educational,0.1751909511460038,31,6,475,988,513,81.9445322422989,5374
b6d83d68-6d1c-4133-9f87-a619b7720b16,Educational,0.8903927761586956,47,17,309,379,70,86.76204282055329,3957
b6e3326e-60db-4cb6-9bb3-00a50ac78e2a,Residental,0.4839353064525118,16,44,289,299,10,12.776448718301125,7380
9b029e78-0368-40fc-8dae-22e5ab2fd33b,Commercial,0.8727124206482646,47,16,356,1160,804,25.945501307362335,2290
2cce190e-b52e-4afe-8136-ad4718264a7f,Educational,0.9755933225173082,34,35,566,834,268,83.98617819461039,1873
2ef1b3a6-9f12-46cb-af76-855fd0e1c0b6,Commercial,0.3754302313911968,30,27,107,1295,1188,39.17016061289274,6573
a5be1fd7-b6bf-4b98-b353-3c8bb2f24682,Healthcare,0.10184432383005493,34,38,66,210,144,26.157006768673305,7634
0ab032b7-1ea2-49c4-848f-ab8a125f4bc8,Commercial,0.864111257276203,49,42,391,1389,998,19.06306208281815,1652
71a0eb27-0272-4ffa-a269-9aed3d87dfd4,Residental,0.855534861957284,19,24,301,353,52,64.89368121846232,4856
1d9d0c5b-24e1-448b-bcee-794d6504be02,Residental,0.9618190758417322,29,24,447,865,418,61.97441837542949,4750
da156655-05b6-4ca0-bfed-9c0446a68924,Commercial,0.8738714407982159,33,12,183,535,352,99.05686305445845,1028
d502f1a3-7e24-466f-8da8-082de0e8cbbb,Healthcare,0.9991878093750018,33,31,536,692,156,26.895280892070364,4801
68da4e46-a29c-4d63-94b8-9fd2658ecdaa,Educational,0.7305596328886594,1,29,583,1116,533,43.62942311972619,4333
c530f764-afbb-496a-8f8f-b47df13f0c04,Healthcare,0.5846231621533762,31,40,561,729,168,57.07546386549646,6273
da8c0cb5-45b8-40a6-8aad-8590a47ad2bb,Commercial,0.12352735526167402,35,36,262,467,205,61.74019663969142,2397
e15b2e04-cfb9-4242-992f-86f51bfebd7a,Educational,0.9684287090079123,49,21,13,132,119,33.220280540169085,4644
43a40c76-b7f6-47a1-a0f5-06ee464dcd0c,Healthcare,0.6660142317930435,14,36,239,1400,1161,73.07755843207893,7903
e16519d5-e2aa-401a-af7d-8e5cc3badcf4,Commercial,0.9086831349114829,38,36,178,972,794,88.8030792639185,8839
e14ce0bc-7f5a-404c-addb-dfc83bc47b7a,Educational,0.7225421865969563,23,8,447,991,544,16.818856032542794,4075
ddc7ad1a-66dc-4751-ac90-c9e127171f27,Educational,0.9905312631854164,37,41,535,1419,884,37.58293014217421,2622
b334db08-acad-4723-9543-dff9f88614d2,Educational,0.4714388877956269,7,34,458,621,163,22.891722080022006,8353
4919919f-3361-402a-ab43-197f7d27c1d4,Residental,0.025821921228894373,26,11,445,799,354,78.42139833101486,9118
33bec996-c2be-4972-b895-24901ad51555,Educational,0.026451746302856294,30,28,498,1394,896,23.080894530434833,9048
5a1c3eb2-3613-482f-ab8f-881d3768a8ae,Residental,0.07473024422775443,49,20,208,634,426,95.40545104041361,8402
5f36a39c-42e5-47ca-a986-e1c6f141b663,Educational,0.303190726449312,19,11,169,187,18,52.90160891257001,3823
68041f39-c9b7-4bb3-8795-688e372ddd7d,Educational,0.43846279191046045,38,18,233,1376,1143,98.86542254595395,2714
b68ea144-4ba9-4f42-9044-84e253c4c694,Commercial,0.06866114384105548,23,3,158,1349,1191,42.5610906576136,6930
e4f1bef1-ce96-4341-951b-d9ff4616c66d,Educational,0.297266146976218,30,15,395,850,455,93.23004820517984,6156
f22ef5bc-a579-49ce-acdf-a2eb7c1b215f,Healthcare,0.7286658327863837,45,18,420,642,222,26.22952988739161,2917
ad81f084-dc5c-430a-9887-48a34af6f535,Healthcare,0.04142945962458977,8,11,269,1343,1074,56.81107573710288,9519
7a057e95-04d0-4e48-8536-62037c04d122,Residental,0.0048654896675502934,40,2,615,1407,792,67.11648913070373,2930
ad9125b5-ff10-4f3c-997a-e772ec3ad006,Commercial,0.9956140942855588,5,14,440,1004,564,36.340389518172444,7105
4656e684-65d1-4b1f-b67f-b9ebe1096e72,Educational,0.16662732747747544,6,17,642,736,94,41.222637800794615,8655
71d7902d-a942-4041-bd65-bbcf5a52123b,Residental,0.103642928426122,1,40,345,1360,1015,73.84835881314868,8767
39c988fd-54b8-46cf-be62-69de783b4cd2,Educational,0.5773160511392182,11,5,297,1304,1007,13.923996036978876,4074
df2d6878-eb11-400f-8963-c4707a3a0521,Healthcare,0.5884017782036453,4,50,195,417,222,61.01683434588794,9922
a1d2824b-2380-4d7c-95ef-dde7ae2bbdf9,Commercial,0.2598808308869537,19,47,619,876,257,43.34059935313938,2329
e4b6c893-da31-4e08-be44-50f4e58dd52b,Healthcare,0.6344103948249334,39,38,518,866,348,92.29382681104344,8995
b75f5a4b-b6e7-46fa-be09-2a62d52d65fa,Commercial,0.9321633524868007,43,49,6,408,402,20.950172970794732,6082
b6903f71-7143-42ba-a734-cd1f9452d02f,Healthcare,0.7977565281248723,46,4,671,846,175,38.277453267779805,2630
484aefff-6e9e-4b28-b999-a302e038c625,Commercial,0.9497919699411793,40,37,17,345,328,38.94218391969012,7592
81a2d499-30c6-4540-8045-3bed94e10106,Commercial,0.42892567479476706,21,48,228,523,295,23.893010834521547,5468
64da63a6-2da2-4936-8c1c-f0eb64a32c56,Healthcare,0.018753609095762735,23,2,720,1194,474,17.075418717381254,8714
91e9b831-4850-4d3a-9221-4de0cdff5b76,Educational,0.8028427523470959,9,41,470,667,197,92.00623577322486,4417
0bc7e7ce-1003-4435-b6de-05c6ff0d5ccf,Residental,0.22962846111926682,46,15,299,356,57,45.31152336996579,4081
396436db-229c-4294-be4e-98600ca58364,Healthcare,0.9415093341065838,46,35,333,648,315,52.7648649243276,9844
fba44ffb-efce-45c4-9561-c288e9e51824,Residental,0.7287003753480533,29,46,193,678,485,96.46694632720693,6420
ccd61c42-2b3d-4788-a324-0ef145439c86,Residental,0.11148508451768258,11,31,118,624,506,97.29182376432576,5506
af6d3162-f43c-4119-9955-368226b726bf,Healthcare,0.6827810699153978,4,19,52,94,42,23.248128748272784,2956
fa9b54a6-9624-4651-8ff0-4af4eb483ea0,Healthcare,0.5369888675614641,37,12,384,1133,749,94.15443522122618,8429
1b6b5e67-b185-423b-9ddb-10f63e422892,Educational,0.6928069268774781,1,38,437,491,54,78.14874206011827,1779
c943395a-ba38-43fa-80df-b9b5e8ad2232,Commercial,0.25948700984303164,33,43,56,239,183,95.40718780147776,4143
f6b5c2b0-2ca1-4955-bcec-3d7b73e18356,Educational,0.146925790962826,21,38,233,596,363,33.78561628875383,6878
5d8305d4-33b6-4569-8342-2829ba92a38b,Healthcare,0.048498348300367145,18,32,614,619,5,88.1275603295795,1468
e2625adb-eb6f-4126-b099-b2004caf6c42,Educational,0.9013069056300406,37,16,6,971,965,55.78355571299119,7297
c85175d5-382e-4555-aa3c-53d777200779,Healthcare,0.6850125392684824,30,35,50,359,309,80.5164068819019,8288
fb6abfaf-1a1c-4476-b86a-6a1d6f251b15,Educational,0.9078655697667655,4,2,596,1192,596,36.299131008028795,8222
7c8b979b-ce4d-4f22-83d2-a62256d2bcc3,Commercial,0.2849773951849194,42,19,474,1028,554,87.03517831899292,3417
51d332a8-86bb-4640-9f63-6b4cdc753c80,Commercial,0.23178095078733008,14,2,614,1423,809,67.20591434599461,1344
f5cb6bef-eee9-4d2b-bada-45cf700c971a,Commercial,0.44397787178417336,20,10,56,463,407,37.777583664694944,3477
bbfe4eb2-e8b8-4b80-8b17-d54d419352cf,Healthcare,0.6278844389579448,6,1,599,1374,775,73.39859784295828,7793
01747fd9-249e-4c7f-a9ec-47f876299f50,Commercial,0.005104317776881695,47,35,290,794,504,54.5812354855675,1836
57c6cd46-3580-4a7f-af5c-fd3cf71ac193,Educational,0.7202748110830646,3,39,534,1410,876,18.87557983622996,2397
eb18eb51-5b1f-42ce-bf07-3a2a35112cb7,Educational,0.2618744001361084,25,44,464,759,295,73.33732922540115,3349
7b6c8ec9-5bae-48a5-9a33-21c320eedf0f,Healthcare,0.36809698525170886,38,13,14,941,927,25.26030216706759,2354
42e659f8-f011-4b63-a998-2011c4077094,Residental,0.7483480176159104,27,30,650,1062,412,55.65002576968504,8749
bd9d89e6-3246-45f5-905e-139202312d02,Residental,0.7419906432098414,33,44,75,1183,1108,39.679977013855776,2084
a6d6fd27-0c4e-4ca8-b862-312630c4da89,Commercial,0.17580954020209327,28,10,651,774,123,99.03525863042739,3533
9e8c6d21-b5b4-4498-b36d-88406621ebd5,Educational,0.4261926153658616,9,4,135,895,760,63.852943124049474,8590
4d3e65d5-408e-4f1a-82dd-23825b6054c1,Commercial,0.09187688295670138,13,21,711,1195,484,59.3714620519954,5156
0e8dd159-9fb8-4768-97a6-686fd1d7b846,Commercial,0.3569629914682726,9,35,281,1115,834,26.55191362858656,1603
1963c88e-a5ec-4b9c-a4bd-430187e597db,Commercial,0.9824900776504066,22,42,25,489,464,88.38289268422373,5161
2b1a9c15-6155-4ac4-8e31-cee122d48623,Residental,0.5777116330717188,42,12,19,47,28,58.98954404299041,8720
5ac49efd-45ba-477a-8cc0-5ac509b81938,Educational,0.7666443766860078,4,13,692,1047,355,38.188415267805695,1073
219e06fc-579c-4ea3-b94d-a864b8659300,Healthcare,0.20346231957430916,35,25,73,527,454,72.36960521269361,2646
1d51fc2b-b402-4d0e-ba6d-242284e51bdc,Healthcare,0.1583327152541023,35,44,30,1099,1069,75.34544603983325,1784
db27bc0e-5acc-4d77-a3de-863fae289fa7,Commercial,0.518676393551236,34,34,671,741,70,59.00414127069003,4205
bf3f9c4f-613b-45fe-be0a-b132153e5d1a,Healthcare,0.14020846082901228,49,13,180,1319,1139,95.17846220710476,4806
b76b1bc0-a544-4763-bd29-6dde86a67206,Commercial,0.24262980691062852,39,47,25,886,861,23.019334535255737,7561
289e5741-45ea-40c3-9cb3-48ff88eab3d8,Residental,0.8815940713101772,9,4,421,1101,680,31.220606652555077,9575
f59d6d36-139e-480c-a139-ebe69e2ca4f2,Educational,0.12604843171217228,26,40,333,829,496,52.93646064071403,5228
8d48a35a-1529-40f5-b94f-e25a4e52ceaa,Healthcare,0.47199883186970537,14,42,674,1194,520,77.68923882535537,9174
0a7da10a-eb86-4f29-b59c-13a87e4445ee,Healthcare,0.9991181047542391,16,42,141,311,170,34.56211720600464,3734
cdabb638-c485-4fe2-8306-3bd45c7019b4,Educational,0.6463158413313972,11,34,668,1413,745,26.81681251999729,1685
4ed47e8d-6acd-4dd0-972d-8d36b0b898b6,Educational,0.20147358654415193,2,2,20,1426,1406,41.08706559191886,5854
ef617118-f589-406e-8889-9066453324ac,Residental,0.9874572160763126,15,21,646,829,183,84.87645392911331,1087
0de53f95-4c20-473b-8abc-dd3e80a58ec0,Commercial,0.3431011214974712,31,12,162,892,730,64.46287908284535,6328
12dcba12-9523-4e8e-80ed-98295cc65961,Educational,0.4924593616551247,24,41,586,609,23,51.140102720438755,6847
db44fa1f-bb47-4e4e-bcc2-2421eb0f28af,Residental,0.9868593158053744,44,49,220,318,98,28.246903107961295,2760
581210e1-a400-4a13-a940-4504d5216f7d,Educational,0.019701952431123826,17,37,389,408,19,25.195124814608036,4730
67947c16-b164-4430-93d5-b14285492718,Healthcare,0.44936972861806046,14,1,209,474,265,43.713719606628324,5478
508413cf-fbb5-4524-a6d9-1ca8d6126a88,Residental,0.9384814853781425,2,12,66,125,59,83.22061938639298,5651
346fbd7a-3d77-45ec-b508-105101087ef8,Residental,0.7559285104425801,8,26,480,1077,597,24.54668663557027,6511
259b6132-5405-4a1e-b414-f7460d1efa57,Commercial,0.8717668980573845,6,30,246,894,648,36.994691624769615,8629
50fa6d0a-ac84-456c-81e7-2feb4a9b3fc0,Educational,0.9799802785544355,17,36,389,1262,873,87.84962220986166,6615
d404391f-622b-4091-8808-1bf94fc88f0d,Educational,0.9145616284690629,15,42,397,725,328,62.58180624427611,7493
35a619e2-0cf9-4e9b-aa6d-a2cebdb7decf,Residental,0.31406314955342607,43,44,47,1328,1281,81.63425515387942,2215
72d8d576-54ca-4e3a-b315-0bfc40058c25,Educational,0.5171835634064559,43,40,449,662,213,56.44954700131905,5339
ea0c3c66-0e1d-4cc6-9433-dacab24ad56e,Educational,0.3431969851402461,48,42,111,458,347,18.06881756427281,8723
edb9e626-ea52-4ec5-938a-5feee654fb42,Healthcare,0.4518611664205294,4,36,221,430,209,79.35786789091428,5261
2d522eef-8128-4e75-bdf4-23eeb7c613b7,Healthcare,0.029214530699617436,36,47,491,1192,701,76.39342744917374,6399
4527c71f-d716-441d-a28d-1a79e18599f8,Commercial,0.0496996338709782,25,17,664,1341,677,96.11014690162338,9864
09b634d1-8a77-444d-87b4-5c48b70ed5d8,Commercial,0.1610951427690116,45,13,638,1252,614,23.24179045268538,5859
5571588f-38e3-4067-ab8a-63c156b57b70,Commercial,0.6283077081785388,49,22,566,641,75,93.64563701213986,4848
e340322e-3b16-44ea-8a06-747703e16eed,Commercial,0.24286673945827608,49,45,234,1097,863,55.048413431621,5127
c3f77fa4-8d0e-4a52-ac28-3733e5a68242,Healthcare,0.2346101099471528,10,19,88,108,20,64.27204294483941,4415
299846d8-cd6c-49bc-a92f-42415b2b3e98,Healthcare,0.28807566997502865,7,6,550,654,104,52.90880022397198,9888
2372de5f-96cc-4520-b8ba-7dc129a0d035,Educational,0.7431761809701332,32,14,99,1329,1230,52.02489003756809,3345
7906b8c0-d12e-41a3-be69-78a64d665479,Educational,0.7940444179746767,9,48,6,348,342,89.42255694030929,2613
9fc1728b-4947-48f9-9710-8078a8b6247b,Residental,0.798621535991882,41,36,224,324,100,89.13844513071558,4553
8b6f83c6-802e-4b43-9e6d-0efef0e1d24c,Commercial,0.034480407645903766,16,19,607,1329,722,94.41630638273266,8148
e6c921fb-34c4-410a-ad67-c673e7cb4224,Educational,0.606253515081656,14,26,657,838,181,94.92978739951641,6769
45be3201-e5a9-48af-b2cd-e2011d4712fe,Healthcare,0.5923953138350718,50,20,351,1410,1059,42.75916341607602,9715
ed7601ad-1715-45b1-8062-32b42173655c,Healthcare,0.6218856547671733,38,32,436,1225,789,91.33027085269829,5007
d035497c-733e-4c7f-953f-dc552e7b0a6b,Educational,0.90460816476163,27,35,241,1057,816,16.63222344215445,5144
7a0323d3-ec3e-4a69-9add-d40bc27b99c1,Educational,0.40099987223885947,24,3,584,913,329,96.1213607940449,7259
89d91bc3-110d-4842-80fa-074c821ed273,Educational,0.40761367292153516,11,23,413,1413,1000,20.152522995601217,8776
c9ae951a-c913-4cfe-82b1-e68f02b18991,Residental,0.861636142322697,18,6,287,1418,1131,49.36480326014942,6693
1e5a0faf-64c1-4230-a975-b9385d3292ec,Residental,0.3996030339842237,26,22,1,495,494,75.41643431839836,9936
60579792-7d7d-4698-ae7c-3c2c79bce3d0,Commercial,0.04980692962845823,22,35,502,801,299,11.323976671879596,5345
261d3973-0bb7-4c47-95c7-bb8bad2057bd,Educational,0.46335525922463994,43,13,521,543,22,89.65338253023813,4735
c030a57a-fb6c-477b-b64e-8f73b5be25f7,Commercial,0.28564726776024674,27,26,528,568,40,17.29496486602453,7569
3d0054fe-19f8-4dcf-a4c9-21aa9fb9f46d,Educational,0.2994745390584842,28,18,573,1030,457,18.725867831111067,6313
fa58e664-eaf0-43db-9a29-e702b7057149,Residental,0.8217139881322268,8,7,443,457,14,72.43116975089032,7909
826c7b88-6e2e-4876-b6b6-d907e477976b,Educational,0.6165692198267837,34,26,309,448,139,67.91473562870361,3790
0706d63e-d990-40de-9575-54753bf46146,Residental,0.5023679708783247,33,11,167,465,298,45.561278724152935,2314
19383b6d-9923-481f-9dca-98b6bd5909c8,Educational,0.8956911272222314,28,38,121,479,358,59.31486381765686,8323
03f4e203-0c79-4695-bbc2-49a060442a34,Educational,0.5086291917589131,13,27,166,1332,1166,93.58701764720054,5734
76760311-9aa3-465b-aa0b-db82745fc52c,Residental,0.8753834424984863,17,40,616,1086,470,34.9203840458303,2248
d3756456-b605-4c1a-aff4-dc2cafd11039,Residental,0.6514404706446421,42,23,366,1190,824,61.600820456730894,8446
58097429-dcb4-4ecd-af8e-c30b56283fb3,Educational,0.09646724325192957,33,19,92,1064,972,14.301085959424856,5312
07445b85-aa43-4bce-86a7-d0aefa6ce0f6,Commercial,0.5464137869001203,32,15,381,821,440,17.800130963740052,3860
0ff0d42e-4afb-4c75-b3ac-a662402fd6e1,Commercial,0.5751091174292938,35,25,620,1257,637,79.86485974676327,6333
1366775e-8ed7-43bb-9b78-5a681efd62db,Healthcare,0.38734894723832913,9,10,597,698,101,84.61588502775143,1797
44ba225b-1d57-4d6b-8ef9-d6ba8d8ef075,Educational,0.42472600369846925,38,4,130,1114,984,35.69338381049925,2947
5d458105-d40a-4c41-8a2c-b14181b44dce,Commercial,0.29036840204118997,46,18,474,1239,765,52.73006656891085,2869
e986372a-6d6a-4350-973f-7b86dd1dab10,Healthcare,0.24569488734125455,6,36,365,1324,959,97.9437640538951,8908
1d4637a9-1dc8-42d0-ab2c-cbbe66df4c88,Healthcare,0.31261321028609024,36,39,678,1213,535,72.30048840335358,4480
2bf26bfd-0efd-4bcf-9758-727ce7c1fbb9,Commercial,0.41709954653652226,22,25,270,1051,781,65.72601201591623,2749
a4d4d81f-ed9c-4f19-9561-ae274561003f,Residental,0.551484679987733,10,34,301,672,371,31.4619614724062,7035
27e712dc-b446-43c0-b0ab-63171208c978,Residental,0.5100750997165664,26,2,674,785,111,56.50664834467859,6078
fc72d987-8949-4389-a20e-57c963411680,Commercial,0.7260090906630524,34,1,223,354,131,75.23435149209011,3065
59296967-5a0e-4ca1-bfe7-5c94c24cf9de,Healthcare,0.9752089517151249,18,15,525,924,399,13.675351084211886,9000
fcda1168-5b0a-4b91-b3e0-5a83c28959d1,Educational,0.5663848177231909,23,26,47,1170,1123,74.57406535319839,8962
78ed2300-78ee-4f36-8e85-4c13b0ae6805,Commercial,0.9655318044409354,26,43,481,619,138,28.47652538068599,6588
c3c5bdfa-9468-4baf-802c-7e34ba9f194b,Residental,0.7651737106249522,8,3,23,811,788,47.26754670188738,6719
539a2c4b-b68c-4679-9b64-51819069779b,Healthcare,0.1533189717202692,16,47,340,1010,670,96.52379757624462,6166
a41fa83f-0901-4703-8955-14e9a41240cb,Commercial,0.14434141061572836,18,19,131,140,9,59.222720372757145,4687
0ffd4536-041c-499a-8114-eeaeff85b084,Residental,0.8413020428741329,2,35,419,627,208,93.23119486331615,3209
063cea4e-502e-405e-9dfb-3fe4ff750fab,Commercial,0.39109111904091054,35,22,505,729,224,12.187237899990427,6011
e85950a8-f74e-4d95-bb81-7099ab988ad2,Residental,0.4750980196422081,25,9,547,885,338,46.246543646393896,7181
37f9ea1e-fa82-4a82-9b8d-cb99f831db1f,Commercial,0.047791989247814914,30,36,97,363,266,77.82389220889118,1166
e55eb387-117b-42f9-a786-7d605d2a246b,Healthcare,0.1486988275989729,19,41,203,1337,1134,43.47678743746761,6886
51824637-3758-47af-88c6-b8d56fcb76a1,Educational,0.3158721710479683,28,48,567,662,95,88.50231147621807,1002
7dfb7f21-8e6e-44fc-8a4c-de3ff5b6360f,Residental,0.175360367727997,7,4,484,849,365,11.004904510604877,5036
0d7b4005-1dc5-4b75-ad50-cfe12549eff0,Healthcare,0.5706113876919626,35,9,307,716,409,15.038495521290532,2347
be2edec4-7744-4f1e-96b9-11f3198233f7,Residental,0.9388070191186987,44,11,100,1247,1147,72.06219086920096,7549
764799c1-af0d-43ca-88b5-08da6e62e3a2,Educational,0.7870211344306962,47,18,183,412,229,36.78521705318873,2831
d94a1bbe-1492-452a-8888-585e1414e2dc,Healthcare,0.8076536124808334,17,16,427,583,156,78.01419423579328,6029
f02b29f3-9146-4d63-b643-90e9f0f1fd20,Healthcare,0.3177286126677341,12,24,606,806,200,45.48713861886295,9971
e82719f1-10ef-464d-bc7e-d21890d6dc90,Commercial,0.9173856644417812,30,40,368,566,198,11.839914566518125,3357
425ed219-0568-4588-a264-c1197b637a7b,Educational,0.19673159516324723,24,45,589,890,301,96.1998665041768,3456
5f171d51-8da9-48e7-b084-736799bf9f49,Commercial,0.11034103464775913,14,39,195,575,380,35.30977104863521,9282
b497f9d1-0b91-46c1-b32f-98088714753d,Educational,0.13297392184417145,17,5,7,864,857,92.63917446869992,3514
07d13f35-f997-44bb-8fd9-a855aa999863,Healthcare,0.8196987803157683,45,34,199,759,560,30.285054409125024,6146
a3e0105a-a7c2-42e5-a234-d24c3e6a964d,Residental,0.39690764613291807,34,31,384,1069,685,75.37747905601671,1467
45d106d4-6f8d-4f43-afc0-2b699bdc43d8,Commercial,0.9552441620420287,23,18,489,1032,543,74.96936505444393,7601
c21fe8dc-d347-4b6a-bf22-75f6ba1132af,Educational,0.9498378412858465,2,50,127,744,617,84.65533750710442,5793
6ddcdee0-6baa-41a1-a594-6595dc9dcfef,Healthcare,0.26448144245358673,39,7,501,675,174,78.3818713200857,1931
75aa480e-123e-4344-88b5-cf5c9261ae8e,Healthcare,0.16514906393905704,45,8,718,1347,629,34.57562612369951,3209
aaa2ca4d-891d-4d34-8512-40bdb9ce37b5,Commercial,0.8918086039231261,43,9,39,1017,978,85.47028621297767,9653
e91cb8e8-31d4-4139-b817-01fd7adcebaa,Commercial,0.16381514130931885,29,12,593,751,158,61.89036927035015,5655
475f2ee1-1d09-4eb5-9a02-64ae709698dc,Residental,0.02563424983051743,29,42,535,838,303,50.25880027919595,6948
df3b241c-adea-4e83-a2c7-9e5a2ee23b33,Residental,0.7359469834820108,7,34,444,1279,835,66.22444565124944,6294
5809d692-322e-4b74-bae2-1cdea88e74c5,Healthcare,0.34514853761658204,24,8,555,1109,554,92.03001305583602,6240
5e99e799-b38d-43ac-b74a-6dece614bdb2,Healthcare,0.1574877217872731,16,28,716,1424,708,94.78534128284551,2610
5ef6b94d-80f8-4ce7-90b1-341ed7d6c9fb,Residental,0.8477938224019301,14,35,576,1117,541,40.72827989862911,3599
067e7a28-1df4-42fa-8338-191705a8e093,Healthcare,0.594030503694137,9,29,676,1264,588,30.563120739377485,5673
f184be93-b594-408f-8929-9abe27adaa73,Healthcare,0.6021489630949535,27,34,276,402,126,52.26944722079203,7572
13ed660b-c25a-44d3-89ab-6a66b16458cb,Healthcare,0.6176865775141225,10,18,330,1267,937,61.43252097976552,8283
d06e9639-634e-4951-89a6-d88fb5c41027,Commercial,0.6986094677783969,13,4,10,85,75,70.57587088530963,7498
d1e56c66-fca0-4b4b-b576-16d1b092ee5c,Residental,0.7133332392606169,6,5,11,617,606,40.55458854744032,5310
f28b95d3-efd1-4634-aad4-525ae5396289,Residental,0.6208044118622561,19,43,69,267,198,87.1999180108493,9683
98b5c302-642b-41ce-b4cc-850ea3e8c755,Residental,0.22277626314218368,46,37,105,1217,1112,86.61127284275219,1401
69585990-34fd-4fb0-812e-5ecd7c1ae8fc,Commercial,0.874691195245049,40,20,400,821,421,65.5943364497952,1043
9ed50c1b-1528-4da3-8b5a-08dddf5f9647,Residental,0.38795915385236013,26,21,505,544,39,80.77797942072456,3676
e8a9c769-9612-4f14-b4d8-b2e5138bb6e6,Commercial,0.6707405925855111,43,42,246,533,287,56.253350523201966,2815
360b4209-e54a-4cb1-9e7e-7f459a84261b,Residental,0.11765708261662133,48,38,387,424,37,68.2808978643767,1604
15bb77df-ab9c-421d-9a4c-606373dbc3a5,Educational,0.7606866857460979,43,46,687,972,285,79.37609226281941,5072
76e7b802-bc59-4602-a486-1eacbc6c601b,Healthcare,0.5728128129363347,3,31,272,813,541,97.12217696336356,1147
b601137a-f943-4011-aef2-ff759bc9e8e9,Residental,0.7694339893504546,48,47,436,1434,998,39.35719794801026,5446
03e47f23-ff91-47b5-ae75-2c0ee91b3b03,Commercial,0.6371272616521231,3,48,583,798,215,60.16457202568133,7193
870ae92e-3eac-4dd4-b1fd-81e46ce0ed11,Healthcare,0.39415258063238423,39,11,568,668,100,20.346103798415996,6144
d62a1b0d-b561-4a88-9565-b0c026b20a31,Healthcare,0.6806905425097061,32,47,460,639,179,71.65184974135897,1265
2b92fbac-1040-4a65-8a6e-a61aaa917957,Educational,0.3727112564876519,20,18,498,1153,655,44.02004987710347,4058
b90ed5b7-0575-43c8-aa86-e543f6ef2ddb,Residental,0.2087404248611775,17,42,278,906,628,78.64725404856966,1130
fa576c7a-5711-4497-a9ad-febbfbc45624,Commercial,0.22343529648361682,6,17,482,976,494,59.48232866540051,3822
6b9c8831-adaf-4298-9222-8d72bd4645c1,Healthcare,0.9447298627928975,22,7,520,682,162,15.935107601362043,4480
1f4fd217-56c5-47d6-bf55-cf124bfa976a,Healthcare,0.11832864911050633,6,20,618,734,116,84.25168629720324,6386
bf389be1-91bf-4a01-b0b3-21efff4d4355,Educational,0.03750330720011974,25,13,384,743,359,72.4871247954047,9177
d6cde0cc-3d78-4b62-8cb8-227e0506f447,Healthcare,0.2440048472816465,15,21,656,1026,370,13.506714403764633,2824
0eea01e4-7bbb-4dcc-b444-7ec1b40dbedd,Educational,0.6804930069517255,7,35,347,928,581,80.70413058035521,7117
dc797b84-0dac-4cc5-b6dd-45b1e6893356,Commercial,0.6339906213236959,19,38,716,1342,626,22.44864866465863,3109
2acef947-a457-47b0-aa60-c200041e2446,Healthcare,0.22336453393837175,38,44,43,779,736,57.912183724234076,4016
4693f342-63c3-4d2c-bc46-5cb8495cac1c,Commercial,0.7205690300311429,41,11,279,584,305,16.881043284791776,7698
aa75fede-0bb6-4df1-9af1-00d69a564572,Commercial,0.7273899993530104,15,23,261,1149,888,14.082767221487615,2811
dabf7282-7e00-4e08-86cb-d7ca0dd2bec3,Healthcare,0.0795372412794868,8,33,649,737,88,73.34697291908518,1488
9a7bc552-10d6-4c29-9073-6381e8dc7ef8,Residental,0.9527429797323663,42,18,147,711,564,44.34794106772737,2195
ee16d20b-ae06-45b1-ba99-d154f42156b5,Healthcare,0.2987263889687325,8,49,204,481,277,11.169482618905743,3089
7bd212cb-429c-44af-8053-9ee767ce0f63,Healthcare,0.665624150121704,46,18,226,1096,870,39.75300840536984,5358
2d35529b-2784-4a97-9b34-e691989f6bba,Residental,0.6522720393042123,48,32,521,1429,908,26.017102232419234,8601
984a5125-1aba-443f-9534-8f9e6089d3d7,Commercial,0.6999964540997194,6,19,416,1262,846,80.05059106836723,4972
0056bde6-f4e5-4929-a620-a81c9e928ebb,Educational,0.6757120231672393,44,32,39,1055,1016,35.91513656103599,7191
88318d60-692e-4a8a-bc36-a03407f12aec,Commercial,0.8166071774179945,26,49,395,781,386,89.2895828515881,2298
08eb6cde-08ab-46f0-b1af-3820debce0b2,Healthcare,0.7936989051302996,16,17,20,392,372,18.400734485382088,4147
351809a2-06b6-45aa-a10a-382ef1fdeb68,Residental,0.676114695687238,24,1,670,1403,733,94.23441764202815,5649
82044a4b-ae7f-4e14-acfc-1e9de9fa2d7d,Residental,0.5357393723582281,7,1,155,219,64,18.308514124925075,1832
d56c9548-569c-4771-866b-e1d3e86c1ec4,Residental,0.8990624410000005,38,48,534,1024,490,34.6415189640073,4768
ee3a8c5b-e955-4828-a35c-24d2eb179693,Residental,0.20778631634360223,38,10,152,556,404,20.47532329687364,8564
bb38e6ad-d4a5-4c59-814c-2541d56bff09,Commercial,0.18740335351150483,35,1,344,1386,1042,31.24903657733346,6527
f7fe6b98-e14e-4c76-aaf9-6fd481ad1d80,Educational,0.5998705083062154,5,50,64,1433,1369,77.6245439028283,5855
2a33fcfa-00af-4a60-bcfc-eb8294238bb6,Residental,0.7862915239955043,21,22,459,953,494,32.03770218857419,7198
e3bf164d-47dc-4c8f-b40d-a7ede5a23e54,Commercial,0.8914625879667734,14,12,459,1094,635,10.78435185787119,5183
ac3a36de-6562-49b7-be1d-2dbcff592b03,Educational,0.38580646611108727,44,27,547,1341,794,44.77435812652292,2927
b781b727-9848-4ffc-b74b-640f9a8e32a7,Healthcare,0.5425159266530273,45,39,706,1328,622,78.02394893321588,5519
ece28456-dd5d-4656-b90c-26e155f10ed8,Educational,0.9008996550451828,8,21,350,656,306,25.858425886579965,6348
579ab7c6-cd9f-449a-9a80-b3fe282a5034,Educational,0.6562162190312758,28,30,371,1363,992,51.24282870716741,4963
602a4f0e-7daa-40b0-b38f-15d8a79a2a5c,Residental,0.1537589014113535,11,43,271,1291,1020,89.72043085219218,1052
a7a82628-bb02-4009-b961-5d736312fd00,Residental,0.1141653614963759,14,35,706,1301,595,13.754991441864139,8648
2f125d1b-a7dc-4790-aac9-62fd81495933,Residental,0.8822059866849894,25,25,608,805,197,74.904460057548,2053
3008026c-3453-4df5-8dc3-a8436516a9c6,Healthcare,0.8240312961579197,50,10,507,620,113,14.350203008721603,8723
00710086-fe00-43cf-b122-38d2cf1754c2,Healthcare,0.3397220058768955,46,9,432,912,480,32.27650586495713,8486
2d05dd23-3539-4ee9-a5f8-7e336c1cdc34,Educational,0.3002231902775283,39,38,361,1012,651,86.34389337638892,1409
24502237-5bd7-42e3-82e7-abe826261d9f,Residental,0.525699711152863,36,40,385,1304,919,73.60875757884361,7254
f3e2ed88-23b0-4a7b-8fc1-858da9048396,Healthcare,0.09227418356220252,17,29,642,950,308,13.190995633934193,9991
d4379974-5d39-4a9e-aec6-9492f2705032,Commercial,0.3446596309999743,13,27,420,1019,599,37.734547613269406,8989
1572f7b0-8a13-4174-987a-c3dc5138c9d3,Healthcare,0.522461888929896,25,6,494,687,193,47.26016929462684,9257
ff068719-f13a-4cbf-99b7-d2961f081b74,Commercial,0.1599719132618005,3,43,350,388,38,92.26750548260505,8105
e658db07-81f1-4fe1-8aeb-c348c9aa14fa,Commercial,0.6412104760043507,10,12,379,381,2,19.810522207384025,8015
6dc7d7e1-8c4f-4c6f-8a2e-1a45cc407039,Commercial,0.824990302404345,31,6,566,650,84,49.25682362568708,4535
d2bc1b08-e7b7-457f-9af4-eb6ea8aa8b16,Commercial,0.49253203106662924,6,11,258,306,48,59.104965502536416,2053
2964a6bc-067c-4cef-b35d-8515889ecc02,Residental,0.8195384173715223,1,27,214,309,95,60.60125831282971,4854
5a0e4f39-412d-4643-b0f6-6652f7b6a0f0,Healthcare,0.17852079676280452,44,8,603,1319,716,34.96886676509464,6944
6f299c5b-88eb-4258-8e5e-3dd69649aa86,Healthcare,0.0021154375249088364,40,21,572,807,235,27.17858181836785,2933
c4f9a858-ddee-4c50-a634-4a602089807e,Residental,0.06030628836266205,2,35,451,760,309,19.933767179670795,2107
7c358b54-e651-49aa-80c9-b7a44649175a,Educational,0.35908300910038504,43,38,249,1224,975,96.30962759367058,9006
cffc7747-1826-4eb1-80d5-1ead8c9e59bf,Healthcare,0.3732910904964276,4,19,205,869,664,45.74376479897737,9516
9ba7cb4d-bb4b-4134-8bf0-df7501be3865,Residental,0.9762036783756443,14,7,1,1055,1054,19.590806139370954,8605
077c7c85-5627-4a65-85c2-f52a1fa46a60,Commercial,0.3649892329555152,18,38,496,1261,765,61.229343977738395,2573
93b5c889-7816-4ed6-88f2-6a1584af0501,Healthcare,0.5161294854015533,6,16,582,835,253,83.35693377036861,9467
c32a3c2c-2d21-4c5c-ba42-3f23c8654d82,Commercial,0.5028749047253618,37,4,307,1181,874,89.78835916816836,7730
a9622857-8733-46fa-a5d5-77bd96b80e1b,Healthcare,0.6178975326876174,21,11,240,789,549,54.06978789421933,6690
2301261b-f0a1-4692-a059-e0119f01df3b,Educational,0.18289238007676145,9,46,112,590,478,29.71692103375504,6800
c5bf749c-a5bf-4335-b7e6-8e62eb5d6aaf,Commercial,0.18205779228274555,28,10,470,678,208,57.912307880925056,9629
b0371be7-48ad-402a-919c-5b2a00884cae,Educational,0.6766678090072,42,37,578,850,272,56.79256778916424,2507
e0e57491-1a0b-4001-a6ed-db6e416281c1,Commercial,0.17550848546633768,10,29,562,929,367,49.90941103903323,7532
130cc6ab-465a-4007-acd7-792f9343e65e,Residental,0.5971637020593906,4,48,494,539,45,48.814354542265356,4677
4aa201a5-b6dc-439b-9894-fdd8a744603c,Commercial,0.8936717054381429,43,24,281,1184,903,82.36170927619288,3604
8f926072-b931-43a5-92ea-29ed26fc6a38,Educational,0.7865602040327268,29,14,629,938,309,85.11626316518404,8893
529c5962-1c51-4fca-a07a-95b9007ce60c,Educational,0.4529691551138969,49,15,371,1161,790,92.28192587951406,1017
6de5e3e3-3194-4c55-aa8e-2ee2f6c2169f,Educational,0.0010080292332734775,28,2,266,1222,956,42.86405460877228,2647
dc9fe7b8-b142-471d-abe4-f3c264ee1b65,Healthcare,0.7139609961366952,6,29,603,1124,521,17.833084135493888,5886
0b17240e-28bb-4a2b-8561-0353574fa867,Educational,0.6488741916612348,14,11,578,1273,695,98.05334703897094,9061
5dacd3e4-aece-422c-99b0-9ac3a62647a8,Commercial,0.7931251432096682,50,13,699,904,205,54.44270613905502,6996
aba3faaf-e925-41e7-964f-e86e81106e7f,Residental,0.006107820118969376,44,29,6,1411,1405,69.78221460317351,5658
749c8502-8d96-4192-99f3-cb44e1889d3d,Residental,0.2923078859381887,11,9,523,724,201,40.88068321495338,6844
892ed780-9c92-41cc-90ef-3e71aa70b224,Healthcare,0.9124352294784168,29,35,14,846,832,32.80925470149278,2575
d83a24f7-20f6-4fbe-9074-294b5f30c075,Residental,0.29818905761530845,24,32,5,1100,1095,76.26418656145773,8937
2160de32-bc04-4d2f-a893-e360a6a949ed,Commercial,0.2767534539800839,1,2,225,741,516,36.743354729980055,9721
5ef9a14d-8559-473f-a046-6c527cd44870,Healthcare,0.7381798985222927,30,16,502,590,88,94.4522789266405,3826
2de0dcea-0365-4e49-bafa-437c4f92a408,Educational,0.22721544186092968,39,22,653,1110,457,40.29278953740308,2689
69d7ce1e-c9d3-4f81-ad10-1669fb7072d6,Residental,0.44186998878380623,17,50,425,1273,848,92.5986255065131,7945
fb72b3f2-44d7-4cee-96de-89911188c82f,Educational,0.2766910016378271,50,3,655,1437,782,81.63529856193372,1045
57e897d7-2e4d-454a-bb2b-84f9d1044ccd,Healthcare,0.36530382180592724,39,30,387,427,40,11.68277637693476,8888
2a7bbae4-7c15-4660-830e-f6a23bab6bd4,Educational,0.06532087653216878,11,13,34,1433,1399,15.074147947117854,9140
0c655aab-97af-4d73-86e5-369dad8a9842,Educational,0.5964920874227251,24,19,350,676,326,19.806173947452994,3256
8e288d51-6429-4a59-a4ca-e7d46eede80e,Educational,0.610034073141004,31,39,295,494,199,36.27093913870402,4918
ea2a9c39-d00f-4854-ab61-d7caa840ade8,Healthcare,0.8065658069976132,9,43,715,823,108,91.14599125539294,6441
fdb39a98-cec8-4dfc-a77c-4293bcc72fb4,Residental,0.014100664086514114,45,38,454,952,498,38.29148866022376,1816
90db8f93-9ce2-4d61-8f9b-49b08a39afe9,Residental,0.17446534288866744,2,8,508,1000,492,48.86494205836207,9654
68e10d8d-fedd-4fb0-8ba5-65626a73e5a8,Educational,0.3826576974956154,30,38,559,1274,715,86.00182790242242,6769
f9947b9a-37d7-4c8c-90ca-8b5201e71cce,Commercial,0.49411741261005293,40,28,274,1281,1007,17.56871425474178,2937
b60773bd-5531-4a54-a88e-a72c44284a81,Residental,0.5282208227143016,42,26,291,443,152,70.45604410699113,1557
22c14976-e299-4d63-a37e-62fcc7015228,Educational,0.1923147967451857,38,24,640,880,240,75.47503670804068,9805
b4102ec3-3f82-447c-b30b-34b338f183cc,Commercial,0.17562351884476968,15,28,658,702,44,24.69920390008618,6415
51751aa9-d9e4-4064-ba70-3f93bf53c7f3,Commercial,0.639349206233524,22,19,661,1251,590,69.60646789468572,9270
a6a4aeb9-4547-4824-a31f-052f4874999d,Commercial,0.22819141390300512,30,24,680,958,278,70.9380667140382,7194
b03ccb36-fb7a-4b62-9018-a6ab0ed5ebe6,Commercial,0.6214856851404269,44,3,182,457,275,64.48166014816299,8236
f768c0ea-64b6-4c99-9ab5-cfa85f8771c3,Educational,0.7848062976246128,29,32,636,713,77,43.42192974997908,3210
e611183e-97af-4fee-b371-64cc7dfbe339,Healthcare,0.35707888827720813,10,34,685,1097,412,10.200293567090547,2424
6e771336-5179-400b-a1e6-1a0927877ab5,Educational,0.45368274576039747,34,41,335,1213,878,26.11293853036829,4600
273b9d21-599e-481d-987b-7fcfd4328fde,Residental,0.8223041523868545,32,13,521,1091,570,82.38532061926706,1681
d93daf5f-3f8f-4914-aacd-c9343a76b90a,Commercial,0.1004202566448289,48,31,155,267,112,75.79724537575055,4095
949fda91-5577-45f5-99c2-7694b1a728ab,Residental,0.7229081728706686,12,41,208,1101,893,73.15922916974486,1493
f454135b-d593-4739-9166-84fcb3a57f32,Residental,0.7745917067794907,12,3,150,742,592,72.57432628173177,2441
10eea54e-7a94-47ed-bae2-c31a94d2a6a5,Healthcare,0.12683843615075163,19,30,61,762,701,56.55453029968201,4415
047502f3-a1b1-401e-a063-93a465823723,Healthcare,0.3055003915390442,43,8,337,730,393,21.54709879766964,8272
c1bde4e6-357a-4e6b-9b48-b23aaf8f9194,Healthcare,0.6152631068247184,44,42,218,939,721,72.5249870355888,2070
9afb442a-524c-4919-8868-d29b9580b954,Residental,0.716389006286908,10,39,32,1375,1343,95.08263056306119,3666
d2287315-3dac-421f-ac21-1ed84f011dd3,Residental,0.00042898717607064984,8,15,201,736,535,68.2170208863269,8625
80d8258b-7934-4254-8458-519e0123deea,Residental,0.9142353954583898,25,31,362,1246,884,98.5571129609364,4384
c2efb6d9-998a-4a54-8a7d-4d0331c004d3,Educational,0.672044365994215,17,44,589,664,75,44.80566616821071,8737
f2710c5d-fa6c-479e-bb83-4e01a176ae85,Commercial,0.663890504008531,15,2,206,238,32,23.10158296803541,2100
d5c8302c-cd81-4e7d-a98d-3d0442d4046a,Educational,0.42140157233728415,22,33,361,850,489,91.61661746628101,3540
04809178-bcf5-48a9-b3d8-f25a16bf93ac,Healthcare,0.2824405945961064,17,24,526,1238,712,34.365569910347375,4901
3f90c38a-e61f-4a49-a621-fd44e17c50c8,Commercial,0.1179587272095558,30,44,202,1020,818,67.06619689851696,6649
40bc13e0-05a9-46a7-83b1-e20411032196,Healthcare,0.6190432674387791,33,3,212,714,502,58.19135256076656,8450
0c386fba-7a45-4cee-9a53-5a5c24d27bee,Residental,0.41808972124012855,29,23,290,1321,1031,45.437964766337956,2198
27d5eb60-cd02-41f3-b5a1-fd47d7697e40,Residental,0.5544406447051796,7,11,537,1355,818,75.8072027508534,1890
2fcd47cf-d5a0-4b6f-8cce-684cb13981ef,Educational,0.5886274109286705,24,44,124,588,464,24.73495405066835,6360
9aa42662-6fa2-4f89-8197-eb94fc4d23ed,Educational,0.16040217476700058,10,14,672,786,114,37.082029619323656,5345
fcbbd2a2-6a40-41bc-b069-2f654ecd92de,Commercial,0.09767251130150434,30,24,632,1245,613,64.52679004277275,1295
5cc2785a-9405-43db-b66f-3eb83b7f3f97,Healthcare,0.03441534385735501,37,26,318,734,416,14.447683630491781,4031
01f2cc07-ff9e-46a6-9417-2b74447e7ece,Commercial,0.4925280908339654,11,48,233,1169,936,59.79709626560566,1770
0d278a99-ffc7-4ebe-9d33-01be6d258c5f,Healthcare,0.45723638070553074,19,28,412,1254,842,95.52336364495433,9865
8970a69c-421d-44a6-a4f6-fb04dc2dab7e,Commercial,0.9134563936477899,37,4,441,605,164,85.67575238009809,8961
a104b82b-adf9-4b59-945d-7a608fd24fee,Commercial,0.25582747640015757,47,23,82,726,644,56.30296663635848,4151
cc1f47bf-f5e7-4db5-96b4-4f103c3962c1,Healthcare,0.308790045061084,1,28,291,871,580,36.60767979680787,9866
bb7186a8-ab15-4a83-97a9-6d050607d4d0,Educational,0.8060953076784093,33,35,633,1271,638,59.606163949699365,7906
5e4eca48-590e-44dc-ad54-3bcac504296d,Commercial,0.11532026913954685,10,4,713,1266,553,37.22967846172614,4730
ae6a0051-f883-41d6-9e64-baef33984ba2,Healthcare,0.9245739979022969,29,22,362,1136,774,19.109389377037235,9553
365ed46c-5ef6-4c76-94e0-97cf4777bdb0,Commercial,0.2282533463972768,15,22,575,860,285,21.63022818442039,8291
668e9578-6e89-4062-b65d-6fd2b15c73a0,Commercial,0.6610730678138778,31,33,177,900,723,58.865784171770656,6370
bc9be2d2-50a4-4790-9ccd-7663079fa759,Educational,0.42528495358280194,18,23,332,1297,965,24.53481306250704,6107
a0eee419-d834-467c-8def-abc2949d16a3,Commercial,0.8586381362454215,22,33,249,1281,1032,64.46781610084517,8240
f99f8ee1-bea2-49db-ab93-2709ff12a7a6,Educational,0.5656617590674798,50,44,448,526,78,99.96718455355418,3478
5794f201-ad43-40f2-bed2-2d70290eff68,Educational,0.2952478028188221,22,17,613,924,311,15.036430163269683,1006
38f6c402-b009-487e-b08d-76fe1c4c99ff,Commercial,0.14781989285834773,11,23,64,1303,1239,79.0974324284739,2024
8bfaa29f-2c5c-45ba-a7c8-8e9385c4e070,Educational,0.2967739608327554,49,19,369,743,374,81.45214368786573,3859
ef72bab1-1b98-4353-8e21-b082e6183e1b,Commercial,0.8641076273795699,33,38,408,1406,998,38.08749169131444,4476
98fd4bb8-e03a-436a-a3f8-239cc3362a18,Educational,0.07330626174910182,1,30,159,951,792,71.83442743988567,6459
ae3d8f63-28e0-4e16-9714-13d93641100e,Educational,0.7627739380669922,34,7,258,799,541,84.25445386886429,6874
18a1bb63-6da4-4b4d-9ee1-566bd2ad30b8,Residental,0.1715756987249114,36,45,698,1015,317,77.89490800426019,3035
6ab87177-5444-4e86-b9a7-29b7b55bbcdc,Commercial,0.34233354501120883,24,42,660,1344,684,28.38341922216705,3926
863b30a7-68ae-4602-ad89-55901266ddec,Commercial,0.7704458558734669,4,24,448,1380,932,92.63096687136155,1945
dee8ba2f-027a-4eb1-90bc-289e746f809d,Residental,0.4715682569275532,48,14,521,924,403,55.86762003424043,1035
b27afbe7-99d7-447a-bac6-190aaa86a1d7,Healthcare,0.3592356098566847,11,50,559,1073,514,45.87621283489673,8873
3ba3d91a-cd84-4c8f-a9e5-ba30e153ef95,Healthcare,0.9719298366035921,43,45,506,829,323,30.53590689856503,6009
287f19c6-3c8d-4e9c-968a-c901fcc679e9,Commercial,0.0007650233267527673,23,26,498,1162,664,60.66983335148566,8577
2291e207-31e6-4142-9843-58d4adfb1474,Healthcare,0.41409183846870656,31,36,566,1214,648,17.266881184391472,1935
26c80d8e-fec6-49f8-bfd9-0fce8ade015b,Educational,0.9140393169835402,16,11,96,638,542,93.38886925061784,1446
62659873-8a19-45c3-8cf6-166c47ed64d3,Residental,0.6490157145393116,16,22,33,646,613,60.711951918168786,2937
6d5f72c3-8a26-4446-b4cb-1564458fdf55,Residental,0.25544942706551443,23,14,542,880,338,38.85916917493047,8140
4a0d4a1d-e763-4f8b-82a5-5aa57725dc98,Commercial,0.7543383579540147,41,17,382,616,234,47.7368120860367,5525
3260d668-fff2-40d6-8ee4-9aec8e5c9d83,Residental,0.4692400497347583,26,22,644,1047,403,66.75817815591077,5678
53e648c2-0c85-481e-955b-ddead0b33c2a,Commercial,0.09928061420660594,47,3,639,1294,655,24.22127093042986,9198
9ee61a65-e585-4196-a910-16688bfd8140,Educational,0.5434352770841917,40,31,180,1438,1258,50.2376765665454,4579
61e7dd4d-60f2-47ba-b10d-0b016070b5fb,Commercial,0.732954864905213,26,34,116,404,288,57.1778714896411,4683
5045e8f2-d12f-4619-bfc9-b9d0d3928ee4,Healthcare,0.4094612756897229,8,50,664,792,128,90.3482650125005,6451
f64f45c4-6829-4967-bb14-848c512dc62d,Residental,0.051213059734312005,30,17,110,957,847,87.8562145246066,6127
dd4a4117-a08a-41ab-9697-f5fd37807b8a,Healthcare,0.4106379685806547,24,5,83,1149,1066,29.18919784260547,9949
0139b0ae-d104-483c-a84e-caf3481d434a,Commercial,0.4744595176205325,50,30,165,1323,1158,10.758296614861912,7315
f1323c01-3286-4ccf-b8f0-fb4bce7aacb2,Residental,0.10864625407970929,25,9,59,728,669,96.57114196682794,6612
256be8eb-509a-47ad-b584-301cd14d851c,Residental,0.30915580010146804,50,9,605,937,332,44.32463567654134,5053
51ffe486-d912-428c-9319-5b449b4d0335,Residental,0.23091233776183262,24,1,46,430,384,75.01395874498188,4784
c6ac4620-74b5-418a-bfdf-98dc3794cae3,Educational,0.7659589877492078,7,25,162,1388,1226,54.01174097816535,5981
3c6fbc61-b416-4108-a518-4c1b7ad587b6,Commercial,0.5490093902500639,24,13,65,1051,986,76.0772263540478,7812
c9b0792c-f957-40cd-92fc-9a69899e12de,Healthcare,0.024830284697907823,37,19,575,1324,749,25.431682277683773,8607
bd511537-84e9-4bde-a9b0-2b828545942b,Commercial,0.7650016537006583,33,21,22,180,158,37.20112117044812,5325
2596c3cb-535a-4d29-898f-690676215c01,Healthcare,0.7592325150255002,7,15,584,1129,545,24.82705232466593,7935
cff3d6b4-3789-4743-96b0-5666643b25a1,Commercial,0.5770710654234988,41,11,23,1402,1379,20.377259926382575,8805
e0f6ca25-1283-4791-b9f6-6d367a2eec76,Healthcare,0.5912649313308518,27,16,227,1044,817,60.07816351781645,9595
9bd2cc4a-2113-46c7-a080-55e8ed74ddd3,Educational,0.07571205234568401,9,32,686,924,238,32.55180935287584,2949
82cae004-7e83-4740-8484-a81affb51511,Commercial,0.5746728874203657,50,16,602,1021,419,72.21885487731412,5905
6aa76077-1c89-4b5b-a4c2-59b9983092d4,Healthcare,0.3078145503223011,20,9,175,930,755,30.84321253820386,6400
bb2c63fb-b340-43f8-a95d-0f2cadaa72a8,Educational,0.08440743753726154,18,42,421,493,72,48.553477361983155,6809
0bc7eba6-96e6-4453-b0d9-8bd8a9983a73,Commercial,0.13920469159640703,12,26,554,725,171,28.181042976631655,9593
f150e30c-b4cd-4cbd-b9dd-3ae7aa54c9b6,Educational,0.647725324269248,30,14,290,988,698,22.441132508007815,1190
467c1fc0-98c8-4e9d-a0fd-2331f5ff89bc,Educational,0.4825703718199922,4,24,538,1411,873,17.355882168307687,4774
6f902cd5-bf3c-458f-aba3-bb23d4bfaef3,Educational,0.10448613578975652,26,1,550,614,64,28.134133541581008,5833
df12f5f9-d062-4546-87b4-b4d4f581e010,Residental,0.9408667883973726,33,22,48,489,441,37.826098015727496,8820
0fc6acba-220c-430f-8b08-704e41276169,Commercial,0.2684822151390389,14,29,631,928,297,65.74322964736996,3254
0e6dbd09-4b9b-4aa9-bb73-db2dacb3860b,Commercial,0.9119706510418776,30,50,491,704,213,54.27079551069407,7738
b2fa4360-8f11-4e0a-bb7c-894d6c2656d8,Healthcare,0.7910889985437015,16,13,21,833,812,51.44419057412447,5645
6110bbca-d203-43c7-ab93-ba1f19168cd7,Commercial,0.5691882171286051,45,23,457,988,531,54.51561885943601,8420
330548e4-4010-490c-a63b-bce4194ae0ea,Commercial,0.7908106488300096,16,45,402,484,82,22.594820716274693,6173
58e2a5a2-3dbb-46f1-ab56-ce4e011ba7de,Healthcare,0.2112196594893302,5,17,151,788,637,37.30449328173599,9027
51a1bd81-25c0-4beb-9ad7-630e1cb3be83,Residental,0.9319860644286005,37,43,671,736,65,72.67753026466644,5161
791b02eb-8eb7-470c-966b-e3bd3910ec56,Healthcare,0.9840362212313118,3,47,288,462,174,49.88027318049047,7346
ed8a647b-a537-4534-a28d-6de551b66b17,Healthcare,0.175514344332108,29,28,550,929,379,63.273615139363635,6592
0ba47ee9-beed-4a55-b885-fa4501de9845,Residental,0.9614621465162554,4,44,148,568,420,47.32888943089451,2873
295e12d6-2645-474e-8f03-aeb2a9ac021a,Commercial,0.8366094771009327,29,28,16,119,103,38.92004339874692,5274
add54ea7-c2b8-4308-9985-96f641364a86,Educational,0.23595407140846658,3,46,337,476,139,54.440337533877006,2558
c6c1e918-0bd0-4c6a-b40a-9b051c18c360,Commercial,0.8509564567210645,25,38,141,679,538,65.06367190246729,3743
e17d7438-c869-40f8-9ecb-b0cb2de955dc,Educational,0.5306417862006804,29,2,666,873,207,73.48571637983781,5817
fedfecb1-64a0-4e30-bcb7-622f7c499da2,Commercial,0.5104762877996153,47,32,188,1041,853,12.14841968856826,4678
0b73cd0c-6c5d-4e65-8f89-d2f6c78e63a8,Residental,0.12145128767266455,34,50,650,1079,429,14.814078425858341,7146
4c9461a1-30d4-4913-a67f-54ad530be306,Residental,0.009832492636760781,5,30,394,686,292,35.60387571295118,4909
d9d95628-56ea-4588-88fe-bc8c5b86036a,Educational,0.17292147736665564,35,18,717,991,274,66.58211308488421,3253
f8e93e7b-8b67-4773-9548-627d66c3879f,Healthcare,0.7816332751424567,11,11,499,709,210,69.18480536880438,1046
c1e632cc-c158-4686-808c-8aed0b7cc15c,Residental,0.9397625472096438,17,40,384,690,306,95.56675500080996,6315
930ade93-500d-4aa6-8a0a-fe73720dea9a,Residental,0.4656972412689283,22,2,674,907,233,53.56619217445628,6748
60abb49e-5c95-4b13-9a99-6b663421ad64,Residental,0.6353002566147429,27,32,198,998,800,82.02725622119755,3172
12f3d1ad-0922-4193-a2f4-3ab59e95b41e,Educational,0.29053987286223715,39,43,129,1346,1217,22.453385307647657,7874
7fab4ae1-2fba-43bf-b6b4-40908bc15ab2,Educational,0.056055185851697886,8,47,387,1261,874,28.774814083024253,4820
19febd37-0566-49d6-a643-077bf3a8bfbb,Commercial,0.6947210016804659,11,12,289,696,407,22.719477807199848,1365
3967a2de-68fe-45e1-9c2e-e35270161890,Educational,0.566457687971417,11,22,608,1425,817,34.66067863479354,1332
b1cd1b8d-7df9-4a61-8228-a0f3fce07c7e,Healthcare,0.6046500641432608,30,7,136,806,670,45.56315844603558,5220
702f5e85-f5d7-43f9-866c-ba0e19a8ce3a,Educational,0.6138203300047131,11,26,602,633,31,92.09853717548717,8702
2b312011-7129-46ec-afcd-b13de5769585,Commercial,0.3836574285720272,33,8,506,1174,668,74.19299767160574,3364
3f0ef137-26dd-4926-a39f-875dbf75b98b,Healthcare,0.5822069532963199,33,36,426,879,453,25.72908008162037,7282
5ac3056a-34f6-4c0c-b8e9-2d93f17d08f0,Healthcare,0.2562643004841725,11,21,1,1383,1382,30.08066247940027,6886
e2355e83-a50f-4656-9964-b7c0db806bb2,Residental,0.3062096399498535,30,6,307,922,615,66.30899842400424,4357
955d6c16-32a5-46ff-9191-9fbe6feefa96,Commercial,0.5125556697554332,24,30,541,1329,788,74.66828645670371,9855
2dc2da7f-9339-468c-a72a-405169d63223,Residental,0.08516260115608643,6,1,435,1045,610,86.51250224341156,6437
99ef7d54-4603-4ead-9dc9-06e96a657ad0,Residental,0.19012932717965492,8,41,388,1014,626,78.75539283867634,9465
f574583d-a235-4721-9940-7ce3d79e1379,Residental,0.4136290064557806,7,42,410,871,461,52.197979742598186,6930
60b204ce-3b30-4b66-9ce0-1fe731a9ff95,Healthcare,0.9550553749250296,18,36,668,1003,335,98.77932125563673,8031
8df61e1b-c6e7-4380-8d27-ccd2b760416e,Residental,0.3467812234801171,50,8,487,725,238,11.417987595079376,4577
e461ead0-b91c-4c97-8f3c-205be871a412,Healthcare,0.20589458368635782,6,44,248,1191,943,73.54295411117158,2713
775cd6d0-2e90-4f94-bb5f-782dc7b337d9,Educational,0.8429053174860988,41,50,481,975,494,63.77366960132964,6191
faf01fb4-0164-40d3-97c4-3c28bbae2e9a,Educational,0.6044740131117887,34,45,558,1109,551,10.389994418485877,9781
30849f99-8440-4fbd-b5e1-71aa8c3bea3c,Residental,0.697352893131262,26,25,444,456,12,28.074918733594224,9879
d89e9dc5-d614-48fc-b84b-8833bb428bd7,Healthcare,0.8730163040154552,4,33,461,1142,681,27.828601114697157,3172
c9777bcd-4afa-409c-809a-bb8e6a968707,Commercial,0.9805311514807983,44,47,47,1017,970,65.26073584651573,8308
a4efb383-162d-4893-bbf9-ba27892857fb,Residental,0.47013651011291224,6,43,719,1328,609,23.61891807227367,5923
45109b2b-be8b-45ed-bce0-e5b8dd77fa22,Educational,0.41727547278366806,20,5,622,1144,522,46.3748648799249,8872
7ad00458-0b7f-4aa0-aaf4-397638c716f2,Commercial,0.4634028647626617,2,44,403,947,544,62.73049912019367,9243
2e0eca74-d744-4be8-b790-ac7844ed12f2,Commercial,0.8626242215216434,11,43,53,1102,1049,76.41920298793421,5904
ea381f4d-acbb-46c0-b490-aba1233f245a,Healthcare,0.18058962168640924,26,10,227,840,613,64.17470409501452,5279
6c0a18ba-dd5a-4f6b-8d1a-5e626b4f5257,Healthcare,0.7444152659041663,6,29,3,1438,1435,60.825347021466385,7297
8a6f8e49-eec8-4955-9838-45ec3f114766,Healthcare,0.010385400655669397,33,18,97,1431,1334,91.93049106199457,2615
e641bd80-ddc8-46d0-b5b7-e8628f640c6c,Educational,0.46339787658689047,3,40,295,1426,1131,32.02337511110981,2845
bd9b6f82-17c6-4846-ab38-8fae424e2271,Educational,0.4655074398317839,9,21,163,835,672,69.43107733165839,8506
1fae513a-84ed-406f-adc5-eee1dc724d8c,Residental,0.8408641479804445,1,24,136,1117,981,16.767011247355043,6110
ba558051-6f40-4594-90a0-50a9ac1f4e3d,Educational,0.5044960490045521,21,50,645,1350,705,35.763431347306856,6455
5ad1c269-ec10-4b60-ada7-07f209ab7516,Commercial,0.6486687026947406,26,33,579,1191,612,18.80337302884456,7036
7a0ed3ea-13ac-4862-85eb-280728ed3d10,Commercial,0.07846419297276075,11,25,452,1377,925,96.36362679042519,9115
ace9c887-94cc-428c-8092-73aefd631755,Residental,0.4013695212588706,7,50,491,628,137,39.90496517818602,8639
7f311b67-1eef-469f-aa76-3fa5dbb3bb19,Commercial,0.8668276240861277,36,5,581,1081,500,28.06862739426945,9954
00074884-015b-407c-847f-22603a862bbd,Educational,0.7598928541069131,11,48,524,1157,633,18.38102960296036,5482
a5f539b9-6553-4a03-89fd-3fa0afa992c5,Healthcare,0.12737152197970214,10,35,35,170,135,30.419701306042846,6200
b1a0fd6a-9d7c-4bf2-84e3-2c57aeb90a3b,Commercial,0.9539113219520997,9,20,81,1073,992,24.095196376960956,6096
8e2660c2-1c1b-4ece-808a-3737e212362c,Healthcare,0.7126682311824465,31,4,521,1005,484,51.288614275240484,5753
62c0c30a-6006-4a97-a1bb-27306d511ea6,Healthcare,0.4049524620899232,17,3,535,1210,675,94.20032852430418,5489
cabe9155-2f19-4eca-ad38-f3e73584ee96,Residental,0.34398855149807717,25,7,273,574,301,14.966802671713205,4365
76d91106-4df7-410e-a8cd-3aa943a8ceeb,Healthcare,0.41159304789170825,40,26,479,1256,777,31.83576615860341,7846
06bf86f7-0d6e-43e4-a5f9-66773cabb019,Educational,0.7792582776875392,13,5,446,539,93,65.3150273364846,7448
8bd9bdd2-7fab-4f6d-86b8-a3c820271a2a,Residental,0.9649840964216855,1,49,594,792,198,85.44138650569802,7029
a98b141b-986c-436e-a450-1d4cecfd2eb3,Residental,0.5321768492610096,18,20,607,980,373,62.25001294702076,3109
f304e4ee-7c84-4b11-ba60-090ac4d973b3,Healthcare,0.7688736464979136,14,43,21,1038,1017,11.960616255477808,1371
f5439caf-c89a-4f1d-8bbe-f07118356d0b,Educational,0.047957063626870355,16,15,215,438,223,40.27376592332682,9270
9c1ed549-8a76-4440-a4ce-0026586c4ad7,Residental,0.24732492170933384,17,48,176,555,379,45.747577147772326,1896
8a03dbb3-2dbe-474b-8289-c1f186c53ce4,Commercial,0.5002218942784,3,26,377,1361,984,18.820247639749866,5290
155e9d87-97ef-4896-babe-1a522a014f67,Commercial,0.41557200496941293,34,33,285,427,142,81.43929774333677,8051
1278bb0e-93c2-4568-adbc-15a81a8bc5d9,Residental,0.2151230448099174,24,50,408,1412,1004,23.682425385694053,2484
c7ae052f-abe0-43b2-956c-412b04e423ce,Healthcare,0.8515782678842599,15,50,568,852,284,87.02334103179469,8780
d5cbaf74-fedd-45c4-941a-82c566df6ad1,Educational,0.8808960335086264,40,2,498,935,437,39.65327787315519,5355
4a77ccc2-ae2c-47fa-b6c7-f4994f44b044,Residental,0.17503740189510253,20,37,137,594,457,70.8811529712431,4794
0bdc307b-72b4-4331-a572-63ed350bbdd7,Commercial,0.13172082160137233,40,14,289,986,697,53.97667434398917,7173
647e1b1e-a527-46ed-a100-ec7cd1bdae6e,Residental,0.27863543613997754,34,18,594,917,323,36.08657827625056,8060
2dc54760-2389-4f9f-9601-a4f505911b51,Commercial,0.8901225732180665,20,9,644,1316,672,72.48825111526985,5071
b5e9dbf0-c555-423e-8117-3dc61d08d209,Commercial,0.9625992771403936,36,40,418,620,202,40.2402748474491,2348
c5bf9842-78e1-450d-b688-c77d080cdb07,Commercial,0.18095761282759393,19,49,335,607,272,48.43219081228565,7473
b12f1fc5-1bc1-4223-8204-ce14eed3aa85,Residental,0.2295859656588527,9,38,219,909,690,82.70159368774063,5892
f098dbf9-afd2-48ba-8cd2-df1fc3317da1,Commercial,0.9109686999064014,4,11,692,765,73,16.920975821074126,9422
2d85a7f5-403f-4963-ab5f-c958e1949187,Healthcare,0.5708868185165977,49,47,533,1157,624,33.38267932784123,6110
7fe66685-2a14-4d32-8de0-3956f72fa525,Healthcare,0.925496160133612,39,15,652,1313,661,95.7190023095269,8820
934d81a6-50cd-4559-b6e3-4ddfbbcaee1b,Healthcare,0.03496558230286173,46,29,647,947,300,87.42639336493673,7593
b9088172-0246-4ef1-951d-549803db78b2,Educational,0.7919867276765882,18,5,538,842,304,25.733663898429953,9279
50ad492b-2b1f-49d1-9ef9-5d428bc9376d,Healthcare,0.7828462566015089,1,24,323,488,165,15.17468451701794,7002
71c57a46-dca4-4dc8-b2c3-3b42c8306e07,Healthcare,0.172416458800002,23,27,275,433,158,38.67511012864689,3724
3e9f3cf2-bf03-47ba-890a-a990d19dae0f,Commercial,0.6168690459591856,2,37,168,540,372,34.494014437115396,9364
26edc3f1-cc6c-44e3-8a76-11e85164e20c,Commercial,0.9883480965367389,27,29,504,932,428,62.12307548532119,7375
b42ff7ff-7fd1-46b6-aac5-e58492135e5a,Commercial,0.9364551324509075,39,3,146,401,255,85.46415909971324,7105
fb866018-048d-472f-bbaa-0f865009f8f4,Commercial,0.3262229221113322,36,26,648,1162,514,19.206325948794724,9053
f6177581-7e77-4b0f-bf46-7ab53e8c6357,Commercial,0.7797198029712125,12,28,39,511,472,91.41530470278418,6783
d0b9f98c-7fd7-4280-8d0e-6a3754d13a47,Commercial,0.4951649281971984,50,14,608,1418,810,56.544895002589655,7023
de21aac7-79c1-4180-9332-0d08982691b2,Residental,0.7674320575444308,22,37,76,1120,1044,45.7267307880588,4451
ff85ed0f-b8ad-433b-83d6-3e33515e1985,Residental,0.08942374467490344,41,38,616,1347,731,26.694388283575837,4522
fc807b41-1de7-4662-b2d9-2c2c2a4d3dd3,Commercial,0.9885022147236537,23,32,679,1200,521,73.24497640884746,4730
393e2e34-f874-4b47-8b4b-2331360ab96b,Educational,0.7407893863185069,38,38,696,740,44,44.64371170167242,3844
db7a471c-1bac-43a6-8e94-c10cd612a9e1,Commercial,0.7879777280764,48,14,411,812,401,76.28583327754328,8606
44336f8a-768b-48b4-8da3-59780dc5dc98,Educational,0.6614353725334655,13,43,97,653,556,41.88652764153282,2397
e1d7c8cf-712c-4af3-9f89-2815b976b99a,Healthcare,0.2311163942765685,29,44,602,689,87,65.92281923809665,6618
f438809e-ea5a-4661-84d0-050cf25ac098,Residental,0.2181709240666576,29,29,708,1158,450,74.87492848828882,7361
81780752-fbac-4743-ad36-84428af66b1b,Residental,0.10219630543104175,41,12,476,816,340,22.85226450242044,4809
2b4e4667-fb92-47ea-b58a-b41e0103d3ba,Residental,0.4542086372658063,14,30,565,1311,746,12.114362168332354,7669
6a9893a0-7c9f-4fdb-a8dd-1f7394d496f8,Healthcare,0.8117085211660646,15,14,113,711,598,92.10138958578116,6924
5ac6864a-7eae-4c06-8555-244f1bd222e9,Residental,0.9885719558111918,40,35,127,789,662,28.409940626331924,5041
dacc1f0d-af1e-4250-87ed-dab948ab03b9,Residental,0.504070969985027,25,4,2,1177,1175,55.47306455900965,8066
1f2b0f1e-8b35-4f42-8320-8b4609d73de6,Educational,0.22612119938517916,41,49,424,852,428,71.714861497231,8464
c6a76982-144f-40ee-90d2-e5157b2b9f3d,Residental,0.5232540056940732,40,20,492,1397,905,97.798203749311,8549
e4fce7be-f1fc-43b6-b7fb-51db94bd17df,Commercial,0.9808609886453933,20,42,638,1235,597,76.80201933487712,3936
b218b694-5a51-48e0-9a21-feec7f19d210,Educational,0.19508774072110258,26,48,47,435,388,40.82832220847405,2880
3e99ce6a-cc87-4404-80b9-5ebef7572a57,Commercial,0.7826921665442138,7,39,597,1195,598,26.832557842581505,1410
3af8c870-9aa8-4bb2-98a3-f9c9658e53aa,Residental,0.28570187615901044,50,46,121,990,869,67.77805495043405,9602
73293b18-d998-487c-97fa-932fe4963fe9,Healthcare,0.6751421895868391,27,46,368,420,52,95.99807166941528,9945
5b2b6dcd-c979-4aa8-8398-7ec66d939671,Educational,0.8528788474032537,36,2,530,801,271,42.24060209645922,8480
a92cbf61-4e63-4397-9477-a1658657ab59,Commercial,0.5219633066381534,44,33,33,42,9,11.034301936308776,6178
3448f38a-f7f3-4063-8f4b-45098d527da4,Commercial,0.7575452951354967,34,41,394,453,59,62.3010207831824,9296
ba285082-3470-4b2b-b44d-ac49315544cc,Healthcare,0.5897201174148058,25,50,504,1158,654,85.12109894520675,1587
207e96bd-d276-42e0-99c2-94cf01c2885f,Commercial,0.07808513841658271,18,27,60,788,728,79.63720119855307,9984
8f1722c8-787d-473a-9eb4-4706bd6c0f67,Residental,0.13031471159603203,43,43,49,754,705,86.38545806079009,6183
331d51da-05fe-4f8b-9d96-9e7af51f1040,Healthcare,0.7430639799018309,32,37,10,880,870,12.94098286419316,3046
69732c41-9c1d-4774-b4c4-b0b0b1586d8e,Commercial,0.9565761876387137,18,26,31,365,334,37.28123451324821,7334
3b5f3e6d-8ba2-4898-b957-8cc6570c22d0,Educational,0.6030194256572837,48,25,196,210,14,19.23837619170105,7419
efbde4dc-be01-4091-87a0-fc1a8314712c,Educational,0.1086803398729167,26,28,526,1399,873,33.04203468268139,9103
56477940-2b69-4f4a-8ae4-10bb0cb481dc,Residental,0.8999394146578424,13,25,627,770,143,16.3456367179647,6575
085bb2ae-9b63-440f-aa7d-86771c33cbc3,Residental,0.9085621854949362,16,45,416,1251,835,83.06933132867441,3136
e90878d6-65b6-4fa0-9473-8e4c7a0089e2,Educational,0.7964573248795351,8,31,28,505,477,11.27850382481306,1238
f248c621-498f-48fc-a34b-fbbde0a43407,Educational,0.4807984167779136,32,46,156,1241,1085,67.50042938180869,6399
03c26725-be58-423d-993c-1b3d82aa7263,Healthcare,0.5217092085099778,11,47,263,1046,783,72.22572525669227,4425
2f6ee872-a3df-498a-9c4c-91a8076a45d1,Residental,0.7339406553076234,18,34,189,889,700,58.11247375472367,5732
7f537e54-212c-4d07-bb2b-d731e036eaee,Educational,0.04964579343113118,23,50,527,1210,683,98.08681587860788,2307
8eef369f-c0a3-4771-bbe6-c1c9d862d94c,Residental,0.35640743355642635,49,22,677,1050,373,94.87442225120296,3032
96cf11ae-12f5-4584-990e-3e665471ab69,Commercial,0.7521262677342874,15,2,475,1217,742,74.78505166975778,9206
3d938651-0868-4b02-a558-da8879ac5810,Commercial,0.28769139011069034,22,17,461,1102,641,50.49131047024463,4846
2eb34aa6-ef04-4615-9d9d-304e821efeec,Residental,0.6655391308361132,49,36,82,542,460,21.21619140146941,2261
784723b1-effb-4348-beba-3b7f806b5819,Educational,0.071270913369616,32,50,478,1266,788,75.99378590892111,3486
86c3159c-1d95-4f1f-a23e-2564a14e20ed,Healthcare,0.6407289783716243,39,10,387,1328,941,76.86555753298258,3997
f469ef85-c4d3-49a5-9b86-7e37f3845d82,Educational,0.6031700455310752,25,49,3,732,729,22.609363030153858,4041
12eedfe8-0607-4a3e-a618-e1185d5f5eaa,Commercial,0.6996945264635476,49,5,504,837,333,94.05736385099438,5881
80fc99c1-189f-426c-868f-b405f3db97ac,Commercial,0.46679720934372404,26,45,223,343,120,81.7582352679042,7484
42c683b9-8135-418d-a957-e1175cc7ad35,Commercial,0.2153653529959021,28,11,490,1132,642,80.74792939182277,9565
e07893f6-71d9-4578-92b5-a942c05ce550,Residental,0.3714921203760435,23,22,206,1261,1055,97.41666995642969,6707
ea1de7a1-5dda-4491-8061-1ef82a8cb8b1,Healthcare,0.907893721706841,28,30,465,510,45,66.83593451179158,4440
30aea71a-104d-4b83-8c0c-87841aa70793,Residental,0.9815134508040205,21,1,61,305,244,82.91065045661347,6491
ced8caff-0790-4b8e-afd7-9fe643d2c43a,Residental,0.06427090665915647,35,13,507,597,90,35.741225336127584,6294
4594ff0b-6b5e-4519-99e5-276e30b1bae3,Healthcare,0.7405347322964008,6,32,334,828,494,39.3824143942436,2538
9035139c-f4d1-453a-aebd-f4d08b441db4,Commercial,0.7798945473325265,50,25,91,1395,1304,98.13944746030899,1342
f1aef880-7779-4fb0-9765-51495f3aaf72,Healthcare,0.9805243875154521,34,22,358,1017,659,58.20856379022908,4650
d63e75b5-005e-49a3-b1ab-9c8312455cb0,Residental,0.6669967797201395,17,12,662,914,252,64.58626850854479,4108
82aa023b-949d-4cb7-87f5-4a9ede8f4344,Residental,0.16024402637545787,45,9,475,837,362,62.20861488783168,4717
25d6f923-1efd-4a7b-98e5-0c03d680e1df,Healthcare,0.7533591559608852,38,28,680,955,275,95.29498075909028,8723
6989e16c-3ef3-409d-a141-fa6d4da9f8f5,Residental,0.6941269451660836,14,29,492,552,60,83.43584311284606,6662
b09fd33d-d725-4abc-9ff0-20cec5972c67,Educational,0.870877351224288,34,1,358,771,413,66.27579716658431,9945
9f32506e-a65c-41c4-be23-aec39d0eb472,Healthcare,0.7094348703785116,47,48,203,861,658,74.13123263263434,4542
8a70cd43-e38b-47c0-8235-1fbb5e99da98,Residental,0.7877236977475967,13,43,656,795,139,87.43517002299485,3297
f21b1e4e-5a6f-4e20-911b-88778780acee,Commercial,0.9770283164944072,6,32,421,861,440,81.52639537782277,6300
9ace0276-0dca-4fa2-b31e-fd940e9707f1,Healthcare,0.20206763089724533,20,34,343,938,595,49.951007948352434,7450
ace32645-fd5e-4b17-9125-61c1e0cd74e9,Educational,0.9297957037920549,35,10,610,1374,764,72.84671882207215,1816
36ed89d2-3d97-42cc-9364-104bf7c4450c,Healthcare,0.4524079793346142,30,13,632,1063,431,84.25519208900914,6315
f32cb16a-c75c-428e-baca-3bda502ba745,Educational,0.009654520401142785,48,4,239,1030,791,90.89463788293436,5089
b9da1405-73c3-4d2a-897b-d0500319b43a,Educational,0.6884347885439716,20,38,307,686,379,37.394718839534534,4599
b5be3199-e1ce-443a-ba22-8ab749847d7d,Commercial,0.7042353212084811,22,8,231,1333,1102,62.58452507875544,5803
5cbaef36-3cc5-4984-bd7a-e5392b738c1e,Educational,0.6858431428908278,20,6,496,720,224,88.85901499313535,3971
b285b476-8bc8-475a-9246-9a2ffd1d0c33,Healthcare,0.19327310277371168,27,46,290,290,0,35.02379733590808,7433
12929167-c5ae-454e-bc62-79ed1dea06c3,Residental,0.052773924498953795,21,42,495,941,446,27.675041743547695,3601
20ab4af4-7758-4edb-ade7-17ae540cb93e,Educational,0.25474249467937726,29,36,598,1169,571,63.69215811980892,6500
e380fc1c-6298-4add-b5ab-98ef765e4bf8,Healthcare,0.45663321584331007,1,31,291,845,554,13.873829005527767,2021
168ef140-3839-416c-b475-7d84572a5e13,Commercial,0.02916828497113555,12,30,416,1002,586,53.65900324730404,1004
d003e00f-6790-4939-b5db-a0751aba83b8,Residental,0.054577364354667646,40,22,276,373,97,63.18175550464051,1924
06341491-9252-4dd6-b6a9-fe837641ee20,Educational,0.6916967691390412,39,28,33,555,522,27.237549060829906,1337
c17663c5-5cbd-4355-86ff-f565394395a0,Healthcare,0.5723284374012828,49,48,216,453,237,14.984361704238637,2545
ee14c13b-d2f6-462b-8813-06b2c94e66f3,Healthcare,0.7454984987550368,47,32,346,721,375,85.43743666838867,4985
2fdc16ee-0688-4d4e-b779-b329d2142c08,Healthcare,0.6532178565119563,6,2,191,232,41,75.43289801702366,6365
6e8de9ed-db3b-4d2f-bc5c-03e5fdf36e06,Residental,0.4223979302354568,39,36,473,616,143,11.489894817992585,6817
043e3b4a-3d03-4bb0-bef6-6c7266464a84,Commercial,0.22258378929837797,10,38,297,1378,1081,50.610045317284346,2857
59c93a4f-93f7-455c-ab6c-5b0fe7d350bd,Residental,0.7783263819031888,18,25,436,666,230,57.058225718432645,5775
0a528d9b-0316-4cbb-b707-e81ff220d658,Commercial,0.1807653003669063,41,11,511,1082,571,71.160276376009,4388
9d0a6bfb-fdca-498e-b253-034cec81598c,Residental,0.480265323180731,8,49,679,1056,377,58.97222757438189,7733
8c6e5d06-afe5-430a-8e25-fdfe8d481d23,Educational,0.8603947803908577,48,6,570,754,184,76.59062455019125,9190
4fffbbac-a526-42b8-bb4a-46ac1b691a6f,Residental,0.0956756893229227,14,43,112,921,809,61.458568345712145,8259
ea179242-05de-457f-8057-2ddaf57fd911,Residental,0.6669998744854712,29,24,654,655,1,93.92542237849302,2434
54a85067-becc-4966-b243-3c39844a9141,Commercial,0.8380988013810101,47,1,586,677,91,86.77468026289701,1045
da6f802a-387a-4735-8fcc-b99286ad50fa,Residental,0.6430024105890009,3,48,414,1352,938,60.96083790075393,4875
2cfe255f-4a32-47de-b4bc-2fe3dc19c919,Residental,0.39814254598448906,49,35,355,766,411,18.224782570570056,3960
1f2ff1f0-38a5-4f43-97a3-bfae8b1122df,Educational,0.7826551796029864,34,41,190,803,613,11.195572944443583,8644
87d2ee29-6799-457e-9697-acc4a7320f03,Residental,0.805157859244407,19,36,430,1319,889,80.01370878303,1908
5c9363fc-6065-4c7b-927d-74d9f3a025b7,Healthcare,0.60980878562644,32,15,233,1193,960,39.69904220160194,6473
50e15562-6824-4158-b4ce-fe867f681b6d,Commercial,0.8600602212177315,29,30,519,1282,763,63.91341738899782,7946
6a503d31-ee9a-434d-9e1b-92f2c4bcc0e0,Residental,0.42818273498489734,35,36,204,1174,970,17.93692633586165,2755
ad3cee6a-dcb8-4668-997e-2218bd3d7db7,Commercial,0.5667961606778671,5,17,561,927,366,25.78902572172369,5396
1401c9b7-caf4-429b-b4f1-bfe52414e017,Educational,0.1940109449185462,24,10,150,1169,1019,33.25562418616162,3730
ee5da0ea-dc6c-41b2-91a7-6e8b0b110d71,Residental,0.7902276784506849,26,1,173,1160,987,18.80456602472826,4355
e0a66e08-0ee0-4d29-a642-5645d4784730,Healthcare,0.8952252083028982,24,45,32,821,789,85.90232482797796,1250
aa2d27d7-b3d9-4205-a990-cfbcd9a17498,Educational,0.743703053802438,16,22,224,439,215,41.32547735900602,2358
00509763-e1eb-495a-91d2-c6025ecd9c2d,Educational,0.25105730497234124,17,27,113,781,668,53.23987249849271,1613
0aa5759e-ccba-4068-a783-ed9f8486bea3,Residental,0.2790260596167491,19,39,83,760,677,74.94945769956153,4384
aabed196-44a2-497e-bdf5-5edcf07a7248,Residental,0.5753414333938408,6,37,134,652,518,79.32132969014926,9589
3efed755-3052-485b-8f9b-0064027dde26,Residental,0.12340196257686642,15,27,7,498,491,63.35568605510379,6549
5ea1ddd5-9391-424b-8c3c-7059adc5f776,Residental,0.7835686823651373,5,9,401,1425,1024,99.42685000494987,6418
92e58538-259c-40e1-97c5-0f14343f4e24,Commercial,0.9738681462642873,39,48,277,1084,807,13.958092391754947,8563
a799ae8e-7276-4035-bfca-1f2b9ebb84bf,Commercial,0.5942809164636605,23,8,426,794,368,87.9745472812804,6991
ad64e631-c873-4f35-8068-a621b5e34a08,Residental,0.11807939938066792,4,3,619,689,70,49.77138495574695,6069
f934a70a-c504-4d28-a0e8-70fd2fb15079,Educational,0.595260982462601,9,49,413,1303,890,49.84503302119362,7481
7a097a6e-7b1d-4e9e-9d62-e0e89dae0f5f,Healthcare,0.8755656220797455,13,19,230,745,515,32.11207249081215,9727
70b386e4-8260-4d06-b1f9-309f6fb06c2d,Educational,0.13006316882258895,20,35,24,37,13,19.650135774954478,7057
ee550666-7aa4-4567-be85-d83a218336c7,Residental,0.33766714952588506,47,36,424,491,67,25.56490771652434,3050
ca7f64e2-0d75-4a6b-9fab-bc3ae9c6d526,Educational,0.3298754959047471,24,2,408,1090,682,13.105813687487917,5629
171e56c5-c812-4c0b-b751-4d2cbe8c6ce3,Residental,0.910737420379221,42,42,379,1083,704,93.51875994529424,1506
f121a396-a558-4b64-902a-f09fcceb966c,Educational,0.4804330836368821,32,4,485,510,25,34.07664623723249,8213
2d1c0770-fee3-4ddd-a03a-edec9dec383c,Commercial,0.9444467025417697,15,40,110,334,224,98.98961407942002,2613
1dd4335d-2721-4e34-8801-233f223ecbd2,Residental,0.9696580178206017,49,24,645,1046,401,98.49427967458371,9016
36cac91f-6b7a-4f8a-8c58-dbe92614a9c1,Commercial,0.7273392878705263,12,50,25,998,973,48.49732962971948,1536
ba087ae8-b96d-41c1-82df-c8229d32b965,Commercial,0.12369615318299132,18,46,158,836,678,44.05584410205031,5151
7009fd14-cae5-4fb1-81f8-a49842d69beb,Educational,0.7525490611872137,20,10,450,732,282,76.41366258896325,6427
ebe04b1f-3db7-4f2b-ae13-83b11956c9fb,Commercial,0.2560626060818032,20,40,272,488,216,96.10926594029145,3286
e1a24fda-06eb-4457-86ac-d3629799ecd6,Educational,0.8017055120429025,21,31,705,1038,333,43.64642317550178,9992
c9d0c7d2-a3e7-43c0-8a49-bc2209faca4b,Residental,0.5337826931467007,41,39,298,558,260,68.76483716394108,7589
047dd9f9-ea84-4bd6-9e56-79fc3961216b,Healthcare,0.08277385622165079,14,44,129,877,748,30.497955054735304,5202
8323e0c0-a62c-4008-9aa6-3da23823e59c,Healthcare,0.38187534411323953,11,35,640,1117,477,25.761379671481222,2309
55599e7d-3258-45c9-b7bc-97c83260641e,Healthcare,0.982815590282018,3,28,95,1224,1129,71.81613626070869,6179
37f47eb3-5612-4a88-a963-0b783c6fb775,Educational,0.7667292193949079,19,26,719,1266,547,41.79613782826786,1617
8d73814d-6f05-4b5a-9aee-3be76d1628bb,Healthcare,0.045725691025478854,34,17,663,775,112,58.22918783698842,3876
e8afc4d9-bb60-45b8-b010-2e26e6e10436,Healthcare,0.9130038892348069,22,3,623,911,288,29.739981253502002,1875
2d0e5e94-007a-421a-8039-2851363c9b55,Commercial,0.9623259057467749,33,31,363,473,110,14.864078664881788,9728
65e335cd-6895-4cd1-92f1-8ef76eb46445,Educational,0.040949516847225476,10,9,548,1402,854,87.07700346571981,8907
426b40eb-70ad-42c6-8ea6-aa456893c541,Educational,0.5964737108483379,17,20,215,842,627,90.67846382015358,4528
65d786a2-e8e2-490a-bb8b-a050204143ae,Healthcare,0.2562900837913663,5,36,16,135,119,71.51683029316727,6392
c1ffe64c-e101-420c-8666-6d22d54d93e2,Healthcare,0.8516956513214853,16,22,651,1314,663,61.22808768298367,2493
c5734654-98d6-413c-a375-a45c0fc23749,Residental,0.22893697073419517,44,21,420,747,327,59.68917076232799,8058
b33e37f1-c3be-4a8c-a4c9-7caa091df056,Healthcare,0.4623896089121372,14,19,484,1406,922,50.95474863459288,7487
ca2bb07b-9b84-454c-8242-0ce4e97430e0,Residental,0.6812298723668543,31,8,663,1131,468,67.63897299027798,2474
21aeba0c-9b81-468b-ae04-99d56220f0c6,Educational,0.9581063454146468,33,14,246,540,294,59.65663305543255,9686
98d9655c-6d91-414d-8c2d-da58f1f18f8d,Healthcare,0.8489138845240152,39,40,195,976,781,31.01171998455892,1060
f87a6afc-8e76-4e05-b220-e5ac64d35c99,Educational,0.2582588677543619,25,38,589,1250,661,57.82380306913579,1691
2ce94d7a-ab95-4e78-80ac-ff1f066ce9cd,Educational,0.4704912417943463,40,41,383,892,509,93.87229827853483,9770
cf2aac1a-54ff-4608-85f0-269fd3e4b542,Educational,0.5032377962426151,15,9,78,238,160,14.91767990166199,8173
7c9cfd84-0a4b-4d78-8801-3d465d2dfc7d,Educational,0.10980040041756856,47,32,55,299,244,87.89729923057635,2492
e0aca8ba-153c-4897-bc79-5be4bf9f6e43,Healthcare,0.48499190620411936,48,31,242,1293,1051,50.085315050097606,7613
ee3396ec-6793-4f94-909d-1ef062c01735,Commercial,0.8975959466140698,25,24,236,1402,1166,68.40951169738784,6491
2a35ecb9-78ac-4713-a396-de64af57b44b,Commercial,0.9086340258790842,36,35,339,581,242,33.72971987839048,3542
9806a8b5-f064-4145-a5ab-ea5e6723b2df,Commercial,0.029044801650875973,6,48,639,1170,531,58.64449876311838,3896
252ad788-0eed-4cdf-bdd4-4b020830f04a,Healthcare,0.17002887051855375,12,18,460,1345,885,67.56969298394705,7761
61b1c1aa-c3ff-4f7e-9a92-7ab48c1f0e2a,Educational,0.6867942113037194,35,45,337,533,196,79.7305625564917,7241
541a1767-a717-4700-b924-8ff39ba11ac3,Commercial,0.7376822766745541,9,29,390,1072,682,63.39523436250908,6829
00644002-43e9-4a1a-a660-ca72451bc425,Commercial,0.9005151020499459,11,4,379,833,454,15.433444838325226,7571
daedeaa2-0519-45b9-81f8-84c8bafc032c,Residental,0.12212005201094878,6,43,33,740,707,37.997163603882214,4170
5ede0978-cd83-471a-9d77-3277ed5eecdc,Commercial,0.9134520964806525,17,48,450,994,544,43.51409124089127,4292
ad62ed83-e238-40b4-a61b-bffd2562e041,Healthcare,0.25924161403174795,13,6,71,200,129,62.85301627766958,1020
8b69b1ab-edcb-4b29-bb9b-6d7533c162d6,Commercial,0.5406860889477763,24,20,103,137,34,51.96627318077992,1667
2945789a-f0d9-435f-aa5a-a678fba0d333,Healthcare,0.8244690137770222,12,41,586,606,20,69.94986347396645,1439
80d90aa0-10b3-4f7c-9c4a-8ba12ef9f34d,Educational,0.13638305503776493,43,8,175,1187,1012,41.803900499625215,4314
31613e4d-a8a3-419e-a09c-617ac17e42d3,Educational,0.7559958448281748,6,11,588,1189,601,45.04045312628721,2654
75451c4b-a254-4c8d-96ad-23cb277f5110,Residental,0.4098435892872332,31,47,462,1409,947,78.4500172367356,8307
4f992b62-1d7b-4b3c-85b3-543b7a9033f5,Educational,0.6563346013809979,7,11,461,1285,824,37.980697691446565,6150
ebeef285-7864-4386-942a-80713bdb65b4,Educational,0.6230793185625786,4,24,174,1312,1138,56.70019140612695,8753
9ee921f3-74e9-4c0a-b8b9-866b6d4ed154,Educational,0.9979317404762714,30,34,363,652,289,36.496359356804874,2085
0adf0773-3508-4627-9f40-b0a8a0544ba0,Educational,0.4966849471039353,23,26,452,1184,732,73.42182027990975,7063
0dd3db96-a019-4a1b-bd3f-e9d809b0e726,Commercial,0.5477721717162382,31,18,16,103,87,88.91038521145546,8374
a32e1bd4-3525-4b10-877e-b54fe7b24bb8,Residental,0.18463006139342608,40,25,532,1401,869,64.35704980358267,5195
19ffb6b0-5546-47eb-9209-c255c585627b,Residental,0.32673036252825416,21,39,240,1077,837,17.64755790208329,4957
ca1b9528-1a72-410b-8f52-2d8f44cc9cb4,Educational,0.937944556678869,31,18,102,1342,1240,30.212807543607642,3586
baed33e6-eb61-4a53-a6ec-38a22e234df1,Educational,0.12276609871660682,44,26,303,708,405,21.412944025417552,2936
2698e4d6-842e-4dd0-a16f-074175fb5e5a,Residental,0.946338017276946,40,43,533,1078,545,61.96803666195526,1818
3972da1d-2de3-4f10-a60e-855a6082b19c,Educational,0.0711668776619474,39,8,363,881,518,97.44424642678251,2170
5fc008d1-ce12-43c5-a7a6-d7d88fa48ade,Educational,0.25879794898390673,3,13,228,1255,1027,79.65522458414233,9795
0ffc2c67-847f-4906-ac73-3cf16b605437,Commercial,0.4218342673071116,30,25,222,401,179,57.4557500181929,6151
42f85394-4c53-4f57-b63d-f9e558b67c9a,Healthcare,0.19553482907838582,22,32,54,669,615,56.68149031940139,3616
93c5c176-11a3-4262-a117-8bb273322dfe,Commercial,0.26444712617088584,45,28,441,1408,967,25.622720484073437,2943
3ce80f19-ff56-465b-8486-82a4a2417552,Healthcare,0.8025411793497416,49,45,505,1091,586,55.754357456136475,3094
d2e67299-9b1a-475d-adef-f241fd20e1b8,Residental,0.9833204640255784,47,42,466,718,252,53.84951071586863,3821
df2bdcd4-2b48-4891-a05c-9ae0d7ea8961,Commercial,0.8225331101562494,31,10,68,407,339,64.07992004282579,1853
2f16e99a-a68a-4664-a110-90d0d0736b5f,Residental,0.2293515583805663,13,27,134,1232,1098,86.97221626890706,9219
9f3b96d8-61f4-4c25-aaf0-d651c363b058,Residental,0.2538963751441876,41,49,70,787,717,61.82106278801372,5781
698dc94f-5b85-4a13-89df-ebbc6049986a,Educational,0.8359673174152834,5,10,630,755,125,65.6601130058726,1806
09c7d7af-d20e-495b-a2d1-0928379afc6e,Commercial,0.978248049551844,44,23,237,1172,935,95.86311556749914,9249
54b2170f-5ac7-47bf-ada3-a30934e4b21f,Commercial,0.0619794017580696,17,15,483,1234,751,21.43291053838822,9436
f9ad9fb6-bfbb-47ae-ad20-e11ebde96700,Commercial,0.31958197742021843,25,20,427,1422,995,55.16006337055862,3724
219c1e26-9662-4693-b303-69a0c533dc42,Educational,0.38172392941268796,42,7,578,895,317,76.02655351619757,4926
38c4def6-0c89-4d4d-80ce-9caa3dd6ad97,Educational,0.016171539942285595,40,14,265,593,328,57.30459906302571,3039
bd04e525-cde1-4503-b259-ecbc85727e82,Educational,0.18772666870969112,39,24,185,1075,890,85.9925128907732,9237
88ba9ce5-72c0-4b21-87f0-c6244c5f9775,Educational,0.8672304695031398,25,42,515,1166,651,50.065394344469595,1793
21407eb6-8ca4-45a1-bf19-1df4ca9b8333,Educational,0.37993973622907296,33,15,539,1436,897,24.655736244495067,9937
1c6facef-2a48-47d4-b638-c7a93092e543,Commercial,0.4089935902661257,7,19,104,954,850,96.68516299760368,5385
4a283db1-c8de-471f-97e2-6a71e90f1575,Commercial,0.9265927745585438,25,47,28,639,611,98.32189163459299,4269
fd11d504-ab00-41df-ba5e-2efa46f53900,Healthcare,0.21282966013248483,1,46,285,332,47,80.61140982643369,3844
4e03d865-2d7e-4e66-bc9d-496b69b94a82,Residental,0.4120197875651336,26,8,438,1244,806,35.312735151316616,3962
8af7650f-e5e2-44c9-aa6e-82148eb2081e,Educational,0.5673595791325899,23,6,422,1264,842,36.224819465818726,3970
8c3acd4c-6376-4a45-ba94-a1ad3b6a653b,Healthcare,0.8696271635230624,23,24,512,553,41,94.74917947457446,9993
5b36148c-39b8-455e-a0cf-2ccbff806d26,Commercial,0.676550234023549,7,11,21,263,242,19.224562177164437,4080
b199b8f7-fd07-49b0-b167-7a66e1aa0cb4,Healthcare,0.21949982252071676,10,22,27,1062,1035,74.56400714975288,8629
bae3637a-8327-409b-92be-832d391a55ce,Healthcare,0.8373236946174067,36,29,598,1269,671,62.8616480044513,9633
e0a379c4-0a2e-4f55-bab3-81699990c4d0,Healthcare,0.9196628702611175,2,3,361,994,633,32.58734558423146,4848
3e6dcba5-4395-49ae-897e-2f60f396c367,Educational,0.08980584967340188,9,15,410,490,80,67.44678506440758,5708
b2bbf89a-7bf0-429a-a220-70a076ccb8f7,Residental,0.026413049764140606,16,24,7,843,836,20.17649570874696,9510
c379b24a-f6cd-4df9-87a2-5272211c0b8b,Educational,0.568776036378253,23,49,316,1091,775,78.72919986611385,6010
9286ae91-4d9b-40e8-b514-5e16a24b5273,Residental,0.45306726203039926,3,9,14,515,501,38.27337464367554,5782
3e2bb299-5d7b-4e88-9d9c-b9fb7862121a,Commercial,0.5346344408993388,50,2,718,771,53,20.319487805030725,4231
38207a70-e171-4a44-bb84-df7300ec22b5,Commercial,0.40990914784813515,28,47,302,1388,1086,80.17429806410229,8430
c66ca733-ffa9-477b-990b-059185c0c3d1,Healthcare,0.2327749446610966,1,33,326,1155,829,20.356489435143462,3180
8e7937f9-4953-46f7-aea2-b2cbec8f636e,Educational,0.4244963805755524,13,5,235,488,253,15.036556113125078,3090
e96033f2-3f6a-4022-8c06-4ea3c3904580,Residental,0.44110183765441446,16,38,526,665,139,35.73452601175154,5118
93da60f4-9a19-4947-9230-3d3094371016,Commercial,0.6889771085369698,46,2,373,406,33,77.62806578638443,9059
e130b54b-1f34-40b9-8a28-ee3f73c6ba52,Educational,0.026973954116363275,4,36,12,1104,1092,24.668449770062196,7775
9b365b23-ff94-47c3-a686-6afdeee0037b,Residental,0.5598100578703972,3,2,425,1135,710,39.100571561868385,1872
cdb713ca-00b3-4dfa-92de-7b7dd778cfda,Healthcare,0.6501319734730338,41,30,413,623,210,39.453743965780305,3704
dbd123f9-6f3e-4c8e-9508-c7ae2b73a030,Commercial,0.5793177942260617,49,31,341,1224,883,52.721047348928124,7774
f96592f7-2ea9-4185-b63b-c7dbb6ffe59d,Educational,0.7721528726526959,46,50,92,921,829,12.028986348860695,9067
7b7998ca-3a06-4841-b1db-3257f523fc19,Commercial,0.7887645598523113,23,17,257,1408,1151,56.304946618151575,8555
d81f0e5b-eeef-47b0-b305-f151c1c6dc28,Educational,0.0029811088405437003,14,37,7,1345,1338,86.97601693718107,6765
463eeef8-8ec4-4545-a2f5-5354978b0221,Residental,0.4243207786396509,2,15,501,510,9,95.77539518911124,3922
0ecde8b9-5dcd-4c80-b5c2-e69ed269b7d8,Commercial,0.4341682843282444,7,45,414,1376,962,12.003833881289681,8810
caf8135c-e6c0-40a9-bc1d-a1ebc30bd3c5,Educational,0.3091730748217073,13,14,719,939,220,87.41009345869261,7848
6bd3a720-19ba-47b8-9af0-93997b4a3667,Healthcare,0.010769350607702122,26,31,478,518,40,95.16248592385237,9052
142a5fc4-eb25-40d9-b2b5-3687ff1a0032,Healthcare,0.37482277552795995,9,12,517,661,144,94.79635122186716,4061
a9af631c-7f74-4bdc-9f6a-9223a0c6cebc,Residental,0.668339493550436,29,27,494,1390,896,70.53776293053338,9612
9aae19b7-216a-40f0-b6d1-f8e7c3a18153,Residental,0.6621671308613913,14,11,647,1327,680,86.03761457412496,2165
c554da8b-1479-4be1-b524-1fe9df8bad2a,Educational,0.9659350470517367,40,14,627,698,71,56.85500669978461,8133
6b89c649-a396-47c8-8eac-1634ee1b2771,Residental,0.4224788197912879,27,16,591,1136,545,41.02893764041008,4847
284bc283-231a-4428-93fc-2477ddefa5a8,Commercial,0.28552129223191824,27,46,194,983,789,44.64417261448998,4911
56260885-f862-4a60-889f-512852109ed2,Educational,0.1659122489460303,1,3,610,795,185,80.92045965541311,8755
56fe5c68-66b2-4c08-800d-211e71f83a6f,Educational,0.8421160387713547,16,2,414,426,12,40.00027866829171,2946
fd973613-4947-498b-837b-24c063c6d037,Commercial,0.7019874159236491,41,3,668,792,124,38.05506821869173,3732
12537128-6851-4a59-947b-0fb6dc561caf,Commercial,0.6892023280809126,36,45,715,857,142,90.74980184338618,7515
64d669d1-67e0-4f8e-828c-005c3d0f98b2,Educational,0.33819159353034045,29,22,292,1167,875,65.91069839626462,7064
7657c537-46e8-4383-b89f-10924cb75046,Residental,0.5836598006631325,8,14,655,824,169,29.3769913244815,4861
15ed79e7-68c8-41ca-b324-60412a1b4200,Educational,0.18786307727395113,23,50,316,356,40,35.98811499065008,5790
8a9eb8c5-b49b-4e83-9fbe-54513648a900,Educational,0.298447507637987,21,3,219,915,696,89.93078175936037,9361
3183e378-57af-475a-82e4-b9b2c07321c1,Educational,0.06546158495543475,45,49,699,1307,608,81.68472599130712,1204
c3e8c87e-5431-445f-88ef-6f48e8db8b1f,Commercial,0.7646672536513848,27,48,234,437,203,25.75390711129883,2476
ca16f8be-bbd6-4a8b-b7c1-5990e7dc751d,Educational,0.9012467938535292,5,30,467,794,327,79.15516659028715,4434
0e834eab-c61f-4f14-8660-9f9349d74af2,Commercial,0.8530460343229253,29,20,192,1428,1236,41.51078451053628,7036
0980c182-5d59-4203-914b-4baff6a79497,Residental,0.41542371755058216,48,3,412,1350,938,99.13970291867227,6121
fd3b5b87-8bce-4238-91ff-6798ff43bee3,Healthcare,0.26947596572536514,39,24,27,977,950,54.59835193509574,5873
7d02cc6e-dc28-4df5-ad02-2ab6ede6f305,Educational,0.9371166742498315,15,17,279,462,183,71.49903109267919,2586
6b3e29c6-09d4-4136-b9ad-e1e9ce9e8c8c,Educational,0.013478022474084028,17,21,635,1389,754,51.011622951691216,6703
636a376e-b97a-42b4-9448-b1735d5cfc8d,Commercial,0.05394615405708081,26,5,92,889,797,28.01369698751988,2796
5e9b7880-8f51-4b21-bd90-30a85ec66061,Educational,0.01615666120799819,24,33,530,1139,609,74.62824086300785,8563
38fe83ff-23a1-4fe7-a018-25d975c49889,Commercial,0.12577856563819356,38,7,70,1440,1370,45.30984182717335,5261
429062fe-6377-4b26-9f49-593414720fba,Educational,0.5199279663732834,19,43,415,1211,796,69.75868913243355,6502
639d6044-b992-4f0e-97c4-25e08345d6b6,Healthcare,0.11198414294239589,1,25,648,670,22,63.98086853936242,5795
260a61c8-d38c-4f4d-b155-d2b6bff07984,Educational,0.22854920492339104,1,9,575,1113,538,37.2222286172336,8781
3e1a1cce-37f8-43b4-b771-987c619f46f4,Commercial,0.002050568607899872,33,17,245,481,236,55.262925380003615,7724
4a5c58d5-3110-4442-b820-ea1d8d69b18c,Educational,0.04119288057820569,20,23,669,1013,344,23.364700851546516,2152
ba38f9a0-e8f4-4bc6-ada9-84a8ab180cb2,Commercial,0.0028539340252540235,18,42,462,485,23,70.6093179426816,7861
451ae5a7-c566-4716-9dac-7d258fa9f5de,Healthcare,0.96764188939737,23,42,546,665,119,29.267084534832666,9917
5c876813-a1d2-4a18-accf-3a6f0a59c15e,Residental,0.2464949822088136,32,5,496,896,400,88.66995069837425,4147
aca954b7-f1e3-42f4-8e01-0b9375dd81d5,Residental,0.27741996920679,17,24,123,917,794,97.16418889420956,6541
ba15f7a4-bf0e-466e-950e-ae5cf074d7f4,Commercial,0.35332511171009706,10,7,69,1263,1194,54.02073134552064,1377
f72a8fa1-d51d-4612-b360-d03d8597de6d,Commercial,0.3597456674085724,1,32,242,344,102,46.173559535401516,8462
b8144d9c-7fc7-40fb-99ec-6d26b4b87cbc,Commercial,0.7790729337367757,37,30,719,1195,476,52.23995971706552,2594
24616be0-091d-4154-a84c-da039f0e4b24,Educational,0.4811781207965897,29,37,434,543,109,91.7777629134252,1548
d00053d3-21e7-4f22-afa6-629cdfbf0fd7,Residental,0.6010001893053569,22,11,68,896,828,82.01238205360694,3530
58bbbfda-af42-4711-b265-0ec0c4f3ccac,Educational,0.37112211514423366,25,42,520,646,126,78.11637563386515,9030
3b944b63-87ad-44f9-984d-8eeb17680607,Healthcare,0.23582738080946541,18,14,215,375,160,75.97811799161975,6442
b7cf3da6-e239-48c2-91c3-d50efa0d16c6,Educational,0.5312273907408464,3,8,589,1384,795,87.20224332898216,1599
712175d7-267a-496e-b2bb-12af7e7bd542,Healthcare,0.12866913933508117,8,46,486,1388,902,11.116799372970315,1783
591ab2a7-5f91-4ac0-9e39-8b5941cabee5,Residental,0.8462228537505956,25,45,194,1036,842,43.69686493671228,4629
d95743d1-4b16-4dd9-ae8c-3c8a8fb21b3b,Healthcare,0.8909184111089766,1,25,643,1245,602,73.99811746401791,1947
ed45c1b2-b8db-4c76-aac6-f336a457f65e,Healthcare,0.6537440164392733,7,46,248,1202,954,49.793970823757455,4940
d2bfe114-de64-4855-abbe-5a7b5c1461e0,Residental,0.4917530584359805,21,37,573,1316,743,78.00771339043129,7953
e8cc96e0-94be-4a5e-8f77-8fa9b8051098,Commercial,0.5925618702560761,30,46,297,766,469,99.12437265786615,6265
8274418c-f47a-44d7-8f9b-364d35c6bdf8,Healthcare,0.6768411524406586,43,48,73,716,643,42.41287337948148,5903
dceead00-3ad4-4146-9545-e5b0039b2fe0,Commercial,0.14216754307039547,9,36,11,1393,1382,70.69978729553894,5410
c08aa72d-fe34-431f-a758-2251433495cc,Commercial,0.060815243879352554,39,1,220,417,197,36.019815650761025,8280
9ec4398d-f5cf-4e8c-b434-42b3f42742f3,Residental,0.42263956484144105,40,45,299,1379,1080,77.75715861429674,7061
7bc91a73-8959-488e-8240-35aa09afd513,Residental,0.07255120267129767,49,26,240,490,250,19.126173030974492,8693
7ec2b3e4-5311-4fc3-ae05-adccbb6c23cf,Healthcare,0.9821291983903122,32,39,392,1356,964,19.89152082953648,6818
94abe6ee-462c-44ad-bbd1-584ce2760139,Healthcare,0.9876215281805172,16,5,526,1057,531,94.75230325602688,4537
05de47ff-a02e-42d2-93c2-0e1137e9a573,Educational,0.4161168971454864,12,15,109,475,366,39.96339101600448,3834
7fba5e3c-b70e-47b7-906c-48636b5292bc,Educational,0.8250336074788006,6,37,202,203,1,86.22184171439271,2204
c7f1c14d-c239-4d46-94c0-48d88581623b,Healthcare,0.3833372829112137,37,49,206,1370,1164,92.08275203579156,5403
3055acf1-8d9b-44ab-9774-477e4389e560,Commercial,0.9419960903742375,2,4,378,836,458,25.897792527302464,7168
92229f14-2c4b-4a1a-a8dd-43e99c7db083,Educational,0.354300660379794,33,5,568,1193,625,97.00044804985524,8181
5140f3ae-1b56-4963-bd6d-5f1fbf4ab1e1,Healthcare,0.6921491812577631,24,19,621,766,145,84.78575087048682,4764
f51053db-5442-4a25-86b6-1506ce0e256c,Commercial,0.9795925575048747,28,29,202,483,281,78.91615818341845,2386
e7712702-d128-4bf6-b68a-f7a29b5a8e6e,Commercial,0.5395382056275361,33,47,81,568,487,75.03567653550456,9202
2790a783-9454-4d20-96d4-888894acc87a,Healthcare,0.9855040936633656,10,10,38,417,379,62.91131489063131,8440
19582e95-4295-4646-916a-0a91f6d66c39,Residental,0.10662645901517454,9,43,550,579,29,80.0874024514668,1449
8f041eaf-119c-46b6-87e4-4b6cbc00e37d,Healthcare,0.7128033873096502,45,40,492,1014,522,47.82480989335843,7167
785a8bd5-1e58-4cad-88cf-9ee70a2efc21,Healthcare,0.23295143413191477,4,2,653,892,239,30.426629402931265,2436
fac91bbd-51c7-492c-bcae-595f1e976025,Commercial,0.5935145976315975,12,38,332,1201,869,88.91560793706266,1661
7f35be67-bc64-4ebd-839f-7c3a5fe3c8df,Commercial,0.7045682993552399,49,44,514,1244,730,68.3038439088841,6781
ef864324-1b25-4d8f-be2b-2854ebb27e28,Healthcare,0.47058196750738246,30,16,411,568,157,12.818689140886452,7382
a79999bc-de26-4049-a91b-0b7fa9d1d214,Residental,0.16473043704670876,5,32,166,1137,971,84.34917047254008,7864
92b90d97-3e7e-444f-be2b-46f5eb2771a4,Commercial,0.07580277366810195,34,30,335,786,451,74.89566915930546,1357
c7d86931-d90c-4e84-b50c-0a48175094a2,Educational,0.596932600864674,16,32,384,1224,840,17.512991678092718,2105
108356e0-5f27-4b07-ad21-f6d0d39a9969,Healthcare,0.6789577268500072,50,36,387,1083,696,42.6024448676161,9194
5e725877-dc34-461d-bce3-011c388774d0,Residental,0.9023321212281313,40,15,158,809,651,38.12908859836178,9332
4d116716-11d6-433f-95db-ee1910e1522f,Residental,0.8164428981331677,36,45,615,836,221,23.613696194574295,6889
9f8d2b54-c765-4b57-95bd-a1b03fda68f7,Residental,0.08191612928212066,10,27,595,1075,480,20.507451254854693,3138
851e88b7-1908-4833-8cc0-e11715a92b9d,Commercial,0.41503252084627795,38,44,684,1321,637,33.41612437589208,3399
86d2078a-2714-4775-ab11-fdf94b7c9140,Commercial,0.39821649472810383,32,19,715,732,17,34.72862496864239,5319
3168e421-a71c-4215-860f-39635c4e0b33,Commercial,0.7976672592384065,1,35,409,814,405,65.24069408553984,5408
5d3dbd66-0baf-4d4a-99ee-e7b093b865e5,Healthcare,0.7482308133741015,6,28,571,877,306,10.742994952523304,2468
a723c07a-1d25-4e38-8176-51569a2865bc,Residental,0.7166449618446487,32,25,294,546,252,97.04668229438909,5274
8ae2efc3-8f55-47df-b316-719f245e689c,Healthcare,0.3074960061097268,21,28,339,1270,931,78.63941153359525,9726
b6217019-430a-402a-8a22-16b01a8f3784,Residental,0.2808999156408537,43,47,162,711,549,54.351801923243016,5064
fd4b8f59-cb0c-4e14-9de6-a7f6e4454ec5,Residental,0.4739924866637917,21,18,437,1311,874,20.668447197069717,9983
a2b7dabe-2926-4c5b-adf7-b3806c1067b4,Commercial,0.28994577267228183,20,34,69,1042,973,34.27394497738206,2165
5964137c-444f-4456-910c-31b0a371317a,Residental,0.20697670213656238,28,44,78,679,601,47.522102364687704,6514
eed9a15b-caaf-40e4-8821-87ef2874851f,Healthcare,0.566724785675116,3,2,584,1031,447,92.140548372297,7005
2979f6f4-c8cd-4248-a9c0-1d8f56ac2279,Commercial,0.07657002882406638,5,30,577,740,163,39.87122638049455,4313
93a9674e-d617-4fb9-8d24-3890aa4d5ea9,Educational,0.00019747321391039296,3,18,68,1008,940,16.902837241268145,3556
c2ba1a10-f8ca-498c-b597-ba873d218457,Residental,0.48001467631403194,1,6,133,384,251,78.03315390742387,3799
a87ec795-6c93-4c1f-aa19-d39d52bc4358,Healthcare,0.7918642627165982,5,32,336,1349,1013,86.80348689623439,3215
23570899-f282-4310-8579-80954254cbcc,Residental,0.9337622756218932,7,7,130,1094,964,73.089215403695,9615
6b04e3e1-1849-4e6b-8a9c-519d30e3b783,Commercial,0.9343764219078442,42,25,72,151,79,69.60780251398174,6418
8503c6bc-773c-4994-9915-68866e6e16f8,Educational,0.7554282849360421,18,37,142,1156,1014,29.935615768610074,1110
6eb2ef57-7c1c-4be8-9f6f-04bd0bf793b3,Healthcare,0.09566893933346676,43,2,485,491,6,97.24576835649991,3158
1d5f4ea3-53bd-4c14-92c4-a845593a78a5,Residental,0.2703261682251116,50,18,610,1248,638,90.72556611257599,2454
435f8b6b-8c1e-4da8-a7b0-02908d84119e,Educational,0.2123558092439608,24,38,374,1076,702,36.496756050434016,9103
c054d658-ccc3-4d65-8d48-c45144f27c92,Educational,0.17035846038556213,49,46,379,1258,879,58.12731660058717,3277
52fb5be2-1463-4cf3-9b2f-ba751c1c0f85,Educational,0.6541269553394137,4,15,134,1028,894,16.823713399579756,6540
dd1ed642-50e6-44c6-ae86-9d0b26db2fd1,Healthcare,0.48660970135817627,15,10,690,1252,562,41.69753769847687,4667
2d7363a6-ad82-4686-b1ce-5f0a1d1fb0c6,Educational,0.6709388072423532,39,40,412,1029,617,35.05216307969285,1346
e009f431-ec22-4e18-892c-d503c441b892,Residental,0.587970686491886,29,36,420,1348,928,22.144087373559,5030
422c5de3-7423-409d-8080-3708e58ab8cb,Residental,0.48743278609713514,45,13,658,1123,465,94.2586254577424,1884
5908b78d-c0ef-40d2-acbc-0ac7ae3f78d1,Residental,0.7638595980072237,34,32,608,1268,660,87.6585026205441,5324
5492bd73-bdf6-411c-9baa-5a9a2b2d115b,Educational,0.5628381818194448,49,12,628,1228,600,97.64893025640004,2879
212ec24a-f409-4680-a75a-58874ee2038b,Commercial,0.39078512256882336,15,10,675,701,26,41.15844154486966,2735
1b213923-856d-43fe-9087-f7c5dcc34766,Educational,0.8289088298102547,1,46,626,662,36,52.834063622866715,9832
b70d3c82-1fad-4222-b3d3-3e28ce4e188b,Commercial,0.3748772098793486,10,44,429,1259,830,51.61411123090388,8530
1100d960-68a8-4bc0-ba21-a34bba946744,Commercial,0.48764430110730606,48,43,715,1100,385,38.56501832840131,2594
684d0d56-7833-402c-9197-317b08d656ae,Educational,0.29633522045382155,9,37,683,1015,332,27.936300798458717,8915
67bc237f-83f4-48b5-b36e-9e7f4ffc00ab,Healthcare,0.27939759730085345,44,17,485,1375,890,46.339112299135145,4767
5eb9d745-57d4-42d6-9eb6-92ed2cfb8259,Healthcare,0.4912370446963482,8,15,535,817,282,81.13636101749883,4270
097734e6-335e-426b-ac35-b583c8255319,Commercial,0.009247512962326288,30,37,65,741,676,79.93319485178156,8150
29fbf97c-8e1d-4ccc-93d3-297855e99b62,Educational,0.04294063140248627,16,43,491,922,431,26.005073979634425,2819
e2c03dd4-2d5c-4f62-8eea-75140c96bde4,Educational,0.7441898772268064,17,42,606,1173,567,22.902118442645573,5210
37fa39ef-d936-4057-a744-d30392704537,Healthcare,0.8801978636775735,40,3,210,922,712,99.99023234910828,1249
0ec62f51-350a-4d79-bc12-4c173e568898,Healthcare,0.6417592041254105,42,4,334,780,446,54.781450845563114,3240
47964694-9c36-486f-8520-b70ec80caff4,Healthcare,0.8484681531447879,40,11,274,991,717,36.40050837710781,4874
47fe97ae-38fc-4b61-ae8e-1d39cbc11985,Educational,0.6270202700347162,8,25,662,1279,617,27.93698988938339,1932
c5547dc5-bbc4-4567-bcd2-68a734d357c5,Educational,0.5479687376807981,50,36,363,1141,778,71.54038486966189,1869
49bcf14f-61ad-4a4a-9299-1c18f3516d65,Commercial,0.0825512817923808,17,41,563,861,298,52.81971095883771,9797
45ba9460-ef78-4e64-84c8-bc3dbc77b753,Healthcare,0.3431016060959906,21,25,468,1123,655,78.78256937838239,1340
fa98e853-62fa-4848-b930-d5f4ab57871b,Commercial,0.23421205563694614,18,3,375,1088,713,47.5218179114375,9182
c49c3ef3-8d5b-4669-9c6a-3a0b346c8b31,Commercial,0.3691245066482908,9,12,473,741,268,89.05527582650161,3449
aa4077b1-aeeb-4aa1-8c77-9e7fd60e63de,Educational,0.5939689335736837,7,44,8,847,839,84.2533077088944,3346
e5403bbb-57ee-4a52-947a-0c7b92f05e2e,Commercial,0.9446571286290781,28,31,491,1011,520,88.54345364817753,2716
2ad36326-3c30-43a6-b23e-d4717a67a0f0,Educational,0.21507201811600674,50,11,84,1401,1317,46.22791554206811,9611
83a958d5-af67-44ee-b8fd-c970b564f1e5,Healthcare,0.01431451043301446,32,17,247,541,294,39.21379037356059,1824
29c27e0a-80fa-4ca1-967d-25099901ec2b,Educational,0.6652435318025196,22,37,129,148,19,10.880410052697247,1413
a1b304b1-051c-40f9-88af-357ff019eea8,Healthcare,0.920574527429431,47,24,127,857,730,65.95430471705885,5274
7e09228a-e28c-456c-af58-52090eba2d15,Residental,0.6061724301198067,7,11,217,236,19,75.52099417429854,6647
cad44a7e-bc8f-41de-a0ea-9d5d62b8304f,Educational,0.6806729272120374,15,16,591,1052,461,74.83799986538354,4179
aba9fb2c-db3b-4aed-a769-759e5cf3127e,Commercial,0.982827576755734,3,35,12,175,163,99.82500795744616,2866
a80eb5ab-7646-4156-af2d-fdc2ec98b112,Commercial,0.5233371756338296,32,19,44,115,71,15.822884152729921,1387
d4eedfee-4461-45ea-84dd-22dc9302e006,Healthcare,0.459009239112561,16,44,215,1138,923,48.300909431689725,4296
8f37b305-0105-44e3-814e-f687b2165a46,Residental,0.6485733654968833,15,18,600,1328,728,83.8208758844963,8941
74ebe965-6bbb-4896-89d0-ec58ef2d19c7,Healthcare,0.7532979299985814,23,33,311,710,399,34.21618578571652,5420
e7fa15ad-8f4d-4590-bee7-e01aeb0f4387,Residental,0.4222080602155376,16,45,309,1335,1026,80.88746508054041,3726
69f02da3-7ce3-44e9-8531-3f65e9cefe21,Healthcare,0.5295882321530915,36,23,405,1151,746,86.6330895740265,9014
ed802983-fb81-4b4b-be50-d1b4ce5ad428,Healthcare,0.7594893036059958,49,24,201,1293,1092,36.40282127516163,6536
d3a8adc1-50a0-4d98-bbec-d0b4c4815bde,Healthcare,0.68237846149565,43,31,390,600,210,17.984651082517907,9982
54416ec2-6bc3-44ab-9498-6d645dece97e,Commercial,0.18752075927135325,41,32,531,1272,741,16.037951868927948,5307
8c3c9ed6-9d10-4eff-9915-64bcebbd583b,Residental,0.023367245359727784,1,39,514,612,98,30.437278718662434,3415
fa8ac4b5-fa8f-436b-9384-9fd2436da198,Healthcare,0.03288542723051979,15,31,131,675,544,89.32865008883024,2870
cd3e0485-5b75-40dc-886e-0802484a2355,Educational,0.1544003181315221,40,44,494,1437,943,83.350733868328,8101
0819bf97-e1d0-431a-ace8-deb482475abc,Commercial,0.0028115730849050946,15,18,653,1173,520,86.84745658726585,5295
a1dc81ef-60db-4812-8401-d8ae665f5a26,Residental,0.9186238152671173,21,27,251,1277,1026,31.832699421455903,3722
4d582a69-1661-4b71-bc91-261f24d91b31,Residental,0.9688733704832996,37,21,257,459,202,14.049719400627596,7909
b3b1b406-a321-46ee-812e-4febd48e60da,Residental,0.06283588712390431,48,21,334,773,439,63.14906054745208,6187
bd15e315-587e-4415-9695-0e55bec0c26c,Residental,0.6580408136637289,2,22,133,295,162,74.62071194023834,5976
ab32d765-3348-4401-be1b-6ca8004cec0a,Residental,0.06988788443828098,30,50,297,624,327,41.465686846579885,5252
855ce513-6f2c-4c40-89bd-a4145cea787d,Healthcare,0.387545946524143,17,7,267,326,59,80.73532354815556,5327
eb210d65-2782-4f03-97d9-11eb59978045,Healthcare,0.1562747741790197,10,8,488,1252,764,93.73438907479824,1977
07d52c90-4d6f-4314-9bf9-8af42dfd07b5,Healthcare,0.09197415336163473,40,39,171,1423,1252,62.07906130794899,4278
e2628776-97f3-44e2-8328-267dcc09a85b,Commercial,0.8048371730480546,26,19,47,537,490,92.17112824937199,4342
138eda0f-e780-4c73-a05a-d48bddb981ca,Healthcare,0.6570242464276441,21,32,86,1059,973,46.360651256054375,9303
24c4741d-8884-4c15-ba6e-927a2fa5136d,Healthcare,0.9584475395904832,23,19,140,662,522,33.740840227877854,5071
d86c42f8-5b9a-43a6-b840-3f17f3da65b9,Residental,0.3679289134775282,32,19,449,879,430,94.0722650548393,2291
9c996d9f-e992-49bc-8493-167c48b4573e,Commercial,0.5936848766610804,11,33,157,720,563,71.7360079853016,1244
47bf9f93-7ad9-4c5d-8ce2-bf4992909daa,Residental,0.9417151796586372,11,5,668,804,136,15.305807067147834,3472
6af5a3be-6258-4477-98cc-2b1b98972265,Healthcare,0.5335415492018267,17,49,253,585,332,51.86954992111831,5393
852ee1bb-1143-468f-a629-ec837cf4ef33,Educational,0.5261740029860429,27,23,262,655,393,68.55091255568605,3876
6cb3b80c-bf96-4c94-bffe-42e6e7a6d1fb,Residental,0.32757594680721625,43,43,659,726,67,91.11908638615584,3709
96400e46-2e22-4aa9-9d8c-f71f1e0107c6,Residental,0.3795856607327496,32,35,509,958,449,47.77328201826896,4145
f217304b-16be-4c82-8db1-1b7ba85fc19b,Educational,0.10675827488577694,9,12,102,947,845,77.03613891790094,6415
55fc3979-c246-4b9b-b213-3844a94cb976,Commercial,0.8953027248929291,26,34,138,194,56,66.9841029617394,7865
0dfd6a96-a167-4115-8ccc-64c796b76683,Residental,0.30484053195891625,11,27,416,1007,591,15.575864333903333,1844
82c41a5e-49ec-4020-b78a-e405b6213ae6,Commercial,0.6871163085822426,42,46,71,1073,1002,11.711165506926202,2849
e87ca885-e98e-4d43-8604-b7efea901520,Residental,0.905003758524368,29,2,718,1275,557,41.69885917239327,3938
e20989e5-dd00-4b92-a8e1-7eefb3a8d6b8,Residental,0.020826610254441213,27,14,351,1271,920,92.51961413202322,8273
22165856-ff5e-4f42-83a7-11cde51fe621,Residental,0.02140340748717051,43,20,284,1250,966,53.707545220793435,8359
1546c1f3-e949-40fc-927b-181eef8fd1f6,Residental,0.6469422446093457,13,16,171,591,420,27.355894156795813,1835
f9b8a446-3c6e-4a07-b4f6-2ad88a01e4e2,Educational,0.7397038735078326,31,48,223,520,297,18.2631097880628,5155
ec6fa1b4-f72a-41cb-9dcb-0383314f0199,Educational,0.8464246143726027,13,33,487,937,450,48.55189336759282,1874
ff8a9a50-be0c-4919-ba6d-e1ec80c53618,Healthcare,0.4116565560427293,5,38,296,829,533,67.80235775544861,9916
2ea74a65-6818-422b-98cb-66ef6ac5629e,Residental,0.0030735306026041798,5,31,325,974,649,97.47842759428923,9362
6a4b703b-1e42-4dc7-aada-31cbbe280717,Residental,0.7311966691620405,43,17,518,683,165,68.31770812345903,4297
142c5bc0-5c69-4123-9190-3b61005cd3c7,Residental,0.978728457232097,27,19,564,589,25,67.1939652399447,3008
cd3ab1e3-a7de-4b97-b990-7aa7d32836ec,Healthcare,0.22395331060385282,4,38,470,747,277,94.07869079061494,9886
b3aa6380-c517-47aa-8a66-fa1b68168ab9,Educational,0.16889381378693402,42,3,559,1290,731,16.980222538723712,3951
dbc3440d-184f-44e1-8c5d-5910cca7f7a0,Educational,0.45837024894127154,13,18,632,971,339,89.31468838419464,2558
9585caac-0207-487c-8649-bdc94db21775,Commercial,0.6038233955972678,27,44,116,1172,1056,68.50309146825445,5248
ab374d58-1fce-48cc-8e38-ca041fb73095,Commercial,0.09109103230739724,42,10,424,1219,795,30.20542859975808,8621
6838156a-8802-4daf-9904-7b177ac2da1a,Commercial,0.6209503124859406,47,22,648,1067,419,49.34842817004033,4294
554042c9-8645-4007-b67d-ddf766585349,Commercial,0.49689656535399795,10,49,644,727,83,21.193345240770107,6927
58ca8b8c-2399-4811-befe-f35b71dac07f,Healthcare,0.37851350521735927,29,40,73,823,750,33.53968511622254,6663
6c379cd9-d8c0-4182-afe0-a1981ecb53cb,Healthcare,0.7878680766694699,9,46,479,1356,877,77.12929998876824,7866
c8f2dbd4-f6b3-425c-ba82-bdbeff4ba212,Commercial,0.8759651807124397,13,15,564,1202,638,32.33235655299792,4648
bf6d48ac-99e2-416d-a852-d5d22969271a,Healthcare,0.7571482073205571,4,2,695,1314,619,88.75004254502716,1505
bce3666d-2d36-4a59-bddf-72e1c9fa2088,Commercial,0.029393949630979632,30,23,423,610,187,74.25388207953046,6498
c7f17be7-be93-47e3-a7e4-0c062c3ce0c3,Commercial,0.08447098782118845,46,25,38,623,585,47.91075610934579,6444
03436f8c-b161-4bf8-a4cd-fa969b3bde35,Residental,0.6022460084391384,30,19,163,880,717,28.62584637577454,9497
bc0539c1-4768-43e8-bb54-265ffe4a5e01,Educational,0.36172655412187915,18,13,473,1339,866,89.66027485307916,2977
930f2f0c-a183-40ad-847e-250ac7d974d3,Educational,0.38834729013893143,13,19,188,697,509,28.84648752952832,4373
c94c1aaf-e1e8-4b50-b5be-69bfb54818af,Commercial,0.7607518669999839,41,2,380,399,19,77.33036377426781,8257
531a98f2-b84d-4572-bdd9-90f8b77fa642,Residental,0.2518921063467868,46,39,410,1129,719,69.09418263754375,8938
ede97c9d-d45d-4b13-9961-0d08ab45b8ce,Healthcare,0.5686108217865243,50,34,24,1183,1159,16.599146104111735,2498
0c18135b-ef93-4c97-bf11-aeac297d3201,Educational,0.7583533018663274,7,4,250,1353,1103,16.380447146479863,7768
6068dddb-efd2-4b1b-8fa2-f5b718fea8ad,Commercial,0.9505478622086941,46,2,437,542,105,61.06554441029477,7964
8fa58928-fcb9-4e4b-8cf7-249be24acaf8,Commercial,0.5756028480708245,3,2,709,961,252,51.64970962124993,9065
677ccd8e-bdb7-4cfd-ab75-fd8e76c56959,Educational,0.24134464236103836,50,14,171,1292,1121,91.46984740291465,6027
a1743441-d05e-47c2-9984-11e78e123ea6,Commercial,0.5770739953333821,50,33,286,648,362,98.22248177915084,5750
dc525959-eaa3-4fde-b982-d5f2df2e9fc0,Commercial,0.9648504262776185,15,18,165,1287,1122,10.713850810798858,6439
ecf1347d-992d-4ebe-835c-911abe8bd04e,Residental,0.8775737600753746,18,13,211,1425,1214,72.71011130435818,5555
c25c21ba-795f-431a-87e9-e447f996ab71,Commercial,0.15357115390072174,20,30,336,413,77,80.9950840788453,7587
866ae003-0726-4729-b5e2-3a1e268b8f79,Educational,0.5561369683238111,25,22,597,961,364,70.88921052583635,2617
34bffe7f-9f5a-4bd8-bf6f-3b0a27930740,Healthcare,0.5393124805394073,8,43,303,854,551,83.04340082540385,5699
464bf1e5-e887-43bb-b491-c0cd67883d74,Commercial,0.534068852773989,28,44,206,543,337,83.55034715866627,4705
aa456b44-e3cf-4a62-8d8f-64bbf519cc81,Residental,0.8462358784296627,22,28,548,1201,653,22.82556537590231,4740
dfb94220-bbf0-4d45-a776-64cdaaaf67c5,Commercial,0.2160696801603358,28,13,395,1072,677,72.03251120424702,9392
0391c8cf-92c4-4841-9b04-0abb76cf50a0,Residental,0.3613978514374043,44,28,406,471,65,44.873889117689195,2708
8de4b772-6de8-4c18-9035-08d39b974bc2,Educational,0.4999052360742072,11,38,636,1180,544,68.68705828074003,9189
b5ef64a5-9006-4244-9ef7-d34b0023b833,Residental,0.6656787640595603,14,29,677,711,34,80.97049494860586,6553
85fc8a23-5dba-4d18-9756-8a7698c0d5d4,Residental,0.14640967582009945,41,27,610,842,232,65.64150209877361,5141
d52f09d6-5905-40da-b1a3-98eea76d6244,Healthcare,0.42270337613058795,47,21,95,277,182,48.03896238847794,6034
35f1846a-45e0-4ec1-8427-4180d9eca7f6,Residental,0.7208132024263993,44,37,108,232,124,58.690433688514304,2100
fa91eaf7-80d7-4b42-9917-2659d98818a9,Residental,0.31131909653723344,35,30,110,1053,943,53.46373085446816,6888
602ef1c7-d4d8-4b77-8d83-fed6650592bb,Healthcare,0.10557202677955435,2,23,340,1238,898,59.05556515518144,7759
f380a512-eaf9-49d1-ad16-12541a82c167,Educational,0.45392652128818634,29,29,515,576,61,74.87329103248038,3098
b63ede52-570f-4393-93ea-25789713c9bd,Commercial,0.5201004107065446,46,15,352,1028,676,56.67687294089217,5817
2ce844c6-90c5-4d1e-9c93-f2417820871c,Healthcare,0.06585385423742995,2,14,561,929,368,53.91812166837559,7382
a9bb3e78-14ba-4ae2-8e2c-35fb4f58ce2b,Commercial,0.03944263314026497,42,4,560,1205,645,92.24596738798913,1099
0470c550-41d4-4a22-8b95-35695f617bd6,Educational,0.21302864872302263,36,10,386,877,491,13.10331204207829,8009
4cde8828-9ba9-41d8-9d11-034c0437ec64,Residental,0.7432382582324388,14,24,633,1139,506,12.79056638061541,4399
a8338577-0e14-4ae7-9b3f-85a0d71f2143,Commercial,0.862226934951479,34,8,633,1239,606,87.71586899169935,2570
69e34fe6-7342-4203-a270-68b8fecdf5e4,Healthcare,0.4421823970565024,8,18,399,490,91,90.8560285241607,7752
c0c04ca9-5dc1-4622-8e2d-9491c5e630c0,Residental,0.8718371069858117,12,9,474,714,240,51.84211777515904,8307
ddb4474c-de0f-4265-b0ff-d248f623219d,Residental,0.934482818432094,46,41,558,764,206,72.53666597888682,4002
76027ab5-764b-4216-a8ea-c7e6d18d7f9a,Residental,0.7788256979099643,30,10,148,312,164,29.214963216910547,8997
571b4f09-f7c5-47c4-b7e3-61efee42e48a,Residental,0.12542154352932033,2,16,22,734,712,82.92076962400984,2987
f4df53a9-13b2-4751-8157-d3d75f26bc79,Residental,0.16788307754306397,42,9,417,820,403,17.43221599561416,6382
0523c4e7-0d57-4a92-bb15-88d87f1f0e0f,Commercial,0.2084458540683699,34,13,286,989,703,87.33946994297536,6586
b0459c12-88e5-488f-92c1-068d44f35752,Residental,0.663793735567254,38,11,621,1014,393,58.94229353294101,2403
1a559e5a-9b7a-4492-ad62-18eb6dd6705e,Residental,0.0201181737003584,9,15,396,990,594,64.40753909443055,5146
cba06624-60de-4c40-b31f-2effb58d5f1f,Commercial,0.20758948168907576,17,48,330,1030,700,23.852034009322228,6676
6d42dda3-26b5-42e3-844d-0fcb0dfe744b,Residental,0.8043090995942018,23,3,671,882,211,71.11947635858249,9337
8beac1af-a867-4c98-84c2-524f224e68ac,Educational,0.27911780539583086,8,30,434,879,445,65.68589122778279,4747
52f7ba79-08a2-410f-a2fc-4dc201782da5,Residental,0.10512422122679244,3,17,688,1017,329,27.654370966556662,6257
bbc46d53-a548-4f8e-b952-64c0ee8eb7d1,Educational,0.7908177121831079,43,50,274,808,534,42.17774725789119,6762
b8a4721b-8b94-41bd-b66d-2564a572df1d,Residental,0.06924859620860757,11,3,68,457,389,62.03529102086392,5436
d1fa9153-3545-4b1d-8c48-79246ccebdd6,Residental,0.8597791230497107,44,7,415,481,66,77.09993314060874,3908
ade0206c-5f44-49eb-8536-a1d018248219,Commercial,0.7005341539451216,23,41,499,1024,525,81.49447491570005,4954
0a47e0e0-a3eb-4cf0-a3fd-404c12293d1f,Healthcare,0.9684303460803645,11,27,209,671,462,71.06738163549319,1963
b3a59be9-3088-4ce1-9fb5-68ec0156c70e,Commercial,0.960889145271628,18,16,322,1072,750,43.156099724562495,1580
1a320371-d800-4a3b-9785-ccc1dc499534,Commercial,0.027412183038300397,5,13,207,270,63,32.518699943039245,9870
cc547a67-9a87-4a7d-b3e8-a671d3bef7dc,Residental,0.07694566228318189,12,13,288,1268,980,68.88713413217096,3210
6144de2f-fc09-4464-bd97-d41dd61e40b7,Commercial,0.5925896775443256,20,48,329,968,639,97.30611018841977,1765
642674b8-88f5-4699-b126-57fb92f6aa6e,Educational,0.3222949887472808,12,25,578,680,102,13.145217708203035,4986
adf7b127-2486-4cf1-803c-8a196838292f,Educational,0.7610876890895037,49,15,460,1114,654,82.9017329700775,3706
f83b22b8-60dd-4d90-9b60-dbd4dcaef163,Healthcare,0.7098465140924847,39,27,9,101,92,63.56184004348053,6293
fafb874d-1dbc-4cc0-862f-b7b64d08500f,Residental,0.06880019358289347,32,11,671,1366,695,21.989269999602868,7882
4dfe45fc-17d8-4925-a52c-7de4c43373d0,Commercial,0.798332954712461,35,47,295,819,524,79.08522265525346,2566
9073a034-1104-4dce-a428-c477f635a0d0,Commercial,0.5280430245425973,40,22,175,175,0,66.0119267811976,6555
4ae62dac-f7a2-4a77-b3f2-426f932fb886,Educational,0.955248937039405,21,10,700,889,189,59.33479745574927,7648
b5ddb3b0-0853-41c0-b2ee-846b2bc4157c,Educational,0.48236284841504495,39,29,472,859,387,96.20723409483217,6483
74456b05-dec3-4d86-9e27-0a491c04f500,Healthcare,0.12292070443686098,28,37,402,411,9,63.988157236072404,2072
25132c0a-0932-47c3-a0d6-a091c645c0b2,Residental,0.8680895761746144,10,34,661,668,7,60.914219280517315,3094
59c94e0a-da81-439c-b189-84f8568d9fbd,Healthcare,0.7398239736308492,32,4,288,630,342,27.80454757751612,7480
eda0563d-ca9f-4d41-8a00-a50129c231b5,Residental,0.7924442839859573,10,43,125,1258,1133,82.06557829025839,7596
21389aca-1c9e-48d8-9b07-4bbd908b5f7b,Commercial,0.982507193852123,23,36,6,836,830,84.9209233679509,2382
fdd04c09-a91b-4f8b-8923-719dadd16bb0,Healthcare,0.6347077570778217,1,17,144,1035,891,59.04281653317691,8058
3574293e-ffd1-491e-a367-5f40f2b0f326,Residental,0.8034848349097037,33,46,404,701,297,10.030276923341065,6242
e35268d5-7b6b-4561-ba43-fe9ab0520369,Residental,0.9826697149186048,48,41,169,379,210,48.218962818036935,1681
e90db137-d834-4160-add2-bdbeef2df5e5,Commercial,0.3671062173243922,8,1,422,435,13,50.95727838287427,8567
fe5e01b9-69e4-4cbf-819b-cdc916a8ba2a,Educational,0.5655025985551052,14,22,187,329,142,48.57945868654266,6729
83e39461-201a-464a-9c7a-0a177b8294a1,Healthcare,0.9133832629723216,2,44,719,1305,586,77.22394632174593,9077
a545d054-b7da-46dc-b244-7676df3e978e,Healthcare,0.7204765836625465,16,26,522,873,351,56.680361475428775,8033
3a4d5ff9-cf45-4bb1-9a67-a59e04549db7,Residental,0.7393222907920302,32,34,559,907,348,79.71212739774333,1412
02b8f140-51f2-4ab9-bedd-beafc5983922,Residental,0.14774477286518695,23,4,78,1140,1062,61.08801099985616,4235
8f21a176-f2ce-4e46-8982-9a2a626f8643,Residental,0.9128008622411682,7,39,684,878,194,27.609154691883855,1654
89db3650-f2f2-4359-9814-5e3e809acf42,Residental,0.7907455361255847,10,8,364,578,214,42.295646739226704,6550
fa055001-ac90-4135-a98a-07351eb4c428,Commercial,0.11204071907650026,1,12,508,1345,837,28.54270563892634,1236
bd559006-5c6d-4059-80f5-a50ef98f9627,Residental,0.25877205543980475,28,18,211,933,722,96.78917007668412,7550
2d976f9d-cdde-4267-a717-2f5767631215,Educational,0.05718165499362504,41,27,567,1356,789,19.426626414298305,3065
69f9c248-97f2-40c8-89e5-46a6f6a19033,Commercial,0.5174904693768985,15,31,394,497,103,64.93457909696234,7339
25946463-d74b-47f5-bd5e-9e72b59f566b,Healthcare,0.6169657868404897,44,33,586,905,319,91.41245600173013,6032
52017ecf-79a4-4396-94c8-692c033c1319,Healthcare,0.24956447431774442,3,45,367,1376,1009,24.341911143121628,4070
26fc26b0-d51c-42b2-b8ad-6ea1351be1db,Commercial,0.013105856292557005,25,5,25,1161,1136,81.8968757983472,1788
279a958d-240c-4cf1-a898-9767c5573593,Educational,0.7129844055271761,27,33,14,250,236,28.089811616465045,9921
0412dc78-01e3-4c60-bc98-9d8e4e0a261b,Residental,0.008093061561793236,7,6,464,984,520,49.15572846422883,9870
efceb713-270b-4fd7-97b3-e4eecf28df1d,Healthcare,0.6075649427624772,18,49,230,837,607,93.08641751642469,6965
776f66e1-1350-43de-9135-f9a89d0e1330,Educational,0.551773068075539,48,24,678,685,7,22.64293053949037,7408
680afd5a-020d-4e92-8140-1e5c946326f5,Educational,0.8524869850307925,7,8,249,459,210,18.391580963621735,9224
5bc93ae4-6de8-44d2-bdd0-de7cb12caa66,Healthcare,0.4153113406372648,22,44,612,1305,693,45.711206205958966,6421
62af1b8a-27d6-4496-8ed3-5889ad609b8b,Residental,0.6530518678390871,31,35,214,411,197,94.93499414028327,1319
34755138-7e0e-427f-b9dd-7073037d4bc3,Commercial,0.3344014215355715,42,17,90,1263,1173,75.65840873414994,9513
05fb9c0d-1908-49f3-b644-63faf14e8aa6,Commercial,0.9401624647869878,28,8,604,912,308,51.24793606585867,9609
f116ee7d-f20a-4acf-8b20-228a7211294c,Residental,0.7322953651173512,22,22,418,1187,769,11.952826625106663,3631
cdd6ef22-33f5-46c4-99d7-be459e69acab,Healthcare,0.8321792200985247,31,18,27,143,116,26.00709153382545,7367
e92200c0-13d9-44e0-b8b2-84183d8b7042,Commercial,0.03289933852879401,25,2,293,1045,752,20.626953373234347,1957
242560bf-042d-40c9-b68e-528f32e9dfd2,Residental,0.7769267556114153,42,31,11,913,902,49.58572577546467,4252
4889e4fe-d47e-48ea-ba64-3ef65c54c481,Healthcare,0.22744905681063876,12,1,433,1323,890,45.61357071201738,9753
79942169-18f7-4e7b-8c3a-a7fc036b5473,Commercial,0.7356552967581091,40,34,299,1167,868,84.17811844940925,7413
3b4f5d70-c277-4622-8b54-d8f4fc0ac13c,Healthcare,0.8286675391402353,29,29,175,852,677,37.51252540770961,6429
277e5fa8-4983-4cd6-a8c4-16f11400fa7a,Healthcare,0.18640893232086198,2,6,90,1411,1321,25.748987634614043,6391
270f05e7-c100-4a76-be63-91f07fe47fa1,Healthcare,0.2352835081230389,15,13,485,816,331,36.20467055263272,5870
a42ad00b-5465-4078-a3f1-2c4bf55561ad,Educational,0.2836333930365248,28,37,574,1198,624,92.40169841915215,2431
e28dda31-7316-43a0-a808-dc2de46f4ab5,Healthcare,0.32751371288595266,34,47,486,710,224,41.11767442122067,1124
ade5ab49-a68f-4469-b160-6dc0068f4381,Residental,0.22065905033309008,23,3,41,1308,1267,81.10347878188438,4218
7616a1aa-1cfe-4c9b-bb77-9b1262c954e6,Educational,0.216428131104889,19,41,252,991,739,80.85094431311089,7573
9abc4d28-c20c-499f-8c90-c408a713a435,Commercial,0.6844656535794,21,8,272,759,487,54.9314389061007,3930
5736d8ee-8306-4d3d-a7e0-060a19963138,Educational,0.4232308336578743,10,9,383,1372,989,52.230784062949255,5313
41d70ca3-8f89-44bf-b442-d6ca17e6f38c,Educational,0.012936509093497861,21,23,653,1287,634,35.161710185289834,6259
9375480b-0789-4514-ae24-84be2fee1319,Commercial,0.6633920653323219,28,4,556,887,331,61.64678694592174,4841
9bc5bd53-6f8f-49fa-9d11-c7cc752e7bd2,Residental,0.8019749735925927,50,21,670,892,222,42.75229058702068,4467
b404124f-2962-4e8d-b2d7-93ae82f047fe,Educational,0.0967752986386432,44,21,93,714,621,20.591395775798702,2451
fad2be79-2ff5-4d60-8dde-82ce560af9ba,Residental,0.3394942539140352,37,28,342,608,266,44.46665846995435,6515
670cf862-8fd1-4efc-b33a-0e278012d229,Healthcare,0.11129301821945448,10,44,646,1156,510,51.68752604362161,8381
80960df4-0c15-457f-8d28-881a50c27ab4,Educational,0.4346141041714018,17,42,75,561,486,50.585420521196916,5721
07f17c6d-bbb4-4791-8906-ac17804f628a,Residental,0.8734756952589373,40,25,381,1358,977,93.3792086992579,7148
4a8fe481-99ca-45a9-b5fe-743260412912,Educational,0.5145360152510846,32,29,111,595,484,52.71407981264114,8491
363115b7-5c8e-47a2-a10e-d4582f0fe69a,Healthcare,0.5267276458323592,32,3,91,449,358,57.39049747223419,9443
043ab85d-6970-437b-8dce-a3b281076f47,Residental,0.7598258249793887,39,47,429,504,75,44.15144129236847,2881
b434a17c-bc93-4cb3-a044-1403ebe18896,Educational,0.5261773001469993,34,49,232,987,755,67.32462692133274,4703
24299486-15d0-4394-9f53-02b84d8862ec,Healthcare,0.22008118819225497,30,29,194,618,424,36.15487592566515,9163
07362349-c464-43fd-a7c2-181086c26b31,Educational,0.23654040682581534,29,45,393,1003,610,10.418557769381572,9897
5b07311f-c4ed-4ae9-80e8-5b1361b32822,Residental,0.6921853210306396,15,23,646,1432,786,96.5233058516593,4285
3014d01a-a442-49dd-a84a-3ce32d942d75,Healthcare,0.6948956301120861,33,33,362,971,609,55.8074250580887,7496
f115e829-63f1-4c25-b746-8529110f3fe0,Commercial,0.05613670094056489,37,36,584,747,163,43.61022500760611,2393
a1163199-c475-4a3b-a706-0a2d4b41844b,Residental,0.7690162979401066,43,26,168,686,518,90.24200778015252,1540
294b133e-8653-4400-accc-acbc87180d87,Healthcare,0.11850198087389663,46,39,64,70,6,36.63409792714256,7004
2b0e3706-555c-40c7-a12f-cb122223b860,Educational,0.8726870193371313,8,35,175,1106,931,50.48567728379833,2986
5caff474-da12-40e8-b581-1865b226e0fa,Healthcare,0.8858634193140899,22,25,445,1438,993,70.25988756291923,1012
d2f8cac1-bcf5-416f-b439-3e13a03fd74c,Residental,0.9479689269425978,21,17,536,1384,848,77.83799565482913,2673
1f8c4b90-6083-4972-86db-0449b9f3bdb8,Commercial,0.5967383784400896,32,31,327,1237,910,48.463717675317014,8052
1bc1e32d-6648-41f3-ae90-11949c72d0e4,Healthcare,0.7063905376652739,3,5,302,759,457,21.394071074899692,8658
a6dcfee1-e872-4e79-a79e-6ac6f4a91613,Healthcare,0.7164432420299109,40,20,637,850,213,21.286153770045374,5236
27e14cdf-6767-4cb2-96f2-2a428921bcbe,Healthcare,0.8120916477706005,13,9,339,1428,1089,63.432372358339286,3483
9b71d4c2-1a77-47f2-9845-77cdbc66d1f1,Educational,0.28937978042492596,13,19,254,367,113,88.77567280874615,8364
713cf025-7066-445c-b20a-ce43f953464d,Residental,0.08701086455617035,12,4,12,870,858,80.11828558774738,3294
40e7d910-dbc2-4bb2-be63-ab1f62c69f4f,Healthcare,0.38151062299125105,18,31,162,1419,1257,44.782245670420686,9714
f7246284-5a62-4fd1-98e9-6fe35061ab38,Residental,0.3609117088188757,39,12,701,1294,593,99.62221615059481,3421
fbb6694a-0e7c-4f32-aedc-11cbda7851e9,Residental,0.38269271433227703,28,45,310,1067,757,41.05123838386179,6276
f662e910-58fb-4c9f-83ad-80676d8e51dd,Healthcare,0.18015160587266854,34,33,268,868,600,13.960057029954593,2196
fe83083c-6a6c-407c-8e83-17b23063e603,Healthcare,0.9148674246983262,18,23,400,972,572,22.10761794087195,5098
9af6ee80-d3ac-4970-b51e-f4736bddffc9,Healthcare,0.24621689005647118,42,35,556,566,10,40.945261090139766,6692
7f4a667b-3a03-46ab-aa1f-132935b25a47,Educational,0.4371074855482857,11,45,594,767,173,83.23597906592062,4281
55c41889-c403-4814-b937-cb98c7b04b2b,Residental,0.3518444542448146,47,33,697,1076,379,37.04846138318078,5602
ebaef436-f062-48fc-a4e1-67d3e33e5205,Residental,0.5764913247709644,44,47,59,902,843,72.51308549136392,6375
137f1e67-5f65-43d5-8fb3-500c757be33b,Commercial,0.0852397414195799,3,10,681,1417,736,53.13514387601034,5920
e5168ef8-9eac-409b-be2f-acabc21b7642,Educational,0.36170319509819726,42,33,42,1210,1168,27.247929534273354,8638
eb9b3bfb-554e-4ba6-9ee6-57b1245d6c0b,Healthcare,0.0847407799836879,29,41,603,1255,652,70.25170150112942,9713
0c875deb-21d9-4280-8e73-e4f800debf9e,Educational,0.008811626984405296,12,45,251,488,237,27.10842827202655,4685
62201f53-e6d4-4855-9dc1-84429bbc68ee,Commercial,0.7670590642814444,29,40,64,252,188,14.028408890092315,4190
ae8cae50-b24a-4e4c-8e99-0893e5e62f59,Healthcare,0.10343907293293819,22,30,255,542,287,16.664942942512663,5789
18b04e45-ab1a-48b9-af73-b491df368a1e,Commercial,0.5950011669331622,26,41,136,146,10,68.14977768306652,9470
9f8b2585-240c-4611-9738-258a9b68f35a,Commercial,0.5401680099485717,31,8,69,1130,1061,94.3278250888521,7948
c0a52688-bf5a-4671-934d-9597bcc40a4d,Commercial,0.694386838855329,4,24,458,1108,650,29.490670536054697,9187
c7e4f372-1c49-4e22-9bd1-83bf534999c5,Residental,0.31689129090299883,9,25,329,380,51,70.00706604085815,6187
b2f93a6e-5a6f-463d-ae7c-0840b9db1f04,Healthcare,0.25584881258752923,24,34,564,1321,757,38.188036851223806,8493
e927e1f9-b6a2-43ea-8470-bbc7888ee92e,Educational,0.6715986713903012,39,32,202,1276,1074,62.31240471474415,8582
468e1a76-fba2-4b8f-81ed-8015f0359aa2,Residental,0.5397911749154766,45,50,325,1415,1090,30.84805508662374,9733
3811def8-c641-4031-a606-d76fed85fa8b,Educational,0.16047696752630036,38,26,349,378,29,27.77733508650267,1682
192d5a06-48f2-48f6-b6cd-4397d2df09e7,Educational,0.28369375762215343,6,3,715,945,230,30.787768998780283,1797
8bdfaf87-b8af-4426-bf5a-ebd6fd28b7c7,Healthcare,0.6903660393009773,9,9,74,359,285,20.651952518892674,3522
b108961f-1ddd-4454-8d15-d20bee7a9911,Educational,0.7293058263337469,49,50,480,995,515,19.797266375666716,5943
75f4dd70-7e45-4639-8978-3a48d12691a1,Commercial,0.04134107036567747,15,39,320,629,309,80.68399624569818,3253
38d8dce6-b8ea-4f28-ae8c-3b7dc2034e56,Healthcare,0.400666398185489,46,21,47,1101,1054,31.12786661988698,6141
0863ba7a-991f-433e-bec4-0fac3632647a,Commercial,0.9399180707797743,40,18,235,947,712,55.70756406834045,6356
e92c9f7c-4ecc-477b-9c2e-76a0965af964,Educational,0.920375800222415,42,31,478,1303,825,81.21676596227503,5096
cdf3ac04-fb31-42eb-85f5-3a192b7443f9,Residental,0.33815589272904134,39,24,305,1171,866,82.26591047400741,1754
4bf363c2-cacb-414f-a451-169698233302,Educational,0.1717660674455962,22,2,567,1062,495,97.9507361537436,3593
5e4331f8-c1ce-40bb-b2d2-18610a677716,Residental,0.7315452753114061,38,16,347,499,152,41.20278405450908,7681
8ddd36b9-4efb-45e2-9fa6-608745e7eb45,Residental,0.00827316499262487,47,1,699,911,212,57.371538490953995,7791
cef5bb21-4a08-4ac8-b18f-50002663b68a,Residental,0.7308347004383187,31,6,257,421,164,80.28678851724665,3458
aec67b81-f844-4bec-91c4-885c35a58ecb,Residental,0.4051812878188521,1,4,672,909,237,61.41616355397791,8503
679948fa-d259-4520-be0d-99ece4234df9,Educational,0.9746531236543163,39,7,491,1327,836,97.9502910913532,3778
b1b004e0-960e-4ba3-9799-dbd8af82bf76,Healthcare,0.18466653490524554,38,19,212,1378,1166,95.09124723356904,4162
6b61dc57-dc72-430a-9278-5f865ab67e9d,Healthcare,0.8356603818101599,7,38,79,1134,1055,98.88416600649904,8415
c8a110c2-b5db-4023-8ac9-4aeac5f3be49,Healthcare,0.45756225823722496,27,38,702,1014,312,95.23939518912202,2615
322d730b-1e3b-4500-9628-f816ca10dd1a,Commercial,0.9485804907552026,21,40,502,841,339,53.69269801321028,5092
e58e22b2-5a12-42ed-9d7c-13c8b482135a,Educational,0.35907129408833005,11,41,597,1337,740,19.203859162958906,4208
00fc9f8f-b942-4178-bd6d-bad5990b0830,Healthcare,0.024522861933880424,19,10,128,1215,1087,98.63391686870114,5106
a04d588a-f89c-472a-8469-c3b96dec9112,Commercial,0.3715847364091859,23,14,694,1130,436,46.33568146689783,2278
42579e39-7b65-4ef3-9856-746d2b8d29a3,Commercial,0.0464665948728169,40,8,225,650,425,53.85462197480619,1476
1f5531dc-48a0-46ed-aa33-48c2fdefde86,Educational,0.8224973678604701,11,21,367,558,191,64.61790815660007,7680
e4b8c65b-a2a3-42bd-8eb4-93ad163e7219,Educational,0.27367577953802313,21,17,413,1356,943,73.15776550915805,9162
5224c4f8-509a-4670-ae39-1d7d0b3efaa3,Residental,0.8121358917032793,29,16,668,777,109,58.67258227171531,6331
1c0ff27b-a959-4247-8c7a-c9a681458518,Educational,0.9260475851507615,19,1,658,1206,548,97.0993924290758,5567
7e9ac1a5-6231-4ae5-887b-245e29bc88a2,Commercial,0.4232577051499815,36,35,658,1185,527,92.50254842255852,4348
82e0df2f-ae96-4952-adf1-921c30992546,Commercial,0.3242613212292873,21,39,692,1343,651,27.53170231129512,3222
39d8dfce-ec24-4fca-b5cc-7a0b6602ac44,Commercial,0.2953674156699704,20,39,551,1161,610,76.72833977993723,1109
431847fe-00ad-4333-9b93-a31d4e07772c,Educational,0.7785007299234363,49,9,467,850,383,91.08752742682553,7218
7644378d-afa9-4d61-992e-7d3417e39665,Educational,0.03113160791512326,43,28,434,1162,728,85.15155572219608,3414
dc1020fd-69f0-45dc-bab6-8cefb9e1bf4a,Commercial,0.5112999969116608,43,30,55,883,828,23.775692365996072,1876
0e590493-bb39-4bfe-960a-67047c1fe6a0,Healthcare,0.5814636297964152,8,47,456,760,304,36.99103332442876,3131
c5fdc16e-6999-42c3-8da4-9c868fad1982,Commercial,0.6994799483262072,46,17,703,998,295,14.288692589118131,4537
e83762c1-3ac8-4a10-95d2-9256cba339ef,Residental,0.5223868671363933,17,47,258,764,506,34.15923535450412,8327
ba300bf6-37c2-44d1-b085-bb42984e3eb6,Residental,0.925822051213586,13,10,554,862,308,31.455938407751344,3369
af06fecf-e7bb-4c7f-8af3-51f42489ad52,Educational,0.6608703093053242,48,18,6,608,602,69.1022864988409,8794
8cc776b5-6572-4ea8-92dd-f7345b96fb23,Residental,0.1869040675027015,24,35,76,668,592,69.0363967895097,3375
ccace67d-1fb5-406a-9cf6-7c3f6224d2c7,Healthcare,0.4141976672079535,8,9,187,620,433,76.37844046312189,7465
7cc3ea65-e992-47eb-b82a-92fd1223901f,Residental,0.8179979818571036,31,25,409,1119,710,78.90407751081996,2765
fc27935f-64e9-499e-b633-c515882779d8,Educational,0.9920608117593998,3,45,501,836,335,66.57037067919248,9520
81cd57ce-c9d0-4c6d-aa55-e565dc46f0cc,Residental,0.9896540041781304,22,12,6,568,562,41.02829531971518,6440
6c1fe19c-cac8-4252-b1f2-78027008dfe1,Residental,0.353952007808766,8,43,13,1271,1258,10.130534533911556,5550
9d7d1284-de26-4a89-9745-c11fdafc81e1,Residental,0.6200607318259058,44,16,366,428,62,53.012670229739356,1780
e161f16e-d0e6-48b6-a669-ba85bddb657c,Commercial,0.9546462190608075,30,35,176,581,405,75.68547381249235,2915
fa3cdc71-f0e5-4b49-9807-dff427aed04d,Healthcare,0.5039342293517511,38,45,348,534,186,12.393304569447782,6970
4d10fc32-33d7-4549-a481-36fc14b19fa3,Residental,0.9432132433910967,5,18,547,1257,710,46.53529435664635,3572
e0184a8a-59f9-4109-bbc9-f184b6730930,Educational,0.6120733021229967,20,40,493,716,223,79.95839575150093,7089
7801a547-8df0-4526-ad43-596c5cf4d7c4,Commercial,0.7540878901449849,16,1,312,958,646,55.55936222336165,8076
de5f9ef0-802d-4b86-b19c-0162004e8a27,Healthcare,0.20806538901316585,7,17,500,759,259,41.9728194456938,9906
57485a22-e407-4c31-9081-b39a5eb5e3c5,Residental,0.5084831748175616,22,47,252,451,199,61.65924711258953,4069
4356093f-c179-491f-8e03-9bc71e34f682,Educational,0.9710629050527438,12,35,375,827,452,35.147049426217436,3235
38d26569-34ae-408a-bdc9-8cb967238eb1,Residental,0.7375148516123312,39,31,271,722,451,29.65034158203404,3584
3c0427c1-18eb-466f-8389-3cbdfd09a523,Commercial,0.06586120771623594,26,29,426,896,470,91.71558405596421,2336
d9762105-5495-4b28-8427-8c3e46a14890,Commercial,0.9727168361941202,15,13,545,993,448,58.431732611378735,2347
a604a0f2-5400-4797-b34b-11454a2b6d08,Residental,0.19763424933359564,10,2,325,996,671,97.18870682864475,4030
faf001da-1f08-4a75-9741-7187c95092d4,Educational,0.12974283688428057,50,27,553,1362,809,79.31701874177122,3658
be3913f2-2146-4787-9933-58c2c1c58478,Healthcare,0.40752267256037233,30,32,225,1359,1134,85.0344404104555,3458
3c917f7c-d193-4c29-a7f0-c98f3adec73b,Healthcare,0.024026483442280755,7,20,113,1333,1220,50.233703329185275,4732
03ebd33a-aff5-491f-8636-6a609802e832,Residental,0.9245086266844391,28,20,689,1127,438,67.04041945303425,2451
3fa075e2-ba6a-4c0d-8b25-db7aba5c2457,Healthcare,0.13538837040683904,48,21,120,877,757,98.84867783268653,9036
4b1c864a-6e05-4465-9259-99f09ab46b8a,Commercial,0.3846852522582642,46,37,158,787,629,50.62896802080651,9874
852295f6-1c1f-4bd1-96b8-dcb2a8ebf847,Educational,0.255621861047568,41,32,32,1154,1122,24.674026027529102,4361
a7ee0eca-eab4-4354-acc2-ebf722011306,Educational,0.13641511144463625,44,45,616,815,199,47.974163333668265,6118
84891925-0c6e-4ead-a34c-3a4c63994189,Educational,0.8583972896469012,32,50,630,720,90,69.7641073236266,3560
1b67de68-58c2-4a68-b1a7-570c78f38d6f,Educational,0.8169437936100348,47,12,502,677,175,99.39818923256404,7048
e4f73ca4-8376-4802-9c7f-875d0e37903d,Residental,0.08289159100107801,12,40,374,1201,827,73.93139623702035,4959
a4bd8c29-d094-4010-b61e-df439a706b66,Healthcare,0.10589314334266164,42,14,221,1429,1208,56.329621237491324,8493
ca0d0b8e-cf12-4a4f-abcf-164e63dadcb7,Residental,0.49890762059126914,19,26,51,1294,1243,12.827706689749853,3368
8feab0a8-8bf6-42e6-b5fd-05feee27a8e1,Commercial,0.6037230907953932,27,44,260,724,464,73.03118718425941,5283
bf2293b8-cfed-4b59-b270-427fd5f73402,Commercial,0.5776150756984206,32,7,690,1119,429,18.863030196160043,9074
22dce82c-7872-4139-b94d-4ddb386ff3b8,Healthcare,0.0940818713837196,19,36,21,480,459,42.34640451763906,7486
cf9e83be-764f-4751-8579-7fb09c40740e,Healthcare,0.1519474278259476,20,39,120,1078,958,43.34442439701353,1938
1f9dcc0b-f566-48cc-80d0-39fed14f3182,Commercial,0.5673503770623277,3,14,52,1418,1366,38.279555276794795,6677
245d25a2-70c8-434e-9ed2-53223055ca28,Commercial,0.09277027989624609,39,32,537,627,90,55.78306410198987,2911
9f10510a-c192-4992-9f4f-44f6e0824a42,Educational,0.6063944397740175,5,15,112,1082,970,20.013647905805335,5453
2cf19a5a-f93b-468d-b209-729d58d69b97,Healthcare,0.3093265873121426,7,21,201,1358,1157,26.32399501504005,3967
b380f652-a00f-400f-b27b-3d12ded55966,Residental,0.0523365769273858,31,26,70,244,174,42.29384901830108,2508
656e466c-a8fb-456b-8759-acaeb8fc9cb9,Commercial,0.9965899810298612,22,32,663,1038,375,87.51286383366023,8439
82027350-354b-4989-884f-7412446fff11,Healthcare,0.775517367788979,16,24,16,1186,1170,86.10140330284206,5919
25f71a45-d2e1-4622-8f57-9c749590aba1,Healthcare,0.3589964559256008,40,35,277,330,53,72.9494771864431,4306
73a1d08a-e98c-4869-8cc9-93d0c567de0b,Commercial,0.47011412484800874,7,31,629,1278,649,26.998711494389273,8705
980db6aa-02f2-4b32-aa5b-4fcdfbbe5523,Educational,0.16827103636478025,16,18,72,463,391,77.88875784674214,7500
ec1003cb-2a32-479e-81e0-c154ad760fc5,Residental,0.14086948303873426,37,36,512,985,473,79.79536868706735,3917
a46afd73-a9b7-44c9-af12-6a38cb41fd69,Residental,0.699050364935678,2,15,401,418,17,85.70311354257996,3119
42c6ae29-1dd4-4998-a0c9-4262c056f7bb,Residental,0.8423610812830647,29,45,20,236,216,23.355318649629012,1557
eccaec7c-4d24-4203-92ed-51c08fd768c1,Healthcare,0.30333611973473307,15,4,441,558,117,22.53012148804507,9240
f0da179f-3433-4e55-9352-8314fe5c9984,Residental,0.5793294454110381,39,19,153,812,659,17.763985288927234,4658
8efbdde5-43bc-4d35-930e-4c977b19a800,Healthcare,0.2589637182441693,32,38,496,814,318,18.973432806143425,4820
4853ab46-a036-4506-a0ec-d932ef85316e,Residental,0.5961442730932022,41,19,318,822,504,94.99822194098087,7921
d186d9f6-0aa2-47b6-a9e9-37e9f30bcc13,Healthcare,0.8928547557984381,6,7,209,1093,884,35.33008348078726,5955
d92be374-a799-455a-b187-f934bc11f0aa,Educational,0.8674125107035279,47,48,171,471,300,56.8943212352301,4467
758ba96b-ef9d-40dc-80ab-0516e0d43012,Residental,0.4277964685531719,22,34,347,350,3,63.715666463455705,7165
40ec5621-a72e-4f6f-9c43-8caa714a7a87,Residental,0.4384265865506005,8,47,347,884,537,19.811685939685745,1181
5f8b508c-96bb-4a14-8196-63c16cb9091a,Healthcare,0.9233156368309877,48,39,117,582,465,89.0456682681806,8237
a692e18b-7cdd-4d1b-a1c9-7d3220fe1323,Residental,0.550030604356877,50,37,543,1337,794,17.298081576031777,4485
8cb6c3ca-b2e4-477b-9928-9ac0dc03a4cd,Residental,0.8963524940102809,9,37,441,1424,983,85.0033953831797,3889
11155a6e-85ac-41a5-be79-2b37811481fb,Educational,0.023192317366436566,31,18,231,706,475,90.31786286994128,2801
f751d650-83a3-48b8-930a-e3c5e7d621f6,Commercial,0.3249270519249692,18,2,591,848,257,73.81510515747642,5197
80edc726-5acd-427b-8527-9415c12d69cc,Commercial,0.08261848067692534,44,2,326,403,77,84.5964199957935,6351
4b9583be-6bc9-4895-b62e-63e0d58c0fe4,Residental,0.018456730610936445,22,41,321,976,655,57.64894969971427,3899
d0fefa86-baa3-4ee7-82d8-3188cadc4a21,Educational,0.8029706833019511,9,18,389,781,392,81.63466514419986,2053
b47a1ed1-f2b5-4149-904e-addf19c563e2,Commercial,0.9639482766780941,25,46,372,553,181,44.69284964008049,8491
d7453c5b-60ed-465f-aecb-deab8cf19304,Educational,0.4373929296658342,22,8,282,604,322,11.103124043711194,1805
294b7502-76b5-4c73-bac4-a580089c62d0,Commercial,0.9168350829048879,49,15,440,1008,568,83.48358781236196,6549
b112a35b-9817-469b-9417-feb009452b5c,Commercial,0.8535751674034076,44,44,15,924,909,60.97081202984158,2748
94d52c15-fe21-48d2-9d7b-b2f24061eba0,Educational,0.02941792672421506,14,18,458,709,251,48.91969919380441,2799
af1ab14b-1060-4ed2-8390-956b6e1ccd55,Healthcare,0.6390412090620395,39,18,540,820,280,63.982712994245766,1179
f90086be-b0fe-4467-a675-11e3fdff6f4f,Educational,0.20621944640678203,46,13,711,1020,309,27.34791450867808,2647
f262c01f-3826-40a2-8be9-f75325f8c1f8,Healthcare,0.0717819032331497,49,47,640,1368,728,96.52039168025802,5174
5fba1f16-630a-4b50-9530-e6a091575656,Educational,0.5912652148801635,17,44,50,1373,1323,42.278736963739135,2252
c505acb6-e286-4d5e-aa70-b8a4c6788324,Healthcare,0.9783869948429957,9,32,97,986,889,89.42671291613092,1995
edf1cc0e-47db-4c92-92c1-1a64ac33d92f,Residental,0.35301196411344926,2,32,582,1170,588,30.37791471689169,9472
661ea5ad-9762-4a15-b72a-c88fd49ede2d,Healthcare,0.7770483911143728,32,40,416,651,235,32.05331345144276,1318
6dae8bdc-7852-43ac-90c5-76a04af28ef3,Healthcare,0.3569934993414995,50,36,99,945,846,92.05664827842914,4646
38e7e361-4aa9-4b40-8944-429067c8c15d,Commercial,0.8435529423824649,8,10,330,897,567,74.34055052663909,7001
5fa32996-1325-4bb1-8e0c-11c09fe7cca2,Commercial,0.1722798378094743,40,2,91,550,459,38.4718714305811,2913
2d6fd374-c5ac-4c26-bfd9-048c53fc4cc5,Residental,0.9253226627376534,5,18,229,521,292,80.63621829452921,4028
8d0311ef-4470-4308-bcde-c34f64fe418e,Healthcare,0.9941972462202738,19,45,607,791,184,31.74368891096683,4712
02db0507-7a41-4841-872f-9690404a3e57,Healthcare,0.3841384914471775,35,28,241,1033,792,84.69861021542279,3984
19c67086-4a50-42be-898f-1c3f3b2fd321,Healthcare,0.09909506750537056,13,8,218,1318,1100,66.95125008673487,6521
3c828436-2fca-4095-aa93-82ebe0d16d32,Commercial,0.22322353074905177,28,37,479,1264,785,59.97180445165782,9277
97765d45-f494-42c4-b4ac-a25d1b5efb6f,Healthcare,0.6666979750288071,17,38,168,1233,1065,83.26040371089766,3354
c77fda55-07cf-499b-9051-0646eca42ea5,Commercial,0.39308049167483694,31,38,539,1099,560,95.26256764554215,3765
5456495a-db06-4567-bd8d-38d4ef9f993f,Educational,0.9454564276238907,26,20,491,1256,765,43.23519603023172,5347
13efcd7e-d6fd-439e-a6ca-f5894d66a2a7,Healthcare,0.33652376234999604,22,23,696,1329,633,86.57495202906834,9067
63fdfbad-5ca6-473a-9ae8-f09bc1762136,Residental,0.4480511482645373,43,41,589,1228,639,56.41164923656873,3390
084d7863-8484-495b-a1d4-c6796d654adf,Educational,0.28624122308182953,46,11,557,990,433,74.63433792662784,2028
a3b1ccdf-a037-4fc3-848f-a54409773486,Commercial,0.31466855065962385,46,41,468,541,73,17.383663036485544,7524
a022bf0b-e07f-4fd3-96d3-54e88149e2bd,Educational,0.6997385398873881,22,15,341,769,428,94.7236432454737,4481
9f1c958a-3462-4f09-9dbc-5adb3e00a41b,Residental,0.7229520894548781,38,35,541,783,242,45.95629649362436,7622
48b0fea3-8181-4d97-bfdf-fbe2f801113e,Educational,0.12358828767408403,36,43,326,1039,713,12.85089233688462,4305
8fbf057d-463b-43da-8bb7-e27904cfe082,Commercial,0.11174063806610413,22,48,519,1011,492,89.00652629839631,3013
a2505642-b26c-4a9f-9bf1-f6d6c57d0242,Healthcare,0.06294379177033715,43,11,687,1173,486,84.17597056102693,5272
9a5df023-2777-4ea7-9263-562976c89f7c,Healthcare,0.9901340703022881,45,27,283,1372,1089,47.96917776470481,1610
d94ab7c3-c9bc-44d1-bac3-c3324434db67,Educational,0.8505130213194024,3,18,471,710,239,25.980209993072332,7605
262b858b-103a-4852-a6dd-aeabaed411f2,Educational,0.5165471094914572,1,18,86,640,554,82.5114369696084,4401
722a7acb-9543-40e3-976f-d335a17b5d9e,Educational,0.6069669297648345,6,45,167,395,228,91.58903093539976,1228
4dbeb1f7-21d5-4576-a703-bcbf838db7b5,Residental,0.5412638553781237,41,11,504,1420,916,66.04620029252732,7581
3eb9bf81-dfd7-465c-af11-92c26914846b,Educational,0.19244603715650643,1,7,367,1139,772,66.92221411392059,1548
a6cf59cb-12db-42ad-8f82-a9a8f6a6a153,Commercial,0.3600141921701494,4,20,73,664,591,67.52319472793573,6703
69f0d18d-59dc-4c66-b3a9-9e293d3d938f,Educational,0.12495667031639113,26,24,511,676,165,39.15947964728865,3507
ef50d638-ded6-46d6-b91b-06de5a0c1f71,Residental,0.01682939570530062,30,25,58,457,399,85.46701973982549,5367
d89f1418-cff0-4d50-8915-ae0fb761aca8,Healthcare,0.7658102718578772,5,14,485,1359,874,42.69862970660439,5169
d2c5db37-8327-43e4-b2f5-e8c2f0249d44,Commercial,0.12743513997733436,18,11,181,314,133,64.56661197209455,4663
02ca2585-59bf-4899-ba99-72b8de19a6c9,Educational,0.42323003034932116,1,26,244,1201,957,95.62772610710188,7467
dd443b4a-dea4-4abb-b804-d7e169922b19,Healthcare,0.5389256462628169,10,5,184,443,259,64.76900865755906,1721
f39ac883-7b85-4846-a5e9-8759206fe86d,Residental,0.6051238380692352,18,26,55,658,603,55.95666761469248,1288
512f0d34-6948-4cb8-a7ae-e23190b9e3fd,Educational,0.3916545798437946,42,40,200,1265,1065,71.2589080270595,8345
8256a55b-c771-4948-9307-8af6dec121a3,Commercial,0.9878964161118481,22,42,93,914,821,94.44512400893022,4999
8b4eae9f-ff7b-491b-95c1-ca383736482e,Residental,0.8454839199739774,3,33,538,1197,659,17.91263212237175,6813
c29a5ee1-63a1-4b10-96ee-595400981f80,Educational,0.8780260196176302,11,22,511,1236,725,16.027045215293985,4480
b243ae47-5dc3-4f50-ac4e-ba5a0aa7f779,Commercial,0.6667242023158457,32,7,48,136,88,39.64819587554615,3872
cfd3bea8-45aa-4b8c-9d8f-38b9385f0563,Residental,0.8555428071042009,24,5,388,1398,1010,11.673014658409125,5069
0391e7fb-e2e4-4987-bf64-bf040b7e676a,Educational,0.5303831323109796,46,32,390,1177,787,94.28716324542134,1733
976b393c-f026-44ea-bd7c-c15ff9b4b4aa,Educational,0.2407005667468295,13,18,526,1207,681,15.192141130798499,7359
9555d1b8-5490-41a5-8ba3-b4ca8d8438e0,Commercial,0.9569446231115554,14,34,151,1002,851,20.423814344359094,5272
10597f2a-1596-426d-a5c3-8a02e0bffcf9,Residental,0.300991385391265,16,37,98,1174,1076,50.928508044954796,7794
37c1127c-e478-42ec-b503-af83cb00cd31,Residental,0.7149868987168462,50,18,52,206,154,69.16465596633267,2445
ba55f803-fea5-423a-bfe2-23c6c86cb38c,Residental,0.3338398366811989,37,11,565,569,4,32.4452221763939,4588
400aede3-75c1-4e1b-9788-785e8e867bfa,Educational,0.4164096799207294,13,17,55,327,272,69.25148028816773,5628
5cb099ef-26be-44ee-b1fb-6cc8ac096b16,Residental,0.805203711606474,31,48,163,381,218,67.96694768304695,7776
a096f2ec-b22b-41f0-9291-3259055dfeaa,Healthcare,0.39195011732338514,13,18,475,726,251,28.697136909246417,7401
bd887cdb-a71a-4e08-a906-4a3fdbf73170,Educational,0.21456762788956762,39,16,299,487,188,14.396093680280215,1707
009bf12b-a695-4455-bd27-4a72568325e6,Residental,0.27722125286857024,24,29,499,639,140,84.00611054501842,9171
439f7509-5ab9-4abd-a0a4-2fa60cd680d7,Residental,0.3966912512550671,23,44,295,465,170,24.37769387027345,6887
be9c2681-0da4-4805-9806-7454e61e2fe4,Educational,0.1898231976183925,43,6,614,1081,467,30.428253359289165,4012
40102690-9a4b-4d21-9ab8-909d339a5af3,Healthcare,0.6191812823287883,27,41,179,932,753,42.664123503330075,7017
1c46aa43-939d-4d61-8e28-c560611240c7,Healthcare,0.494387690010604,2,48,714,1212,498,15.937285876436238,4789
4faadb5e-2ae8-4d4d-8956-af1b496ca39e,Residental,0.07239930515650894,15,3,563,1126,563,92.03516242575866,7426
d2846bfc-d743-4a88-8948-050b3af75f2f,Healthcare,0.11346357677182439,30,50,503,650,147,34.069800938280125,1524
18b1393f-55c4-498e-a36c-90e804b4e61d,Commercial,0.08141411851543456,40,30,369,702,333,26.561046207256332,2603
e00a0dd5-a5e2-41cd-9fa2-875e206106cd,Healthcare,0.11129205546333665,23,3,566,1080,514,48.555816094156164,8328
c8b431fc-aea1-4b34-8e7f-46e49d39a3f2,Residental,0.8654840022934299,15,1,523,964,441,70.52861311604164,8130
4bbfb91d-5715-4324-8e2c-76c45a007682,Healthcare,0.4075988810935861,42,39,413,762,349,30.04982952659753,3236
cf59e520-983b-47d7-b287-a35583e8bc20,Educational,0.6058334460592254,30,1,169,172,3,28.23972822297734,4072
d461d107-e3fd-4d66-b54c-afd2668f4d29,Commercial,0.03726730166196024,28,25,473,1374,901,41.54122641148142,7518
a8b77788-e6a5-4fd0-94d8-efe4de28fd46,Healthcare,0.15579489156805038,31,7,405,1359,954,16.112630594458615,6136
87cfd50c-0974-4ea0-8915-eb43e079f588,Commercial,0.4759373414462501,1,27,383,782,399,43.14972701780375,4174
098c58c9-e5ca-41cb-9f0e-a323212e59a4,Residental,0.16567014944173053,47,14,22,26,4,69.42622126240946,9673
573fd265-0588-4423-a580-18a59ba90ed0,Residental,0.6086488990658246,38,5,705,1404,699,39.569646081256536,4026
152c3eee-9870-45ca-a84b-67c01bf13daf,Educational,0.5689545418236518,27,8,317,1329,1012,70.9684863551347,3364
f3704b63-c073-4c38-81fd-757d11a82a66,Healthcare,0.11396957236013827,1,38,521,1155,634,67.65518358316196,7341
fec6ae39-3389-4b2a-b846-e3a4458c0938,Residental,0.30716958954418994,28,34,403,1099,696,92.56101807683518,9732
8026c2cd-b21a-4b15-9a58-adc6bb8f01bc,Educational,0.45933043118503647,42,25,242,1156,914,85.32197884356988,3092
a713756a-c55f-4d43-a90a-4061cfbcdcd7,Healthcare,0.870172134912433,6,36,236,934,698,69.59770246800036,1567
eb0402ae-3e22-4f11-9fe0-0ecd1b2b4b0a,Healthcare,0.6611396194961482,11,33,124,533,409,60.996729232211955,5183
752d3b39-65e9-4f6e-ae48-14750d757d25,Residental,0.5404925369784583,9,39,615,1258,643,79.85949152185938,2318
0bee8ece-2fba-424d-ab6c-d2620f6e464a,Commercial,0.322862868614336,42,4,581,992,411,34.96463470951923,5127
ed451258-6294-42aa-a91d-2830a338c39b,Healthcare,0.9918079640982949,7,25,393,1071,678,88.86780244645895,9666
acb633ff-be6e-4ffd-a63d-597fca3de323,Healthcare,0.3786861325652243,44,24,658,1314,656,28.437387324521918,7500
4b83ce9f-7aed-4c60-95a8-b4df2fab5479,Residental,0.3449970804134459,27,27,562,640,78,73.03242746785958,3948
19be3f35-f2ed-4d05-8708-56b557cbf5fa,Residental,0.4417909453005143,7,42,93,293,200,49.85631386895298,4721
a53c5271-81e5-439d-a516-2f3848fd41a7,Commercial,0.6510358311859596,50,24,624,641,17,33.93384926966351,8383
c6edb75e-7a5f-4f9e-907e-c545e1c89faa,Commercial,0.9880459536938656,22,35,260,1352,1092,27.502025439116764,3072
67ee3b3b-8e35-463e-a766-0ac3ccc5b81d,Commercial,0.8850926821923462,42,43,466,618,152,80.99552286933944,8255
cdff548c-b4e9-4c22-ac91-f567a8d9d8ee,Commercial,0.7796806311705494,20,8,227,1144,917,74.12951503227104,4384
71c2b29c-3e98-43cc-90d6-bd684309161a,Healthcare,0.37470908762466604,36,6,498,1287,789,33.5212238361367,7927
6a6396bb-ac08-44d2-8814-17ba6f18c64d,Residental,0.18448846671962893,46,8,695,781,86,76.97035355287406,2597
171558ec-36d1-4f01-b3dd-e8025794302b,Healthcare,0.4294865964953144,40,20,349,1220,871,20.19525659600398,7583
77e77d71-faf1-476f-87df-faf5e965c8ae,Commercial,0.19361454250035826,37,25,307,631,324,95.62207116949567,1340
022dc429-cac4-483e-856f-ecf1400971bb,Healthcare,0.11029637704279638,36,34,338,950,612,62.76841274995645,1472
01f28ce1-e530-4c7b-9612-6d4de26ba11f,Residental,0.2802517091599698,15,41,616,770,154,97.59770389505157,8516
fd11b616-6083-4a85-981f-96f4ddd0cd52,Educational,0.5375481165923771,34,38,166,1300,1134,99.40449503143343,9474
a580558c-c811-4182-8bb1-4b9e7cffc397,Healthcare,0.8099155892700344,34,5,626,1385,759,69.86287163333498,4140
00d418c5-9970-4420-98d1-a4a348aed440,Healthcare,0.777219252673691,50,49,644,1288,644,92.58237955421806,3066
af7c9f8c-e922-4450-834a-13117a24aa1b,Educational,0.7211742268893179,23,25,284,1270,986,12.425783561655368,6740
23ad5e02-c4eb-4fc0-bced-007bb93cf6a4,Educational,0.9901522412247205,49,2,201,485,284,26.40852058063516,1375
fb38f0c8-53f4-45bc-a3fe-e31f1ffc2548,Commercial,0.5013466032447653,37,5,276,892,616,57.38495080707049,8289
d729f3df-5bda-42cf-b722-18ebb29903bc,Educational,0.4492329625714355,43,46,311,1300,989,48.36138088835202,2129
6d4948a6-1056-4211-9c80-17109d84f49b,Healthcare,0.7075419581601144,40,6,64,1244,1180,57.671007521627786,9288
bbbcfa3b-f66d-4c17-b0b4-a215243a207e,Educational,0.9717870941391361,43,25,226,609,383,62.39678440622822,3991
15127af2-8c31-404a-a0a1-d914bf5896e3,Educational,0.6692149820887778,14,2,250,1023,773,83.53274992278327,2773
25ac7a98-6b8c-45ee-8b44-81f90fd109a6,Healthcare,0.5327881724422537,6,31,79,217,138,22.333819812454223,8912
935df438-abc5-4dea-950b-dbda91170f20,Educational,0.6819179622512946,4,23,97,490,393,37.065238856993105,5069
d5866781-a213-4ab8-a410-433ae50d593d,Commercial,0.43905309352072797,38,20,487,783,296,86.52610642462906,4087
8dd93e21-4362-4bd6-b279-f77b0a3d9d62,Healthcare,0.5774164883196637,17,21,195,679,484,69.00094779693829,4890
61b2d252-cc46-4552-b6ee-1af6b0bf2413,Healthcare,0.02659979026328585,15,36,83,646,563,42.865213619426946,4052
f53b9ee9-3b04-434b-89eb-aa49fd3b0095,Healthcare,0.3779648334895591,18,11,452,869,417,38.89659078788361,5101
1407416d-eb47-4c28-a8e5-b9c771e156ab,Educational,0.14061375479929183,50,20,256,1209,953,96.6981107367024,1647
d2b09a6d-86ab-4601-973a-a60ca7521577,Commercial,0.026571857160074264,50,8,51,292,241,12.21269728358995,5669
bd95dfdd-1e87-4581-b7bc-fea5440b0e8c,Healthcare,0.2976107989344088,7,2,438,696,258,56.70772845685049,2343
31c640f1-e8fc-4ce6-9258-eb8982395b56,Educational,0.47632605542162876,5,24,678,1225,547,30.277297679798497,7222
71670011-b938-4192-b685-da3c8d951962,Commercial,0.8261706049140228,19,27,492,1175,683,88.43059385741182,5763
6e26e599-2415-4a94-af32-775e89076552,Healthcare,0.015480483122903177,15,35,224,1067,843,79.8276191724175,9817
cad2835d-2daa-4143-a4a8-15c25787113e,Residental,0.6088771863739539,15,31,157,644,487,46.33771062018763,7027
77b7b88f-752a-4d60-bce3-b76a7bcfa4f0,Educational,0.7989566627809991,48,2,45,1321,1276,76.16082583145116,3435
f53fa664-93e1-4f07-aec1-7457ac2b670f,Healthcare,0.7839035240233033,43,10,143,194,51,39.20562118575543,5346
45a0f7a5-f8be-4ca4-920e-c924441ba6e7,Healthcare,0.7552007338876386,10,5,409,1323,914,33.440381727335414,5728
46063d39-b966-4a8b-a963-6135b8d27561,Residental,0.353412306169958,10,50,448,1169,721,86.61999427606902,3117
66027647-69e1-4dde-9f20-061e426245fa,Commercial,0.8170835943451076,19,41,597,982,385,91.16493847690386,6360
de800bc9-f1b6-41a4-9871-9eb49bef553e,Educational,0.6202697208841705,23,4,408,689,281,78.08177337069509,3566
0f956664-7814-432d-a30c-a3954a0fb84e,Healthcare,0.1811993527858916,49,35,6,1158,1152,48.4461822073461,1186
7865bc3e-b074-437f-815c-baae3e16ddb5,Commercial,0.655072458821345,49,14,82,850,768,76.41621795623756,7790
91c9dac9-7193-4833-b63f-83cf30951fbb,Educational,0.2631873412804798,31,44,232,373,141,48.14091312800882,2781
b8800655-0e6f-4cea-b324-c5a2f48987cc,Commercial,0.6641279685065029,1,1,708,1436,728,48.862842688629634,2174
a46307a4-8a60-42be-9233-300f34653481,Educational,0.6416607701117157,12,45,357,663,306,84.25335216238508,4953
42a51857-fbd9-42d2-b90f-7def4c9dc2ab,Educational,0.28153822810251783,47,49,557,825,268,75.77415816526059,8162
36c39f08-d4a4-4d5f-8cf7-b10602a6fd45,Residental,0.8778439366666417,40,17,14,1022,1008,43.49402938326742,6539
c290dcf9-41b0-4ebc-9a17-f91d284e7197,Healthcare,0.5055888180455345,28,19,436,1350,914,99.21708690091012,2490
60f7fd51-c742-435b-84a6-3a517032826d,Residental,0.5731932569505422,39,27,686,900,214,14.420679411463318,2925
1bd63061-c390-4c3d-863a-72c4b00733bf,Residental,0.08412777395209559,32,10,141,824,683,38.05741221385556,5313
16f0a118-c9df-49d2-8eb3-d2c97bf4c5ed,Commercial,0.05980034162247427,46,26,197,885,688,66.24995193565972,5404
c9147f01-63fc-41ee-88c3-75adb46a9997,Healthcare,0.45250565242936247,34,42,693,953,260,47.427394489096635,1038
d30267a4-8686-4689-a4d0-526f98ae7430,Residental,0.3752210975026451,16,13,686,847,161,50.8434550814419,6890
6a820fe4-94f9-4758-8be1-66bc7e93821f,Commercial,0.24755466008990823,41,46,167,577,410,24.10826461926078,9212
afc53fcb-fdc4-4fdc-b7fa-2432dee70600,Residental,0.8185855998176269,11,17,378,1092,714,20.23783323620645,9783
dbac8e24-6313-4e10-8807-b02a7c1aeccb,Residental,0.723081043099114,40,47,387,1077,690,69.29399924723,5286
84df4ff1-142d-4279-8364-ea94f73c7dad,Residental,0.47852132322966034,36,8,179,1168,989,16.165409473948888,3004
d9ef55f4-7f96-41fc-aaeb-1add6afbb97b,Educational,0.7722197708104594,12,23,720,1054,334,63.75081974953236,2874
cb2301d9-9c8d-4090-b68b-befc58317f0c,Residental,0.12153246083464275,45,3,153,900,747,11.407292630891103,4506
e91c5128-6274-4721-b7fb-aae3e7771313,Commercial,0.2661551520877057,3,32,698,838,140,62.772728062883786,2694
a2cba940-5ea4-4b06-898e-9cc17dfbdbf2,Commercial,0.1784709822071624,8,23,508,1206,698,55.24855673132047,4604
f6402549-5a28-454d-9976-88d7c3dd5856,Commercial,0.9396357783550984,1,2,612,733,121,19.777907770627138,4491
1a7c0569-aacd-4edb-b941-e6a3f7bf1a33,Commercial,0.023027465229661592,23,5,485,1251,766,96.02400916321156,8651
6ce16b05-76d6-462f-b20e-784aaa4c080a,Commercial,0.22276874443915518,42,38,412,855,443,56.21191165321175,1537
1db2e7f8-45d2-479d-ad8f-96f9b25b2c27,Commercial,0.9985764193335877,50,13,89,92,3,22.356030015637806,9656
4b3c971a-9cc9-45ea-9638-811d90248192,Residental,0.029954633514356566,9,9,307,1028,721,52.24485209845075,7653
7df15391-cdcc-4586-897c-bf5a4bd1a0aa,Healthcare,0.0482144828159633,14,48,20,103,83,76.20907266692834,7121
1d7fade7-9cf4-49c7-9656-963078f0cf62,Residental,0.8964687471366939,13,27,28,865,837,59.76646607788893,6184
eed80b0f-579f-4790-a84c-cc29890ed12f,Residental,0.8315291212656338,46,50,281,419,138,85.94123887082944,3247
98ac6d81-3db1-4ebf-b367-5ba11adc4d04,Commercial,0.9626750081948682,24,42,412,1174,762,27.80913590732143,9478
291be650-895b-429c-8a74-fb357b3057e4,Healthcare,0.6270666435964337,36,34,46,358,312,35.633514234513555,6888
0145353a-37ef-4802-b42d-182a7d0e4eb5,Residental,0.0048793388932585335,40,19,622,1150,528,29.253101290451298,1188
85186846-d9b5-4fd1-ba0a-38c35a34e252,Educational,0.3943102794729989,18,8,340,1001,661,12.412592248768641,6527
6b0c75f7-a1af-43a0-917c-56a7c4d5f34c,Residental,0.7866022984166694,48,46,552,987,435,28.401932875932147,9857
d6682843-5780-4c64-b3a3-8aff3119530f,Commercial,0.522108968458152,14,38,525,1388,863,24.918426553794482,3911
84947eab-308d-4bc8-a568-a3f818d62d7d,Healthcare,0.09419790452054366,42,25,364,773,409,90.18000571008879,6371
65a3cd0b-6890-468b-bd01-49480491c0df,Commercial,0.6493773004193202,49,12,524,1059,535,31.544515872121533,7727
46c39f10-7cd0-4777-9ab4-75b525e7e6b3,Healthcare,0.7021298969578367,43,40,490,915,425,16.347647446894342,8436
18632cdc-58b4-4b49-98f8-1aaddc8128ff,Educational,0.020262791013499037,43,5,227,739,512,24.51391143927058,9434
fa9d41d1-4704-4ba5-a663-732761e71206,Commercial,0.06202951932919187,27,11,290,495,205,42.624425074156704,3095
6b88582f-28aa-4498-9937-004032c790d4,Commercial,0.25638166099800275,31,30,544,765,221,99.2600521531635,4014
1a115e38-346d-4b53-8421-a95bceae65ff,Commercial,0.26127252422294744,6,18,247,795,548,54.79283375428226,3535
087d63d3-5cc7-4545-83d7-db53587d7cb1,Residental,0.08122469538652433,33,47,549,678,129,18.69211355001298,4759
5050d22e-095d-4826-aa2e-3d1a5c127769,Educational,0.5950509258721887,42,43,135,589,454,70.17578465419905,6772
3973d71f-e491-44dc-9332-4f8782e3db17,Commercial,0.538313380698192,4,19,471,560,89,71.62634980946939,3656
510284c0-8174-4ba6-a9bf-9604a3e710c5,Commercial,0.587827864780447,1,26,395,642,247,72.64763328776466,8274
56913e28-b78f-44af-ad26-21c2dcdfeb6c,Healthcare,0.17815128158305793,47,24,665,884,219,88.6243701439826,6756
28c76591-cd78-4d90-978b-672ca4b28def,Residental,0.5904879270984955,35,38,8,322,314,30.71857914205175,1940
fa1f7006-87b3-46e3-9869-4609c34b62a9,Healthcare,0.8577282945072967,41,32,385,761,376,10.060267190183161,8948
b951c825-7697-4161-b6c2-6d4055509025,Educational,0.8184446831454701,16,22,214,1184,970,44.47918242971057,9428
fbeeec1b-b9ab-432a-b107-71aa21d4fb2a,Educational,0.6445812529213325,27,31,664,1221,557,83.91233678479783,7523
379ffc59-cf84-434a-bf3c-4e27c9ad7843,Residental,0.3532673347941845,2,12,85,570,485,88.61582260281297,7768
bb457239-425d-46e9-a3d1-8a3371723d93,Commercial,0.45063281305166325,20,11,192,995,803,36.078276057463455,8462
792e1183-dbcc-4716-ba07-d0e50c391cd0,Commercial,0.8304144678555387,12,9,524,704,180,15.13900213387659,8387
303b5665-49f9-475d-a15d-c08dbde18659,Commercial,0.8296387073012162,33,13,139,674,535,56.200947770552006,6835
83b4ed73-ab9e-4858-a1d2-068a419fb01b,Residental,0.8723268357819117,30,2,241,705,464,22.03899599138711,1561
4aa8dabe-4690-496d-9e5d-6cc6fe3c777f,Healthcare,0.4470169205174779,33,17,340,632,292,15.37478347286303,1336
9e123207-1439-437a-8979-6bfd5204d4c8,Commercial,0.3037891492517617,31,40,573,1180,607,30.09939163615845,6106
c4b9db82-4f76-420c-9e63-7c56352ad315,Healthcare,0.8610422897698646,14,48,604,615,11,42.75492301300372,2119
01c6cf82-af67-4b71-8bb4-b185bae5f091,Residental,0.09501841920325338,12,29,424,1103,679,53.251863376261376,4653
2c822e7f-2b19-41cc-aebe-ba98fbf01fa0,Healthcare,0.5098188770942984,8,48,628,1132,504,77.59955487505441,2756
be433599-e34a-4e1b-a04c-0aa9fce86d04,Commercial,0.953220345759052,17,16,2,41,39,74.13723091768875,7279
fa4893a9-749c-458c-a091-fd02e2e939a7,Healthcare,0.27072576968546136,49,38,531,779,248,93.55664146099856,4948
48a1c7a3-251d-4fe8-a39a-ffc4d6c9da13,Healthcare,0.17714120050592608,21,9,531,1044,513,71.01772187290462,7581
b80ceca1-eebe-4f0c-a580-cc8d5fa0bc67,Commercial,0.8062920639353189,17,45,311,622,311,40.15236139657711,6441
db5019e3-25bb-4af0-b8c2-f32c18190237,Commercial,0.6746357196150348,16,28,607,840,233,42.183230532951285,5391
24b384ff-7757-4047-8b27-4b233de907a6,Educational,0.36778664150257656,44,14,178,251,73,53.783904741794316,1329
9ef81bf2-f11a-4567-bfd0-7534c9bfc635,Commercial,0.8746827524526418,1,37,458,927,469,32.22868409690433,7429
e9e48d29-c61f-46ef-a068-f09046b4f785,Educational,0.7329854759060349,10,36,272,1051,779,94.7533732579359,5070
297bfd9f-b603-4dce-aaad-2e8353ee5386,Healthcare,0.35470758609183306,19,4,477,821,344,70.79816851467754,5088
1391ec3c-6599-40b3-a3e8-993c77bfc7a6,Residental,0.36140403314302394,34,37,54,1352,1298,50.88513728650838,2686
ee46e9d2-3dce-44c3-9710-2373b3b587be,Residental,0.7892631698145574,28,48,129,790,661,77.44031982690097,1366
0b3f7743-4b1c-4be5-9cc8-6e60627bbb17,Healthcare,0.020908954122936807,8,47,11,567,556,45.20735186283381,6749
23552223-4701-4ac1-9c14-985fb88735a6,Educational,0.3586483506321074,16,4,385,1149,764,98.60985833875566,3910
57392b1d-7c7e-43bc-821c-f93a96e44ad0,Residental,0.4859147099733967,17,34,144,574,430,33.92608868982269,9417
ff7e2fbd-c526-4fe6-8328-e6134b87bbe9,Residental,0.4047817744071821,10,46,583,669,86,38.16281233276992,2736
ed1e9d8b-b0e6-49b0-bbf3-461fab9a800c,Commercial,0.9202723630861784,14,35,320,1307,987,96.39448168317642,3305
8e37c60e-91d5-457d-8625-f00f9a36f651,Educational,0.11166313900979563,10,46,301,1349,1048,61.1305142149963,7938
5bdbc50b-c4f7-43e5-b333-2f7e542f582f,Healthcare,0.5619816026716311,45,2,398,1295,897,39.60660508217057,7259
4aeeef25-c159-4602-bf52-be970af0b558,Residental,0.32829601299455813,15,10,82,115,33,25.886512302247688,2504
007c0b06-1134-4df0-849e-807194c68bce,Educational,0.11546126371713372,39,41,592,621,29,78.24992821924444,5981
3867ed16-ca21-407c-91b6-c1b2dc036726,Educational,0.20369962389942264,21,1,472,1410,938,61.24394122080581,3638
b67516c0-a939-4597-9021-9be97c99ec8f,Commercial,0.7821981647972001,26,33,472,708,236,20.567933140279777,9363
71f13aa8-7a18-43aa-8e47-06c81bb51f50,Educational,0.3824421328165999,39,5,296,1318,1022,73.72808773604365,5507
1af06893-1b09-4aa9-804f-c3973a704e8f,Residental,0.0028285359035958857,26,8,655,1041,386,89.07210708430357,2060
1a88ee67-7008-4fd4-809f-c558eeef06e0,Residental,0.03283879926120992,28,3,285,420,135,92.71005918842276,2498
33bbb862-b733-465a-b385-b7ce57df307c,Educational,0.7186558090361352,23,12,578,952,374,66.97543020399856,8620
f744c5a4-9cfa-48ec-bb0d-a4d8be248aa2,Educational,0.36667668464287007,2,19,504,726,222,81.56282885441686,3894
e14d29dd-5931-4d6c-ade3-b257d9801652,Residental,0.25630718353207727,15,42,372,1247,875,73.3881871853109,2244
5522f67d-3391-4f9a-afa9-bbc568bf9f09,Healthcare,0.9918824133344551,14,7,453,1250,797,18.443467595501723,2940
f5a263f2-dd86-44ac-8d40-a419cb16743a,Educational,0.41823338114201447,43,7,608,870,262,44.777565177575795,9049
72733b10-45d1-4ad8-a080-8a0c1fdf5cfb,Educational,0.42223217061816354,33,14,119,148,29,72.97506706270089,1752
0c8416ed-f100-4257-b3a7-1bec4cfe8465,Residental,0.8667016819182531,44,48,641,1065,424,70.40939092178525,6389
21ca422a-0da0-4fcc-babd-01255025cd2e,Educational,0.0921529919420836,27,3,471,530,59,57.12174496422581,3182
6ae4c5dc-1399-42f8-bf6f-af0622f6cbd9,Residental,0.22898270080253935,26,41,293,1185,892,91.75953937640973,1435
650d8aa8-3c5d-4b5c-84f0-3611b30fd0a9,Residental,0.5933868777301933,8,32,584,977,393,16.91362392773664,9856
ded1e555-c762-488d-9222-9081db40707c,Healthcare,0.8739163005936988,3,22,670,1388,718,67.80613976294327,3302
b100a4af-1afa-477c-b45d-ccb789412f46,Commercial,0.3251139813335061,2,34,78,1171,1093,56.7679696631027,8279
2b4d1f4b-bdcd-4c7e-a054-db2870d6ebf2,Residental,0.8092460388820375,8,37,120,204,84,22.834100609276945,7376
9f3119b6-1acf-4ccb-9eb7-1e2ecfda594f,Healthcare,0.06373882980950307,45,37,634,1175,541,31.71372996282134,1511
5f8ddbdf-4fee-4eeb-b0dc-b9f03be5fbea,Residental,0.6956361252297386,37,41,346,840,494,42.132644625595965,7655
0d913a39-7440-4857-8d29-0ec82bae42b0,Residental,0.7912417603839434,23,42,609,982,373,10.617622882159436,5498
bb0d2d83-66e6-4744-95db-737af3419b27,Educational,0.13571664562684072,48,4,383,1038,655,49.38011612699767,8480
db2b95e8-0407-4e8b-bd58-399b665e3d0e,Educational,0.8599490367865074,30,39,372,654,282,24.808784580027154,6163
d58a7e04-33d7-4439-a4f2-23ef70f15a2e,Educational,0.1224466898566916,1,4,310,324,14,28.62857667228204,1299
2fe5a73f-215d-4b3d-a935-81dde6efdbe8,Residental,0.04688335992045267,38,30,610,1174,564,67.66738361902945,6258
d97217c6-1737-4243-8253-d32d71488aac,Healthcare,0.14755790009230962,37,10,34,1219,1185,87.73301138656934,5586
848f22cc-0e96-4b9e-b171-141571b80d7b,Residental,0.33618696489830246,11,9,122,161,39,11.685073103432455,5193
4e131262-fb11-4930-8ecc-96a1808a34c7,Residental,0.9111224556491943,3,17,50,1050,1000,76.14203452604062,5971
efa26ec6-0e97-4112-ac43-fb23c2994b48,Residental,0.5074457156392956,48,22,268,1255,987,72.30895472737465,1198
84c0da6f-dd9b-42eb-8639-1df2b8d459ee,Healthcare,0.20231255698818285,38,31,48,317,269,17.498296680061898,3755
2826fa3e-2224-4927-b187-021ce7963461,Educational,0.8814672070766065,18,22,378,654,276,64.3679689874759,7341
bf08e642-0eb8-49b8-9547-1c2e7fd0b24d,Educational,0.030652802127511203,45,26,647,740,93,13.965825653725556,4568
d092d9dc-9f04-4337-a583-89b17e6bcf0d,Commercial,0.31691233508698535,38,42,641,1094,453,42.09967730031927,9687
a7f5dd0f-ef55-4d52-9413-41f0cd531a7e,Educational,0.494022089812611,4,33,31,1220,1189,45.83355234629458,2141
2f6b13e5-dc51-4043-9053-a6e21a9ceafc,Residental,0.9599308143576938,47,43,486,589,103,77.53987401000283,3276
9207c80e-abef-4a63-827f-166238fde500,Healthcare,0.06967812394321493,29,4,286,1045,759,84.26115935663105,6202
1db1aab6-2f01-4442-953a-4d5530e80401,Healthcare,0.07701513815349137,6,33,129,718,589,82.83561209937812,5705
1d5a724b-81cc-43c5-a227-c6c6e35bfcb8,Commercial,0.733267832646296,18,8,527,798,271,44.59383455973969,1881
454c6b99-9adb-4256-8af2-b566898b6446,Healthcare,0.4361328676494557,34,10,175,1008,833,21.964734298673726,7089
3c2b629a-cd3b-4f72-bb3b-a8d0ef6d1716,Commercial,0.679439339199228,48,19,246,1412,1166,77.40959131445881,7110
85e5f652-c8b7-4404-b0e4-c046105f3507,Healthcare,0.8438929978413535,37,5,220,1125,905,55.40692050442344,6873
336584e6-545e-4540-a424-0e4683cd16e7,Residental,0.34567179239322987,35,18,47,412,365,38.24133209528134,7347
3a15863c-bfa6-4e52-a166-de1aa83a0743,Residental,0.8072027307428502,43,21,388,1333,945,12.410714956178332,7267
c1bd0080-d9e3-4799-8ceb-27446db4e1ae,Commercial,0.8509074438574228,5,23,418,956,538,85.70379229790171,1624
d5afc470-78a4-42e5-a714-15d930cba6a4,Residental,0.3953179244047361,14,25,193,1377,1184,53.93782185752287,7977
ecefdf4c-b827-42ed-af44-284271ccd0a1,Residental,0.9660544631986613,41,46,450,834,384,75.03334164703764,8834
dbab9257-6c5e-49de-be58-72eb76ebd9ab,Healthcare,0.18715072672751687,49,44,635,1248,613,57.409423535903656,5025
898dae4c-6a81-4be9-b697-4444278d8dd1,Commercial,0.7447014939749622,33,39,110,217,107,88.67485588666219,2003
8893ea1f-7ad3-475c-99a2-8daa3b20fa8b,Commercial,0.43697179855777113,37,8,228,462,234,73.20545514495156,2582
e0130b08-fc8b-4eb3-9cd7-dec8aaa9b20d,Educational,0.777231784784611,34,43,130,309,179,68.36045502031884,1527
af00a108-5df8-4c5d-94ce-d24aa1e04334,Commercial,0.2826702741616097,48,5,629,863,234,29.95133188412729,1028
0a41fa53-484a-435b-b9a4-2233fead90f2,Healthcare,0.2597413517459264,24,27,56,474,418,41.211850014585764,6996
9221880b-2fb4-4943-8d50-4e131ececc8b,Commercial,0.5072315071027715,12,44,583,785,202,16.06973675223668,6759
ba481fc3-2f2d-402e-9a16-15cc1cef06f7,Educational,0.8648879117493997,7,36,430,715,285,46.100697154149586,8135
1c7ffec7-abb9-4375-9709-e3352067dc72,Commercial,0.6816365849098447,16,30,541,878,337,77.81240004249264,2871
1cba291a-92e4-43f2-93db-0078e522c2c8,Healthcare,0.24882369372987334,16,33,674,1120,446,43.22092565550261,4166
33396973-fde8-45c0-a331-8cef562ce28c,Educational,0.809259579080108,6,36,438,537,99,91.68355866036815,1195
32dc0fdb-c9ef-4953-9c76-0ff2104517d9,Healthcare,0.7218350995809063,3,10,300,1152,852,99.48039198944467,2910
34eea12c-df1f-4f8a-bb98-4e75d5e3171c,Residental,0.5938980971390776,5,12,225,526,301,18.84146649944521,2863
a017414e-9907-4d6f-b32f-04f950296bb3,Residental,0.7309839119360929,12,42,371,1083,712,37.185589548800785,4155
43c940f9-75da-44e6-9a23-36a491ef4d84,Commercial,0.0803091542046207,26,28,83,692,609,71.23394930405483,9419
246610d0-ef31-405f-bfc4-cabae91ece76,Commercial,0.7444811741754769,48,47,559,1008,449,22.715197939231572,6635
3abee090-c618-4f64-86b3-78445adfe43c,Commercial,0.20159723716156985,38,7,423,1127,704,26.00108802852519,2369
1b0d7a65-8545-4838-8daf-96e5e7f66d98,Commercial,0.6976937559939776,48,46,387,643,256,71.47615490278938,7048
c9c18a8a-5d12-471f-a37b-9fa669a814ef,Educational,0.447872199842423,13,1,386,974,588,44.801674437951455,9113
9457c81c-e195-4aa4-abbb-ca57e9863438,Educational,0.78078084533841,44,25,291,414,123,60.37766632065537,6416
92bcb38c-9e22-4db8-9471-ca76c06bbdc2,Commercial,0.34775755693033783,24,32,72,935,863,35.71784617378754,6625
a6d17032-2ba9-44be-8789-58c5a4d6270a,Residental,0.23295405268070768,16,6,195,1315,1120,61.94264198253606,1388
73154ce8-d4f7-4e42-ae7e-4416e5ef07c1,Residental,0.5914882323084475,18,25,354,1420,1066,57.33333429228367,3298
4e5a6ab0-bb7d-47b4-9aae-2c2430b76a10,Residental,0.6170083018297661,24,12,31,1015,984,78.76598699936899,4669
11ce9e96-bc46-4e5b-a874-79e32d4e9e49,Healthcare,0.44178006962779404,19,6,343,1392,1049,63.666483911086154,7099
32278fd9-5429-47f6-b933-230eda8108d4,Commercial,0.8381790412646288,2,14,631,1021,390,19.180058857434833,9691
48929bcf-acb8-4fc0-b2e1-4d4e01301120,Commercial,0.5884543123272433,13,8,409,422,13,74.19222914000922,8978
77ac9dbc-0fe4-40eb-9b1c-f717e6bae5c6,Healthcare,0.08553794680095372,15,1,159,487,328,60.91054060744805,4234
61817772-d059-482c-91b5-563b0991c469,Educational,0.5870622100614904,5,17,485,782,297,71.74622778964414,2223
dc3eb38e-f361-4728-ad9c-4ca282a0626d,Healthcare,0.322820923349476,48,13,466,586,120,48.75132471562998,5221
4aa53adb-64f2-453a-a3ac-ca4aa0c9416e,Residental,0.4482997370698929,7,9,624,695,71,91.30269267500087,3366
8c9b09df-9746-4665-aebf-45770d862f9c,Healthcare,0.055584648887339716,3,28,427,839,412,16.39088292802702,1850
7bbacc8b-ba19-4451-a79f-2c30a23bece3,Commercial,0.8711454998819982,25,40,635,770,135,64.54019055112252,7485
43ea9ed4-071f-4737-883a-4a56739a5629,Educational,0.6636323992228057,40,43,388,675,287,38.98819082600333,4523
ac5bc2a5-5a28-4aa6-98d0-4477f727b1e2,Residental,0.7481369676384674,26,31,617,980,363,39.34673921731043,4524
e7d0e66f-91c8-42d2-b9fd-cda9dc11b825,Commercial,0.446254364230237,46,34,335,1425,1090,48.11772417323905,2623
de9ef39b-6f48-44ee-9ab6-ad9a88c3d378,Residental,0.5681728504026856,43,7,323,678,355,73.06532937561468,1570
462743b2-8584-444f-bd5b-317aada753be,Educational,0.4019526745368418,11,3,625,757,132,32.847708130113446,3606
b9bbb901-243f-42de-9082-0d20110dd50e,Commercial,0.8812085687521743,12,40,73,575,502,41.22015976921524,7773
86a77da8-7e85-40fb-8840-2f761464a018,Commercial,0.37724268307496134,38,31,471,1399,928,27.964462786832904,6066
8c3be3dc-0b59-4a60-bd70-af39e0988fe6,Residental,0.7547660322102717,28,28,415,756,341,44.346691860743654,9579
4c36e7e7-2339-4390-ae1c-3e8ba0691a44,Commercial,0.8441247667968546,49,50,401,1037,636,60.89596001802211,8414
db65a859-ba7d-4fdd-beef-617b2a947f94,Healthcare,0.29793973774493665,42,44,415,1288,873,43.53264526504975,3130
1ebc1557-dc99-434a-ae6b-66085e027997,Healthcare,0.6557763075095198,47,14,554,863,309,14.335304545242398,1879
463ad799-9779-4a23-97e7-98e6251f5029,Residental,0.39179502935566135,48,42,177,265,88,72.92002589470748,8640
567931bd-c5cf-4d2b-8670-a493306157e7,Educational,0.47442922145633115,21,22,277,982,705,20.22660437202741,9373
e4b5e64c-869d-433e-9920-05c7e6de6985,Residental,0.5092600654733738,47,27,21,228,207,27.5816871697387,6079
14141751-c85a-454f-891b-9ab65d0827fd,Residental,0.5350907070151957,25,41,472,1124,652,17.370838052663558,8900
e704e872-410a-412d-9579-71e1a272fae2,Educational,0.47738406742215334,4,4,221,1198,977,79.62370126743672,2421
5778cc5d-fe5d-476c-8819-1b003e682dd8,Educational,0.7848570816049762,19,24,306,620,314,57.83163088793003,8072
d0a51c17-fd61-497b-a196-8e749c1a9e74,Commercial,0.3056220367011423,34,36,457,1237,780,64.92536681188751,8222
fb029732-8242-41fc-8b7c-bd1a53438ef6,Healthcare,0.7145733808029262,39,38,319,1197,878,87.98553612666508,6907
d7bc54f9-b970-4a5e-9e68-0cfad3b11ab1,Commercial,0.5724845115249041,18,7,3,106,103,45.24943299588799,9485
dbef6f48-2147-4c33-91fa-6748d5049b4b,Residental,0.7717416569317386,13,24,715,1384,669,51.336559523969534,4142
f38e164b-d9c1-47b1-8f2c-b5445d288f76,Residental,0.6032087867954845,28,4,713,785,72,29.86044974510335,7258
e69cec9d-8426-463a-b903-49edbbfe09a3,Residental,0.32503203242156753,22,29,162,630,468,92.99789913436013,4970
2fe5329c-3098-4a80-8e5c-603b0e62e56b,Healthcare,0.32519183116245787,28,22,173,895,722,70.85893424285192,4877
4e6d49d2-b5d5-4c7f-84d2-d7c66ebdc253,Educational,0.7928819287004119,42,30,644,1076,432,43.080936480483075,8616
b3bf41d9-2039-4be0-80b7-866474c43abb,Healthcare,0.6974116589921289,33,46,293,300,7,88.87628429048172,7070
85be0a44-2e56-443a-aa61-98e79a5feb26,Educational,0.6572311485007547,31,13,225,1102,877,98.55543166828288,9517
d92a964b-e4f1-454b-92aa-961dae3126ff,Residental,0.7600231898469914,6,41,389,1140,751,60.02118700236649,2929
c6f3c798-fc3c-431d-9d44-99d411d2023d,Residental,0.5289711096812925,10,45,106,949,843,36.893680205278166,2078
103e1c00-ed48-465b-8657-27fc34abc8af,Residental,0.6557901144619827,27,8,616,870,254,98.6742601541466,8104
1edaca4a-877b-49a1-83e8-a0ec5178c76e,Commercial,0.9791484533277103,28,14,80,117,37,65.43348128304646,1939
e2250a9d-f5ff-42b8-b5bf-320cf75fd066,Healthcare,0.8544371627167612,37,5,581,618,37,54.8729534312353,1984
3b8af46f-4727-49b0-b170-7fd535e5e52c,Educational,0.12882108541384785,19,15,199,274,75,68.59694945010312,5694
b4afb6e7-666d-485c-b710-a93c1ef56c4d,Educational,0.5850022504594531,41,29,579,1204,625,22.9914940098055,4363
6d37532f-07c9-4539-8420-3ffda51a4647,Healthcare,0.13724398631258705,29,20,169,815,646,70.7939646844283,9328
b04fc850-f9eb-45a1-acee-a088dfb7f531,Healthcare,0.2601612687484025,5,3,542,862,320,45.93364566976243,3925
bdc6d33a-43b6-4c14-a4b0-e308679b9f0e,Healthcare,0.38948436562023414,9,17,141,688,547,94.33521170123679,9381
88e649a8-0de0-40e0-a612-0a870ce7d56f,Commercial,0.4332990248845868,44,18,663,1242,579,92.90313918804402,6786
7852f23e-90ac-4774-b5a2-dac1e855268b,Residental,0.5779082500827937,47,8,446,616,170,76.56527595106856,7711
3b79217d-d194-4631-b865-069c10aa555f,Healthcare,0.8015271342559664,16,19,87,138,51,54.799728329233375,6967
8598f60f-0963-4ded-b16e-3ecdf35f4d0b,Commercial,0.9620591414777224,17,19,11,1405,1394,58.443876148690514,5031
994c7a5a-c659-458e-b4cf-7a129acb85aa,Commercial,0.2169254022303504,11,5,245,1105,860,76.84399245119351,9574
69e8b3d6-a616-4b9f-bb60-4f13927ac616,Educational,0.563261961312781,10,5,683,1120,437,82.21129137424192,9872
894cffb0-8f6f-4577-9313-46a93ce1f37d,Healthcare,0.5763142935353514,46,14,200,223,23,66.01015404517099,7406
19268672-185b-42a9-ad98-7f21beadc904,Healthcare,0.808768360275507,14,4,83,719,636,33.68865786575669,8748
fe01040d-716c-4c1f-be3a-6f4cc9918793,Residental,0.029310908735310615,34,10,652,1414,762,33.926409737649934,8049
155c1e4a-6ff1-4195-9622-1066baf89185,Educational,0.8466945666128465,19,9,40,560,520,65.55139942471314,1369
fbb2f1dd-a99a-4d27-8c3b-210bf56f770e,Healthcare,0.1274874820718067,44,33,705,1103,398,94.44163062315906,4063
ab346814-1407-419a-b084-47e106ec5ae0,Residental,0.21180057275731468,25,45,508,759,251,90.07147070860964,8446
996128c0-1231-4bda-9479-c681653d5d3e,Healthcare,0.9451302670860658,50,39,503,1324,821,38.72217661365578,8308
f4e0b212-8c81-4b50-939c-9d38f81c290d,Educational,0.4916534805687245,2,44,6,533,527,63.12431203363925,3604
6f1ca060-7b5d-4e0d-bffe-abbf2703633f,Healthcare,0.49035772175873826,37,43,60,632,572,32.301623337832766,5834
84a2d5ef-9b95-4972-ae02-799f880dffd8,Educational,0.1084831362256723,36,7,103,1398,1295,27.01365556472307,5205
608ccc98-5d5d-45a5-bdab-bcea55334a5a,Residental,0.7210643606881103,15,42,129,612,483,69.8733198357223,1590
7bf8acfb-127c-4c9d-8031-8195045324c8,Commercial,0.706128498980635,17,22,660,1363,703,54.32543094875302,3848
49a5cb9e-67ce-43fd-9faa-b2645c4f3b97,Residental,0.3978689031175877,25,18,500,673,173,82.67538790246856,2939
5ce89cb8-784a-4fd7-bf11-704e4cf7003a,Commercial,0.10157224475654436,47,20,515,1259,744,82.79678345139881,9936
4388f496-7965-4c6f-82ef-5a85214753b6,Residental,0.7176094479024012,35,10,90,885,795,85.67877318711541,3220
0f066f01-19c7-46c0-8151-4ebdefd73a3e,Healthcare,0.5912740260757604,24,4,132,335,203,54.210544490217806,5034
49867a9b-b7a2-4ca7-a44f-0361d3fe8564,Educational,0.6051899565827302,49,22,707,1318,611,24.80326881920459,9315
3978df9d-6eff-4785-aa59-3ad6dc5a6e5c,Healthcare,0.16323991782418068,23,15,460,574,114,48.47221907459824,4396
b8dfe172-ff1b-4dcf-b15a-1023b743d160,Educational,0.14720594808576826,5,42,468,1323,855,40.702917082552275,1735
1e2d5a51-43ce-4550-81c2-041dc7ab4a91,Residental,0.6331423661037072,21,7,324,667,343,49.319998665543814,3584
22125c65-b668-4ee8-b72d-b520486f4e4e,Educational,0.5164068828634883,9,42,547,615,68,25.722696070269684,6343
ae3b9abd-adb3-46da-b4b4-3115e064fd63,Healthcare,0.8576699614406912,36,49,19,430,411,25.964005045290293,2713
9d4e6a45-55f7-4078-9389-a4188f93d05e,Educational,0.0660253931160989,9,8,121,483,362,69.38428927068941,6890
c981e27d-50f6-482a-8f2d-f183dc7d1cb1,Commercial,0.027894697447328864,37,7,283,338,55,25.11424526383021,9527
892e81fd-3f61-457e-ba54-3fc8aa81c4a6,Commercial,0.765293620090864,28,10,62,255,193,43.00308634681627,1568
9666703e-7854-45a7-9a59-61d4c81a9558,Residental,0.12978786833430156,19,29,80,291,211,54.08675063363255,2610
c39dbf75-0e37-4202-aafe-87ea1b88607c,Commercial,0.09313258778463374,2,25,482,1012,530,62.11069345171845,6670
904785fb-6b8d-4dcb-a7dc-f3382b9c4441,Residental,0.7392436590535548,49,45,109,1057,948,84.23656593234746,1655
bc3ebb4b-426a-4f6f-a3fd-beae69469293,Educational,0.04642184225041035,38,8,360,388,28,47.07812857921907,8339
67362356-329a-4d38-b95a-1681b8f2d324,Educational,0.29485510302730356,30,36,21,1407,1386,17.425995924608905,5036
646ec2dd-75ab-4700-8466-8d2d62ec3d1d,Commercial,0.9990091009079785,7,47,664,1284,620,31.304391027725018,5252
3e7934fa-6081-4485-a91e-44640e65f4a5,Educational,0.7010258949992484,19,39,598,1356,758,13.828988823537749,4473
4474d012-3e86-4934-a46e-f95445e0f859,Healthcare,0.5731919169455408,42,4,352,773,421,60.03341260085621,8624
3c9842f9-246c-4358-baa2-e6a1753e9894,Educational,0.1875465906218302,32,9,293,335,42,57.014146465974484,7856
f0fca164-8b58-4df0-b1f4-d0113f451af3,Educational,0.8472289838005395,48,39,38,408,370,76.95495836705072,8084
26a3bcac-2029-4689-9920-5916fd363574,Healthcare,0.9833733001367053,22,26,83,338,255,65.97291883332035,9091
1a95d0f3-6076-4b7d-a6ef-4f4f4cbc2d4c,Commercial,0.9486192436986615,23,17,707,1258,551,59.90658250620574,9503
aa946453-21d5-4281-bfab-e455c7bc8e72,Educational,0.7610452609649536,2,32,638,833,195,85.00150851365022,4559
440d28e5-514d-4ace-803e-3013b29b9943,Educational,0.7771729178992791,27,36,295,1429,1134,44.95978363449221,8382
fffed243-29e3-4a0e-bfdb-ee6d1006cb7e,Residental,0.7025699707066113,21,26,716,780,64,94.66742309627723,8075
a512ebe3-ff91-44d4-a4cc-57bd17f59e36,Educational,0.7842873595268869,44,16,212,1418,1206,98.76837496579395,6098
5f778425-9241-4ed9-8a10-106292c722be,Commercial,0.14151723073859368,4,14,705,805,100,82.39504798489432,2323
7df97adf-7adb-4622-9cb5-ad761ffc24fa,Educational,0.8632341004572018,40,19,173,920,747,30.367923122587296,6753
a74fe965-fec5-4a6b-aeaf-08f5e7ae47a1,Commercial,0.43721230947081435,25,47,677,871,194,28.06090400599861,2577
167151e9-72b7-4be4-8fa1-e1519a9095fc,Healthcare,0.7486165445223456,27,26,560,583,23,99.67345500789648,6149
886cbf4a-2aae-4127-b44b-4b38ca07dfae,Residental,0.06140515895295928,13,29,603,894,291,25.566344130383996,6011
8aac9348-4ce4-4449-b2ab-77378305f9fa,Healthcare,0.7219329016416424,17,16,24,536,512,26.806160492864006,1411
446689c8-f101-4bcd-b001-4a779fe8b91f,Residental,0.7706786087136551,26,28,697,783,86,79.75769127845376,9226
194a30d8-eab8-42ac-936e-f9c6c2cca4af,Healthcare,0.10690495752444074,29,34,492,643,151,11.448012110739565,2273
2e88b15d-9785-4e05-9031-1a2e8e39ae3c,Healthcare,0.7996815205241534,48,15,670,1181,511,14.547872596920982,3295
aff791a3-f1a0-46f5-b313-8293030c9bb8,Commercial,0.8948389532784498,4,47,484,650,166,94.10917834068543,3468
2ac2fa72-0564-4d73-a92d-664fd9b8313f,Commercial,0.28298999136489966,11,2,638,670,32,48.930436212006846,9185
eb8f39d3-a186-4560-867d-9961effdac84,Commercial,0.6349088061419704,20,41,551,1338,787,79.58899032197175,7989
8243287c-5b2e-4c86-a9d2-694e70db7959,Commercial,0.35199885904845973,41,32,212,401,189,64.89732175313821,7881
8c0f31e4-a8ce-4542-9e4d-f62dd1e45cc1,Educational,0.15429532333216667,14,35,693,764,71,87.61573905345314,1144
29f5097e-97e7-4b99-ae4c-6d42dd1fa6ce,Healthcare,0.8447812638272285,43,39,64,64,0,86.66340560472825,1353
5e6b474a-c6be-40f8-859e-cf877a6dcb32,Residental,0.7676508374095847,2,18,618,772,154,90.6575975813461,3935
1805ed5c-2565-4d53-80bd-9f1ea50f0dd4,Healthcare,0.1595404931629164,1,49,130,431,301,24.17851826303945,8412
7dfe29f3-6883-4d7e-83d6-d91ae21d6a9c,Residental,0.6357108957116684,43,31,407,480,73,87.74305523888852,2048
fd8e4476-6a4e-44ed-b365-871b9b72127a,Healthcare,0.09698225741430289,44,7,619,971,352,24.702021630258045,8590
83b1e7c0-975e-4f11-ba03-e8225e0e5487,Healthcare,0.4584585754724799,20,14,694,1164,470,14.355384632173045,4864
b4ebcbc0-f18d-408c-9039-9dc547861faa,Residental,0.91749341865493,34,6,150,932,782,47.863487716978966,6506
477608d7-b3c6-4e33-bca7-d3c6397b7068,Commercial,0.8688332987851544,33,29,579,754,175,11.68124579250448,2681
62bc7ea1-4caa-4b00-960d-730c6fcc1194,Commercial,0.2151757271692234,38,14,566,1002,436,14.793176025703998,5191
acf26893-6020-405f-aa5e-8465957242bf,Commercial,0.3402476767684972,21,37,670,710,40,63.721898190460216,7593
e8a934b2-50dd-4caa-b21d-293c4fc0209a,Commercial,0.6089053674277373,13,2,192,1313,1121,86.56586054571602,4393
f1efe8a7-0b35-41e1-8a8a-ca2ed9e445b5,Educational,0.5509103402850726,43,36,23,713,690,27.400215779994806,1302
58d47991-d230-460d-995e-084058c319ee,Residental,0.11351486013147849,31,12,547,1335,788,85.84534904500367,4585
674bf8ef-6be7-478a-8115-ca1048c8c82f,Educational,0.7340275656047562,4,3,98,1318,1220,77.79935988224075,9184
735940a2-8b18-449e-8c0d-9a00a04caf15,Educational,0.23957151299175183,23,6,8,127,119,59.64895209093909,2023
8fbbb794-5668-4faa-ac17-ed11a9da13d6,Healthcare,0.0881199811895127,25,45,448,547,99,94.82761065634277,7214
92dbf8bc-188e-4ff5-b69d-d0bdd9389d4b,Commercial,0.6261098415319724,11,38,272,1311,1039,93.79252280980705,1964
3ba2c736-8c9a-41b8-8381-ca4133c9776f,Commercial,0.09418195943627938,43,33,460,622,162,68.30412836186892,5760
38c734e9-4340-4e6d-a4be-500e017d3196,Commercial,0.03644079096876862,45,35,58,954,896,15.853470468012514,6149
bb9dc80e-c97c-4b69-82bf-56f2ceb19eea,Educational,0.6506195759077548,47,4,484,1173,689,32.00895332537077,8870
46b3f6d7-ae37-467e-a11c-b7610afe342d,Commercial,0.9817208526902013,31,39,716,1168,452,69.4835375122363,1765
4a9196bc-5df2-452f-aec6-d25647a56c86,Healthcare,0.9783055599884697,40,42,66,1271,1205,82.81186227091098,5646
a86b6d0f-24ec-4afa-b796-29562888ad4e,Healthcare,0.8206235098684801,18,48,682,1374,692,43.229738628794784,5651
a373d4db-fe13-4e1c-af98-97937f0b4dbf,Healthcare,0.573032809142569,35,7,80,640,560,67.19571850662564,4853
5dc53e5e-89a4-4e3b-bb8b-abcc4ddae6e1,Residental,0.9719508457699995,43,11,284,1024,740,93.33857138702659,7753
5e28f21a-dcd7-4b72-a1fc-b71c1ca8e2ef,Educational,0.06571975513155759,18,40,221,794,573,14.63514991052884,8222
fddcf61c-4bcc-43e0-b4df-561adb5b8db4,Educational,0.17975754718142278,40,30,582,1245,663,57.87046785911349,3141
022d912d-9171-41fe-9d8d-7be812dc5979,Commercial,0.792053018007058,33,17,614,799,185,67.09901344713307,3906
3853aa9f-103d-42e9-8ad5-8d7fb8441553,Commercial,0.045197357879769084,9,45,104,750,646,92.42177404289161,7544
1582c11c-f2d1-4a05-ade0-3a70c55264c9,Healthcare,0.07815336101483827,20,6,107,351,244,25.34842911245254,7373
db020452-7ff2-4561-8985-ef0ca30e704b,Residental,0.11109522856970688,17,6,617,1065,448,27.665895872327923,2094
3605980c-18c0-476d-ba3c-dac143de622a,Residental,0.15915370409244312,26,30,335,1108,773,48.19668432070918,2973
67d6cff6-c5e7-443a-a36c-7f2545f453a6,Commercial,0.261346802556394,1,28,13,1192,1179,55.707302295513166,9302
a0a46e92-7344-44c3-9c88-c51a00c37cca,Healthcare,0.066193613220483,12,36,432,1178,746,78.47219467396584,8084
50052647-722a-4b0b-8314-219f773d5cb6,Educational,0.799456263804474,20,24,27,63,36,19.408532180195053,3673
4cb3ca72-dae6-4b01-ba99-320f032b18e5,Healthcare,0.5976137826849991,14,4,96,403,307,67.18296476725939,6282
031c91e4-fc6a-4297-aedd-7c3c19664fb9,Residental,0.33359346357869346,37,44,376,852,476,58.56220570899443,5438
81e70219-000a-4933-852e-129790325fa9,Educational,0.32723448881954476,43,10,350,943,593,63.77228168632251,9880
a8083408-38c9-4b3e-81ea-9611689321a8,Educational,0.40926170644348636,2,50,165,1315,1150,48.923284841805255,5895
f26a7396-8f0e-4490-9455-b651f45081d2,Healthcare,0.3928380337568935,1,18,616,1154,538,77.78331000743079,1255
28c7b5b7-1227-413c-89f3-478b8f4c5269,Healthcare,0.5883707231422285,27,45,708,1398,690,54.5720492266964,5959
f1b8e918-c0e9-4181-8c63-fd5491aceef9,Educational,0.8679470960141646,27,47,693,813,120,79.80412068133168,2784
5f75daa5-20d5-40f6-8c74-2550a1c97919,Commercial,0.8892011437160964,39,19,339,431,92,93.74675188180392,7783
56452bc3-ccdc-44ba-be3c-1ac621e417ef,Commercial,0.013389071254285012,1,27,503,1438,935,55.617807182215834,3743
d78b3471-5666-4013-a70d-06aa07ceff71,Residental,0.3014737275978777,36,31,320,602,282,20.040424259839895,4379
28c7a94d-ad78-4d5e-a882-776424d74d3c,Commercial,0.05375304099269629,7,32,670,1092,422,90.04367907550247,1320
9fd163f1-712c-4c5e-8f56-1f113ea2377b,Healthcare,0.8074930139525572,13,15,11,965,954,29.347448049602047,9664
325893a7-dbb0-4991-a3c5-564173753169,Commercial,0.21302487857125918,31,18,539,1174,635,56.694155219956855,8221
b55873f2-cf7e-4f2d-930b-fe9d6368c4c1,Residental,0.6006246904611143,20,5,209,1339,1130,85.27840615845214,2862
82d21edc-45e7-4f97-abe8-8a55043c9af2,Educational,0.3608650925656359,50,26,559,1057,498,92.88460036515565,4464
9b0b2e65-ebda-498d-b7f7-a748e2f03d7a,Healthcare,0.6381563667307911,36,50,526,1302,776,17.733586516401367,9996
65ff1eb6-4085-4425-af76-2eb3a1b3ddec,Commercial,0.4987411239223887,3,47,209,856,647,15.598926566266904,6625
a4fb6674-fe00-413c-b2a5-b24ac1f4b85e,Commercial,0.25331098025726073,23,6,132,799,667,20.727017111938196,6962
21f3699b-af33-42c2-80ec-508c82c0f728,Commercial,0.4120805833097122,15,25,98,185,87,86.78997519539197,2525
00da851f-1003-4574-a3bc-4e1500174799,Commercial,0.27353271605016927,24,35,393,478,85,67.28139016279374,7643
17effe0a-74d6-4ea1-9858-d0a90d2d3421,Commercial,0.7086808272590359,31,46,117,924,807,86.30491552756808,2974
43d1d59a-b2c0-4929-979f-e4a9e7f732a1,Educational,0.995853222152502,45,24,431,605,174,57.45339064417548,9140
31043115-a5aa-43ed-b271-68194035b99c,Commercial,0.054328496315412034,35,46,419,1371,952,71.62575004382762,3044
8453a1f8-1f2a-40aa-9474-019afe1d3acf,Educational,0.27820662115448047,1,33,375,477,102,21.36579359787377,5249
555fd8ad-23ea-4c7a-8e3f-087368bcba41,Healthcare,0.658123599201632,26,15,640,641,1,91.27364866751105,5118
dc6e8d6b-b912-4ae1-bfc1-fb03137aeb8d,Residental,0.7801998015178246,21,14,21,62,41,79.98967437102912,5189
d996f2fc-1dd2-40af-83ab-b8273c0cfd77,Educational,0.7929110007732563,37,21,22,1237,1215,10.677676345954271,1614
49578bc0-9295-4d51-ae39-37ba5709620a,Residental,0.9067782284068024,35,35,404,456,52,54.1751229934221,3564
06f17235-e560-4412-90fa-eefb13632a25,Commercial,0.6636684569829779,46,44,48,703,655,33.05470126868826,1198
c194b640-3a98-4bd1-abb7-dbc9cfba9ff1,Residental,0.022217737459649278,50,17,97,396,299,71.675091669976,9750
82e33590-1939-4e26-b84c-dfd01b1fa3be,Educational,0.1859687555986853,22,35,246,511,265,45.511502793577726,6667
ce7fdfbc-d520-4e68-a92c-776f96a86778,Educational,0.9860998343057076,23,11,632,1127,495,47.0504078143455,2890
4724ff70-a830-43ed-9bd6-9739d4528526,Healthcare,0.9288051202227537,28,15,510,978,468,21.011523282396947,8252
48284c6f-6280-47db-8a35-5a03cf5d75e0,Healthcare,0.5954905510080583,13,27,362,1006,644,76.30751463987065,7965
958a2899-b2c4-42d9-bbd2-ad4614363d8a,Educational,0.40733323707844316,35,1,524,1124,600,55.955940570392556,6629
da72667b-35eb-4f62-9c98-3d3d691f3702,Healthcare,0.38469661794535015,49,8,164,772,608,56.36998310413499,9386
59fdc4e7-42a7-4964-a004-78b979b67dd7,Healthcare,0.07910477242076253,17,38,234,890,656,36.38736087780209,4512
a15ce517-be45-42f9-ac7c-e210e8a649eb,Residental,0.04092205839522589,1,38,318,906,588,97.02657601491808,1200
07f78c0d-d8df-4d0b-8515-900d90cc5c2c,Residental,0.9313418593950652,19,38,318,747,429,41.60224334369207,1227
383e69cb-3625-419a-bf88-c163c5616b97,Healthcare,0.7916565664750098,25,5,664,1056,392,73.38840225301912,6661
9c6751a5-217c-4273-8159-6c36e53caed7,Healthcare,0.5182903912015902,16,2,196,922,726,21.005078170555322,9308
53f1a285-1d97-435d-bf6e-0dc6491bedb8,Commercial,0.6387359532116177,33,31,64,476,412,88.68847694546147,1348
f1f51edf-94e9-4f19-8f9e-19ce7fd4cb47,Educational,0.4728449111002402,38,11,337,1387,1050,71.16178265845556,4129
774be38c-74f5-4e1c-8536-ebffd99e29b7,Commercial,0.1485298133990064,38,50,200,544,344,46.350404988566616,3376
d63d7223-ef9b-4e35-9ca5-03b1f77c4c0b,Educational,0.27046749133996817,2,43,174,1310,1136,97.52268344262181,6794
8323a0cf-6e06-469b-8859-e672ebe05d80,Educational,0.018484799223734916,30,36,202,849,647,35.82934636228421,8380
41672d8a-61d0-4a05-8402-81c740ddef81,Healthcare,0.7061358845712596,32,40,318,1145,827,98.09598247502521,6742
ab987f0d-27f4-48ff-bff2-11dc8bf1f01c,Healthcare,0.6003680747466486,42,43,573,949,376,98.56349136566753,2061
8ee9763c-0a06-45f1-8c80-460ba972b24e,Commercial,0.8422523863205548,2,50,483,955,472,28.315317489282766,8272
76b7177e-953f-4f61-a9c9-5bc2d9d3a8ea,Commercial,0.20062777403615972,22,35,139,374,235,62.455481753656464,3431
c6743fb0-6d56-4bf2-b97b-0eba424f1c10,Educational,0.5285218860317275,49,14,467,1143,676,83.54863625140347,1725
09beda89-50c2-4400-9914-91f41043ed38,Commercial,0.8933183929565154,19,22,670,1233,563,62.763177538630835,9094
a4eaa5b1-fabc-43f1-91c1-8fbb7939ccb8,Healthcare,0.9667503424039531,24,28,706,1119,413,16.04951582336734,1582
82e18f30-9785-41ac-9368-f4d02d6e83c6,Residental,0.1353129204161606,42,10,634,1081,447,12.788811032244723,8280
ea2b85fa-b8d3-45d8-ba64-bce3901f628a,Residental,0.22575091796309443,5,40,623,1086,463,53.55618947392977,3622
88ab4bc2-cc94-4cea-8468-a487115f9f7d,Residental,0.49474248219442307,39,30,250,1223,973,62.98120866830724,6783
3ad6c2ba-ae7f-4bfd-88e9-4abacf2d93fc,Residental,0.20720965194019458,42,34,147,930,783,91.78135940205237,7425
4d17f40b-368f-40a8-89e9-fcb535b487ef,Commercial,0.15469395022072852,38,5,326,431,105,52.49483695998457,9617
bd41d204-b012-48d2-a742-ad82bafacfb5,Educational,0.7240863871612235,3,18,593,1422,829,37.365342085645686,1855
e599fce8-d10e-4609-8984-f8679e0d5233,Healthcare,0.3467554426795123,27,49,634,904,270,44.14468885344592,3892
87719f52-872c-4b0a-9b65-7f86eeddda37,Educational,0.17664521928674237,38,25,712,1217,505,57.3323754399682,1395
3c28372b-e5a2-4c72-b202-7f358cfb9ca5,Residental,0.31726433705155954,20,45,375,894,519,52.461472733017175,6456
0b1b4ace-550f-41b4-bd8b-d34fdc7af3ae,Commercial,0.2267022673170177,43,37,9,1346,1337,85.82053573407141,7477
4f0dc08b-4812-497c-b845-3ef06f20b1bb,Commercial,0.9966109565803977,44,37,1,466,465,36.32666978360861,9555
e313a22e-cced-443c-914d-d8e43750e5bd,Residental,0.3353839244897546,47,30,160,694,534,40.19727822889423,6815
10ce4e5e-1696-4da5-bca7-d5edee408a19,Healthcare,0.5576704954178674,7,11,519,1209,690,99.92361065040065,6891
6a5fcc69-f2c7-4714-91d0-0e6fa63dac18,Healthcare,0.8541683238417055,5,18,212,531,319,26.871657490180215,3036
bead13a3-8099-4b00-b646-09788120eccb,Residental,0.5032139482611966,42,5,680,896,216,74.73975632910397,5105
c18ad9dd-ad4f-46fd-81f0-6a660409fbfa,Educational,0.2760187729725312,47,26,326,1270,944,47.572891412878214,8231
7f0cd26f-11e8-4e84-a5e1-2036c16a8ece,Commercial,0.41142163814282084,36,7,69,1297,1228,39.04391671996032,2748
71ea5ec0-9d80-4bf3-9065-f42693057c55,Educational,0.1530505935302484,15,24,672,1141,469,73.38612048456461,6838
e28a8306-be4d-4a4c-a959-bc0c43f77ddc,Commercial,0.9471877805408928,14,32,589,1080,491,40.31988769763645,3469
ff216aa8-b469-46b4-aec3-0af9baf27383,Residental,0.9483221577501347,20,43,292,774,482,10.415582193340349,4091
d6860238-7a51-4ab9-adf3-9ec5132d2426,Residental,0.09728694448334618,4,32,253,1384,1131,64.61736482868129,2805
34a76e4b-cbb0-412a-808a-75142a9cf038,Healthcare,0.8555940265902601,40,38,641,692,51,45.623962327003774,3971
fb26cd46-750b-49ea-afe5-05ee46e7bb3f,Educational,0.05561952895227418,9,14,649,749,100,95.5294724950169,5714
3436e1e6-ccff-45eb-ae21-fbd1b476a52b,Residental,0.889423600019358,34,38,189,708,519,61.750609016264505,6468
3d228e8f-b82a-49b0-92f3-01fad39bb8c7,Residental,0.8730506088331028,47,23,521,1258,737,37.335982827292895,8517
55548ac4-f5f4-4452-a19d-3372e938c0f5,Commercial,0.13452218584064013,28,34,465,863,398,12.23857187271026,1654
cc712a8f-a288-4993-8c3e-637f18b69d5a,Healthcare,0.8059815442058771,37,31,235,787,552,81.68216527995175,2388
360a7739-67c9-49a3-80b3-7c4f46442d80,Educational,0.0018334429874932168,24,20,195,1438,1243,61.66301010161222,8721
34f59c16-7666-4db6-9c26-ae98f17a18f6,Residental,0.15048889218792016,11,6,466,611,145,22.173123249415376,6516
7f879200-48e1-4a35-8ab8-8877c7a79768,Educational,0.586291642600544,39,45,474,1361,887,35.66690832463013,9473
a758e849-50bd-41b9-8391-4db741789715,Healthcare,0.15272694154724775,48,23,528,1432,904,94.7666901414082,3679
2fa2abd2-8e19-44b4-a77b-b0e590367b99,Healthcare,0.8150838396872463,9,7,130,554,424,32.75790874409594,6476
3eb245c6-63f2-42c9-a382-32109a7947cb,Educational,0.2751557320767757,2,17,693,1403,710,60.08182217270427,8195
8a0a2354-ab2c-4172-8c66-b431e4f2965d,Commercial,0.7733425325154205,10,30,70,597,527,38.695526017831796,1487
df859713-83d0-48cc-bb74-cb729efbd1e6,Commercial,0.7834303517238693,46,37,671,1327,656,87.95754456701161,3292
330c7f84-c24a-456b-bad0-b73ac9873d9f,Healthcare,0.8269127952125717,35,33,465,901,436,51.718390277691405,6687
2f64724f-acf2-4a6d-a1ac-c4518aff2d2e,Commercial,0.8086624112983999,20,37,572,1102,530,23.208560131669085,6465
5709ac76-6c8f-4952-ba0c-6cf11faacb08,Healthcare,0.5127603186649393,23,48,346,644,298,37.114878963748865,7362
5c4d25fb-e8b6-4cdf-9ec4-d17b8a4a4c1a,Educational,0.3859322314112682,45,47,118,414,296,98.12190345868808,1444
44129013-26ba-48b1-a682-460882682896,Residental,0.7982800805041668,2,6,356,1247,891,60.336495179564366,9314
4da8fa51-40c0-4161-9c04-91d04163bc6c,Healthcare,0.9006597662036282,28,32,191,738,547,44.06917233676898,5756
bb272478-c19c-45b3-bedb-f1afdd73be51,Healthcare,0.24852229512845336,50,17,383,1270,887,30.803391959941816,7524
5af64e9f-ac0e-4805-9302-6c75e62f75d6,Residental,0.9996094452931293,42,13,403,428,25,91.19303104337932,6253
c6de8e56-3f70-4bf7-a1f5-ffb5f5c1180c,Educational,0.2736450206794103,26,42,576,1252,676,89.51230689911907,4368
37e64c29-f7e9-402e-a95c-e68b2e6df978,Residental,0.7705771300696347,36,32,45,406,361,94.36215460607156,2455
a09efcf7-7ff9-4f1d-bc22-fbc6b776e449,Healthcare,0.6154682410050643,50,49,666,819,153,34.737590868585144,8522
5a32a7a3-4ede-4cee-947e-aac677a988f7,Educational,0.2009433945155491,21,3,520,686,166,68.50389251577214,5381
ae6a8d16-1af5-4bbc-867e-d4744d297528,Commercial,0.3385099329499607,39,39,408,1296,888,23.78929465252243,3507
c88cc2dc-661f-411f-aec3-f8fb6167d835,Commercial,0.7014015467832577,32,8,197,1209,1012,27.98476574966103,2015
87b8ba46-1016-4b32-b827-deae1d52773f,Commercial,0.25217552077822725,5,5,353,1048,695,98.87153998523982,6568
187f4ddd-45cd-41ef-a1a9-ff0a3bfc359a,Healthcare,0.9992146675131082,31,30,254,1085,831,48.31493285153761,9030
8a5eb6e8-7706-4917-813e-83163765207d,Residental,0.8820114484774441,18,36,133,954,821,96.64004219234646,7177
4c3a9310-e807-4687-aae6-1da499ecaaff,Residental,0.44059257621520387,10,36,693,894,201,25.90722934799506,9459
855c4a8c-539d-404c-b971-ba100912d9d9,Residental,0.34888227671978567,9,41,465,630,165,42.37083348377776,9085
0ba6e233-af5b-433f-9582-83a4bf24e892,Healthcare,0.391222047901447,41,24,455,1439,984,96.0551610801607,3206
9f31edaa-e0f5-478b-ae98-d7c743567dce,Educational,0.9994583550711581,42,42,338,700,362,44.81534945426753,3597
fa0d5919-884f-496a-b9f0-0ff1f914f2a6,Healthcare,0.7409456735409444,21,31,386,1199,813,71.0724380094715,2332
98298d0f-e7c4-4486-9fb9-35a57e058b11,Educational,0.08079630188338438,30,23,321,650,329,96.00086294595819,1106
07f970d5-bd21-46ee-8869-617a21023b99,Educational,0.2120089880398104,45,9,24,78,54,27.728660631762708,3890
34f43662-fb3c-44b3-a636-acddaca99c89,Commercial,0.4567727227040028,15,18,619,662,43,28.514781495528577,4781
a940cd67-0110-4091-bce1-ea618107e150,Healthcare,0.7463663772341841,3,46,350,432,82,16.541253297701857,8800
a8e9eeba-cbfb-447d-9355-2de2593a8319,Residental,0.7591253255910392,26,33,72,89,17,38.49717278555997,5927
d2db802f-eeaf-4914-843c-b73e5b3bf18a,Residental,0.954326180317689,44,16,456,650,194,30.277793148721095,7951
481ade3d-2eaa-4507-b955-0566a964256f,Commercial,0.22795894045986909,45,17,509,1394,885,70.33167714872785,9130
c38598a9-c75c-4610-ac44-a438f94934b6,Healthcare,0.19154980976204394,34,48,643,1258,615,81.49931655685477,7068
1eda215b-e3d5-47c9-bfd3-153ecbd24289,Educational,0.679355971264838,11,1,450,1356,906,75.4579864035095,4643
01ded5f5-2537-4953-aee0-3c92189325b0,Healthcare,0.29100631492931495,1,49,427,1267,840,53.6315567174758,9827
f4b4deb4-7ac6-4e85-90a0-fee1b197e130,Educational,0.9253509909712512,16,48,60,269,209,97.17974141879714,9387
dbc801ce-7ce8-4323-8d16-a58463cafea0,Educational,0.9024558771460309,16,21,438,529,91,83.052166520117,6144
722bfc57-75b7-4d4e-a2c0-4f28ede8fe22,Healthcare,0.516298103010909,18,3,142,154,12,36.5760499679402,4873
2cdbfcfb-cd54-4d47-bf13-b430791c2a51,Commercial,0.02726751899003388,9,33,29,865,836,30.628092392005623,8734
b8af1d0b-6e6f-463b-9e7a-c0d9070843b8,Educational,0.85644337906794,40,10,315,514,199,11.56229126214767,8126
adaa6313-891a-44ee-b69e-2fce2f2c8d22,Healthcare,0.8833155261825603,9,15,312,617,305,28.15762087367123,1007
ad36d214-f4ff-4f78-9abc-f5cf5f911879,Healthcare,0.696594257826476,49,4,383,949,566,59.320966068242306,3396
b414cb21-bb2a-448c-baf7-f0a3a65ed1f3,Commercial,0.31729172196218836,17,27,288,1289,1001,62.258405170393566,4435
1de1ba31-09de-419e-9c23-0dfde3f6e74f,Healthcare,0.10843636810337509,1,49,202,1423,1221,31.054357049761556,9734
2d120d8e-336c-4505-bf90-ef8332e549fa,Healthcare,0.47833870821573,33,2,312,1064,752,31.51850113903556,4095
9f642b0b-c6fb-46c3-b869-26c618a74ede,Healthcare,0.42777820333396854,34,11,503,940,437,54.78377728453875,8225
a54b775a-4231-4ef1-9c83-1bfc74b566fa,Educational,0.38267604614963,30,35,391,1349,958,74.54048219864129,9452
b538f7cf-c461-4fb3-ae22-7744d3a164a9,Healthcare,0.5935019963128761,45,30,238,1064,826,62.07752181610966,6548
68b29acb-d708-413a-8198-aa31a59d42cf,Residental,0.6349820858799647,49,15,386,914,528,81.85265928421323,2376
c39ef982-d597-4fc0-9713-ac231f75f895,Residental,0.1671999352813751,24,1,191,1345,1154,80.04952362052148,9639
e4a61733-d6e7-4982-89bf-c661854ed71f,Healthcare,0.4084632056824017,12,20,419,629,210,88.39758001102321,2556
0884c5e8-b806-4987-b662-52b01bd6714e,Educational,0.4021786479040118,44,9,381,982,601,83.26914828001527,3570
9d205eb3-40e0-4c07-8c10-36fc5ace710c,Educational,0.7426508497768413,11,47,512,779,267,79.97174460211157,8309
aad67522-5ee5-4c05-bfc0-81f45f758082,Commercial,0.27729312009056006,23,44,27,371,344,51.422071533620375,7287
9a4bc087-88d5-4931-8971-68c4f4bb8c22,Educational,0.3195571250926428,25,27,345,1357,1012,73.587232747936,2766
50cf8114-14dd-4167-97f4-216b29ca5161,Commercial,0.9943446963444912,23,17,529,638,109,10.338214125040135,8366
4b38c253-b860-4f77-8f8e-412b63c23070,Commercial,0.944635831588593,28,7,304,382,78,77.90127109801456,5437
e7afb897-efbb-4a1e-bef6-241dd792ec68,Educational,0.46271122954484534,29,4,22,93,71,56.27982642862564,2911
8a5070dc-87cd-4f97-8f4f-e5b1b4b4d70c,Residental,0.046225308586935854,43,27,236,1415,1179,39.0647885626544,4080
9dfd6797-4ea4-4c9b-9191-bbbb61eb7d14,Residental,0.5330274655806438,44,41,494,503,9,25.872906270744792,6441
a36f7136-976e-43ef-83d2-ba7b3f877701,Healthcare,0.33602308327048847,48,49,210,1315,1105,65.37443024383342,2355
5458bd89-6c5b-4e6c-88ae-ef80ba4a75e2,Healthcare,0.2219750059037121,35,14,207,1394,1187,34.44497041655751,2931
eb3b2b68-d1c1-43ac-9285-ebc940a2a44c,Healthcare,0.21215004506250124,30,39,485,883,398,35.74439705071542,9474
b1ff6c12-6514-4ecd-8003-d5ed5dc1d56e,Residental,0.4920021452431519,15,31,257,572,315,33.41212495499665,1767
5e8dc7ca-cd46-4a03-bfb3-7026d45cdb4f,Commercial,0.8484256940686798,39,7,402,1314,912,72.65848540358635,8649
8653d014-9d6b-48b0-89ba-455327d817b5,Healthcare,0.5199970069419805,7,50,7,424,417,86.89752658836447,9751
92446a86-e5cf-4f00-96d1-78539fd946bf,Educational,0.05100015253346768,35,46,205,1175,970,20.425054620009426,4808
03ac0e73-47f8-4316-80ca-a64a444402d3,Healthcare,0.9716899557073855,7,35,139,523,384,62.938204701466546,1204
3b4b6f76-3af2-43e1-9dff-ddc44d151d93,Educational,0.07726756483827368,4,42,485,859,374,71.12425383530484,9411
8fc46df3-e1f4-44f6-bf4b-6f60148b9b9a,Residental,0.5342456874359424,20,32,715,798,83,17.73005455872014,2859
128826f4-cef7-4eb3-909e-44c88eb2928c,Commercial,0.7535933403977877,35,50,283,1154,871,70.94175053833237,2797
47e2d70d-85ed-4888-9288-2c7e42432af6,Educational,0.22755795310049298,31,45,608,626,18,35.792542001384106,9826
f5a1c187-96f7-4d28-8a33-52fad9d36322,Healthcare,0.32649337987829274,21,7,464,1130,666,52.05168505278973,7271
b2bea738-50cb-4686-b2f7-02beaeefa7a0,Educational,0.31328449714326423,32,48,323,532,209,76.45919417677987,5984
8cd03a73-103b-4e67-b9f8-4198b017e70e,Healthcare,0.823371158721512,10,28,629,713,84,10.049714726297427,9895
bfe44aa0-18af-4bda-84a7-53f4ad24e308,Healthcare,0.4862455745366485,27,2,714,884,170,94.87045014631768,9097
f96b65b8-5b5c-403a-81a0-8574fe10e531,Residental,0.7707330956181629,27,15,558,1398,840,74.17526484750415,8500
da9c0081-af67-415c-a60d-ac3cc92a9d2f,Healthcare,0.8357741273949609,43,19,437,545,108,62.25390334087255,8938
316985ba-4633-45b9-984a-51d62f92cb35,Healthcare,0.9595238511481196,17,43,585,1265,680,18.172332346706753,3080
d277063f-f574-4f1c-865b-3c5b6c907493,Healthcare,0.8348306857402813,43,26,53,647,594,65.36201559887941,9340
b6d7e113-7870-4fc9-9812-92cc42bacb34,Commercial,0.9733931307490368,20,11,516,1050,534,81.62069762915698,7870
82af1672-a99f-4626-b300-15a9dfbbfae6,Healthcare,0.3503243530295771,9,28,185,989,804,22.50162768733375,7186
5aa5b72a-5fc8-453f-974c-68aa34d5e52f,Educational,0.03672709900962445,50,7,610,1235,625,37.58809845604918,5013
68f3a95b-753d-4f54-95a9-cb1fa1bce1f8,Healthcare,0.9631924061089016,40,41,666,1014,348,73.67734681583893,5797
4abedfd8-8243-4cdd-9629-ab66dca7fe09,Healthcare,0.9936119082623273,38,10,418,660,242,98.2490804075507,7532
bb689bbc-2a29-4f7c-8706-ea45390f2347,Residental,0.4106620859937534,26,24,265,373,108,29.97494988598239,3756
8c75692c-107c-4df8-af58-645a33223534,Commercial,0.5769124821453947,21,19,644,728,84,34.59880138441157,9231
7c933647-8a54-408c-aabe-280796a48012,Residental,0.4396303728756291,33,27,442,929,487,82.68231835911067,2717
6bde7e56-bc8a-4098-9df9-d2d756529a39,Healthcare,0.3384263104043188,30,9,698,1304,606,23.978451398968332,8898
ae39292e-00c0-445d-bf59-8255c252ac70,Educational,0.6791080273738989,48,7,561,718,157,85.18804981014934,5583
766446b5-f5f5-41f0-899a-e1fc01a7f2ed,Healthcare,0.9726001894334977,25,45,375,635,260,36.20165665333204,1044
b6f1e18d-1149-496c-abc5-c9b737222f5c,Healthcare,0.3504568387873177,20,10,384,596,212,64.1218875065417,6105
bff8f140-e4b7-45c2-84c1-7008a7f04089,Healthcare,0.7727440475509922,39,14,321,490,169,84.60743872004116,3688
8a8b0c59-05c7-4569-894e-0ff5742c4528,Residental,0.20365252485647545,46,31,521,839,318,67.39377158400043,4760
5bef5e72-71e5-4c5c-9435-b72f018f716b,Educational,0.228105161214732,1,46,74,1434,1360,57.87714216764497,1579
b0fd6c32-bc7b-4a64-a91f-f5b133941275,Educational,0.4147332743516601,1,31,258,913,655,97.28874452961733,1148
d4342887-541b-416f-a6d7-3e09fd957dce,Healthcare,0.9314151448449526,3,5,457,912,455,11.601711598208045,4204
46baad74-c29d-4239-b9e7-012f9b1a5f9e,Educational,0.16855874791893788,36,33,35,339,304,94.06085093366327,9977
b627a042-2a5a-402e-a8bf-9fb2910eb939,Residental,0.8564053607292158,27,21,517,620,103,16.09512441660253,4855
2729e278-3c49-4ee9-9bb4-b0ee471cda15,Educational,0.9303739177902219,35,18,328,883,555,17.047145003869723,8742
409f040e-ec91-4afe-8a05-917f65aeb7aa,Healthcare,0.2542977409949857,42,21,434,1338,904,72.49768633097571,6866
adb13d39-fc27-49e2-bb61-4bceee0d12f3,Educational,0.9198876569750312,7,30,712,992,280,54.98111426079056,7374
602cd802-951d-4912-81a5-0a57572f8a12,Educational,0.718853503806973,38,33,490,1312,822,97.93585053993952,4022
f2cd4674-0f31-4cac-b0c1-0543461f024d,Healthcare,0.47560515873989706,24,13,405,406,1,90.74552603693243,4022
cf914161-e4b3-454f-87de-106448788c2d,Commercial,0.40735376688242086,22,8,119,179,60,27.15104467144731,1965
9e101595-fa59-4757-9bde-541de352fe2a,Healthcare,0.4323563663692338,40,8,484,1411,927,14.942999198768478,3864
b80ceee9-a3d7-4c3f-9100-cddf70ff2118,Educational,0.14408659438671945,19,43,667,1103,436,98.59623980634389,5150
f808eabf-206a-4293-b9f3-60692e33622d,Healthcare,0.10955611501293916,50,8,214,597,383,97.57391652949102,5151
282c162a-70c4-4705-8dfe-e7be9e619fb3,Healthcare,0.3481859170195464,48,15,295,920,625,58.10819252821603,2286
bd672f4d-68f9-4c5a-aac4-82a6f3f612b9,Healthcare,0.08507461856231913,18,11,685,704,19,23.62697513386795,2022
a109215b-f248-41d9-9702-7e19808f0548,Healthcare,0.45572560147818386,32,7,213,466,253,93.64297836150172,9574
5fcb0ee8-dad8-4af5-9b08-8b4d295427d9,Healthcare,0.5588245669415839,19,20,272,331,59,93.40878509625016,9150
90ed35c4-34a0-42c2-ad01-4a62898e8fb6,Educational,0.9614195758680641,2,2,108,1234,1126,70.78634739819722,8716
7f452175-9b5e-4ded-98d6-511da9f720ab,Educational,0.4637507853268863,32,40,356,1042,686,53.90671119477645,3960
490fbef1-d70f-444a-8879-81ce4019bba2,Educational,0.26210326017821306,50,27,374,818,444,90.40369064729664,5190
678d9051-4472-44d6-aafb-092f79b00377,Educational,0.44910160912441544,46,39,366,464,98,43.30324151590985,4254
e7d3bd18-bce5-45f3-8c16-936ff3a70c44,Educational,0.3881301009613247,49,35,18,443,425,96.67742909421054,3118
9f7ea425-078c-4d61-8c5c-d1ba10c1d4d6,Commercial,0.7193437966988394,49,23,688,1049,361,98.9067935304514,3491
838b24f2-639b-4550-8f73-8960aa8c5818,Residental,0.5265198028471084,29,28,548,570,22,34.674547016907624,5124
9f735b26-7b55-4cf3-a512-c56af7410349,Educational,0.12257718860061528,8,27,287,1341,1054,87.34472943277164,3956
8202b3fa-45c7-4638-98a3-380e9b78a8b9,Commercial,0.6214183283180814,30,9,327,581,254,20.536148085894975,3096
1fbc7ecf-04b4-45b4-b8d3-a3c16131455e,Residental,0.9848107379325214,42,3,168,1125,957,19.206562318503387,2755
e0dab6cc-0379-4cd3-8d63-ca7f3a9cbc02,Educational,0.83160031718435,17,14,682,757,75,10.71313457567388,5075
01398715-6e6e-4cb4-a793-fd2fe2d0f42b,Educational,0.06719958384316316,42,8,595,873,278,79.46566085514434,3075
918ab34d-0ea6-4461-9cba-f89cce07fcc4,Residental,0.3641033922897422,1,3,546,1355,809,76.62637511460905,6084
ed6b88ac-6b92-4d9a-ba6f-fc9a2e5e5080,Healthcare,0.0857852992674698,16,12,317,463,146,83.68046987447258,1025
dc05d51f-369b-456f-b10e-f730eddd9653,Healthcare,0.6974822648714947,19,38,509,565,56,45.33815290503443,3067
eab07d5c-1834-44e2-8e03-773807801f41,Educational,0.01187087722474589,26,28,640,878,238,14.63776423829544,6503
f4876e2e-995a-4d39-bb32-aa5e2ee1ebf1,Residental,0.1918259484489936,9,30,141,463,322,32.32795150243081,7449
1f871294-abf3-4079-99e3-415aa36fd2d6,Residental,0.12012518774311931,37,33,112,317,205,39.45631165260856,4891
2e890906-65cb-4e49-99f5-4bbb86be1de0,Healthcare,0.4045123628080367,17,2,221,1177,956,69.4164419688252,8986
2f51e4d4-367f-4769-818e-31560ce6bf2a,Healthcare,0.9561198997416419,38,14,605,1013,408,94.78975406349062,5706
02330ed9-4204-4fda-852a-3c957c9d23ac,Residental,0.9567374726890145,39,39,342,362,20,52.09396279611763,3356
cbbbce93-a843-4f1d-a1e4-8bfe072fda6e,Residental,0.9744450582965123,17,46,336,1402,1066,57.17069598903253,3661
4a3a497f-c48f-4508-8e51-a8915032de9a,Residental,0.03898768433580069,22,23,590,674,84,32.25775815163622,9450
a994cffc-b573-414e-a5cd-7a41c6190427,Commercial,0.8909817108994467,11,20,569,1143,574,15.0297021150037,2823
d3acabc5-8924-4819-b842-94cae54e490c,Healthcare,0.7877777625670942,15,5,489,821,332,79.38706765039848,1283
00a4cd5b-f8c4-4814-b27e-1fcf9f7d42c4,Residental,0.4975460523159718,38,28,507,1403,896,65.0354275388002,5212
b805edf4-3cf6-43fb-9af2-ae4f77381ac5,Residental,0.9316965325631332,25,23,563,564,1,41.91193702131528,1855
a68e65aa-b41a-40b2-9319-88cc8707a35a,Healthcare,0.4105284962871094,43,8,631,1411,780,94.77226727305462,8217
3f4927df-37dc-41e9-8e9b-bfafa0849b88,Healthcare,0.516456196606859,10,34,67,1027,960,74.88746207449091,5973
830a9fbb-f68e-487d-aedd-46ef7d384777,Residental,0.7303695424727898,42,18,444,518,74,60.60778864600368,8937
f93ca525-8010-43f5-a370-afefe7e0cc32,Residental,0.6655161411993213,20,34,581,1229,648,33.34559263645479,3397
4b6546e3-ed7d-457a-b2db-4c0507d0baa9,Educational,0.7436802585324148,15,10,667,1185,518,83.1148059088676,3775
23ce30fe-e64a-449a-8543-d728268c862f,Healthcare,0.00950463197917939,45,30,660,1233,573,41.536848524521616,4804
010d1b25-4c8e-4145-b910-a97fb79a0c25,Residental,0.4381996862301788,40,36,546,1277,731,96.09271175992623,2037
6e594b62-c92e-46c8-892f-ac29db37a22b,Commercial,0.6239091635474495,44,45,288,974,686,75.03282137418954,2462
55f77887-b599-4497-971d-ced8a27a0ff9,Commercial,0.31223012754987356,7,1,199,969,770,26.70268686789255,2895
f72f5de4-8a8c-4812-b6fa-3d63f814c7a2,Educational,0.5619924930767177,34,42,559,785,226,56.96179884054293,1340
7776c534-49c2-4ab9-9439-8918acda704c,Healthcare,0.1702535852743291,20,46,368,981,613,45.90965217386222,7725
b12a1865-18a4-4e3e-94d5-0b4aafa0a243,Commercial,0.6644111315431346,6,22,242,636,394,46.532711725494,2567
ad43e6c0-9799-420f-9cf6-b7cdf403281f,Healthcare,0.7741005981783807,27,11,563,960,397,97.58360651081983,4389
45f10700-ea28-4f6d-b03b-03d3bca70d5c,Commercial,0.5358631504093471,23,19,263,1173,910,24.566892195008705,6359
18fa43d3-8027-44dc-8ce9-8146e4a6c37c,Healthcare,0.5155045732971774,6,8,626,1436,810,90.32712775355388,4610
9ddabeb2-61ce-47ae-b083-acd1ab0b8819,Educational,0.7194062707709913,39,39,698,935,237,32.15663022661168,5626
d877a8fb-2c7e-4c1d-8812-f67b36c3b39d,Residental,0.21624883739156242,14,16,446,1235,789,75.12232395619779,9277
66e92583-c257-487a-961f-bd740ef9b8b2,Residental,0.6416942124634629,33,42,703,1389,686,44.74689513326551,3141
59ffcb2e-2e92-48c5-bfe1-596d8871f9c2,Residental,0.7979264979247535,7,41,296,817,521,71.46463594892748,4438
4f3e9cba-12dd-4c67-95c4-93285a4a9331,Residental,0.33767467396578477,47,39,544,1128,584,23.990000113285717,9816
866190d0-13f3-42f9-a1e1-7ea7b5db1dae,Residental,0.4424745908558456,35,28,329,1006,677,20.690574656475874,5978
97958b16-fe44-4cbc-bbc4-c2135bfd0ac2,Residental,0.08251476760067811,9,5,222,1360,1138,93.41569060141715,2054
b2548e87-c813-4859-9ff9-a77d06a0aeb9,Residental,0.47629151239434,42,42,110,791,681,94.38765583131956,5138
6b7ee481-94b8-4cc8-be83-ecc7f7e32657,Commercial,0.03986173675049831,20,29,433,778,345,24.04329616031817,8329
734d2f5c-c6d6-4599-bfc2-476d22f3dcd2,Educational,0.37188994800683384,36,41,457,1192,735,99.86837508198487,2799
f1b8d071-2e13-4e1a-b105-149778106120,Residental,0.7354154964156235,6,30,694,717,23,98.4008096568047,6901
a9f686c5-0b92-48cb-839f-a37266c73db7,Commercial,0.044972241903191934,11,36,67,157,90,34.00785953354155,1794
5d57b2bb-e9b9-42c3-bc63-04d00db94d1f,Commercial,0.8385851921702923,11,10,281,1279,998,42.77016015268222,2281
99642629-7f3d-43ea-a0fe-8d9a39de6998,Residental,0.23041357900601522,13,13,192,1248,1056,20.98893896159429,9875
7aa69aa9-b7f0-44d9-855e-c30a62d211e6,Commercial,0.32478077749460166,18,50,208,1408,1200,86.9771658246465,8179
be2e6c35-c8e8-4ec9-90c2-c3a81cad3a20,Educational,0.7000518638206709,23,5,326,582,256,14.628065324827052,8258
2643d429-8f1f-4fdb-8e47-8ca3427993e0,Educational,0.6427134085727554,10,3,188,267,79,34.35032691587289,6041
56f07e5f-e4d9-48fc-9cc1-48ef49e2e9bb,Healthcare,0.9574464911474937,21,47,109,1364,1255,56.544570014126926,5005
9a9134f1-84c7-4448-964e-ec253d51265d,Commercial,0.33941701618077913,2,22,123,169,46,48.15366044503704,4231
e3f3ba5e-cfde-40ce-b291-dad0008b9780,Commercial,0.9130421736628542,6,3,340,1390,1050,12.065239762445966,7299
e303bbb8-8ef4-407b-a9a8-e1eec000966d,Residental,0.4427787762399731,47,10,287,910,623,77.33769732614867,7972
f8afe450-c809-4115-ab1e-4d37c6b1aaf0,Commercial,0.17570437559668806,6,50,438,1210,772,45.985616481266696,9043
b9b19424-77e1-416a-88ef-edbf488b707a,Healthcare,0.45719451964747315,40,20,111,622,511,60.70719180251311,5729
f853f325-148b-4b72-9488-6aa4495206b8,Healthcare,0.9155149176722613,5,22,150,576,426,69.60839833619693,3231
57020bdd-09c7-4cb8-b30c-62f23ca01ed9,Healthcare,0.8667454875143502,34,1,427,443,16,48.5989770608454,6269
137b5ce2-7d51-4f58-99e1-e5496d9a4f9a,Commercial,0.7483299485175384,24,24,365,1373,1008,53.51566124948802,2925
6277958a-080f-4107-81e7-9a1d3869ea27,Residental,0.015070187966645276,28,23,401,886,485,80.29681757023185,7060
e2a01198-766a-41c2-804e-a95e9b1d09a6,Residental,0.6307137308108508,12,43,21,120,99,36.01264465228054,5320
79df5a48-f749-4d57-9505-f0b735ce7eb8,Commercial,0.8099318701322183,48,44,292,956,664,65.59338653981892,3959
f1325095-dcbd-4d92-9d02-1b4d825ae80f,Educational,0.7420169020744186,13,48,398,693,295,95.94035008326813,6402
9ac04c72-5e21-4afc-8272-6569b30bf643,Residental,0.5221973652642514,48,2,704,1381,677,80.16727200982481,3850
0060343d-5a1e-4201-a94e-86e74e7bfc43,Healthcare,0.8529555240163619,47,22,686,1158,472,66.07522576419481,6760
e097fc9b-1209-4cb9-aa7b-4c3cb27a78a3,Commercial,0.6069301079149299,48,11,451,736,285,14.454530566993771,8984
6f352a9e-20c5-4a86-ba0d-56d2ed5180eb,Commercial,0.18309041847571061,10,4,81,343,262,69.1389636002229,4041
fb17e200-46e3-46b8-b961-b9a8fafac0b4,Commercial,0.2194838154133555,19,30,251,563,312,55.05972231887557,5673
30d60a3f-d177-4e4b-9e8f-3c0619d1a0df,Commercial,0.4410629534929972,37,12,428,628,200,14.557178298996675,8889
02ed209c-9303-4035-bf1e-f514f0285e96,Commercial,0.061679541534989,20,41,329,1399,1070,75.6676078444057,6866
bdf5a463-2acb-4723-b3ba-a112aa780a47,Healthcare,0.3140242958853888,10,8,703,1118,415,24.551522759244847,1531
a870b4c6-5161-424a-8e16-7ccfa528862f,Commercial,0.23258947886064962,47,31,459,794,335,83.85684451169223,6752
b99858c1-52fe-4b0a-a714-d8b2c695dbe1,Educational,0.29197890159151896,18,16,141,429,288,89.37812091394883,6338
4b437f29-aea0-4a3c-ae25-4b42e73b02da,Residental,0.9765458240370968,17,22,541,1085,544,33.402387595619295,5330
590e2c08-4d1b-4eac-9e3e-7a3f901e3c89,Residental,0.08650883620183403,13,19,275,1205,930,67.994151067014,9148
92867c14-5a4e-4f87-921f-122f37cd29ae,Residental,0.8438361036873604,12,34,650,946,296,12.293148776260185,4052
ad415927-f61a-4f2f-81ef-915d58687185,Educational,0.2852081857314094,7,12,447,758,311,34.6567490017505,3926
f0385c9e-a83a-4dfc-806f-74f0effd4927,Educational,0.5765446370897005,13,37,634,837,203,55.543957530856225,5769
4d9e2369-bc24-4ef1-9834-7c1aafe39dd6,Healthcare,0.32953382604429804,23,36,121,126,5,60.1456842718651,1552
3a937b19-59e3-4eef-bf58-bf533f9f42dd,Educational,0.8712384069695037,6,26,679,711,32,60.25938475942906,5778
4599fb88-2bd2-4833-9f39-82ccad274bef,Commercial,0.45960088653475706,18,11,173,1186,1013,25.022766147775393,9252
6d77b0fe-d132-4347-b0ee-e0e1131a5ef8,Healthcare,0.17970979674183218,22,1,534,908,374,77.70505110933934,8495
0d77b811-978c-4deb-b8c8-e58a96cc429e,Commercial,0.44473555661911623,49,41,226,251,25,59.840012704261405,1080
7ffef68f-723f-419c-a156-031d40a9f68a,Healthcare,0.9819240747874538,28,37,228,862,634,16.488481250902936,7643
4c65b62d-f3bc-43d6-a660-48ff01c73922,Residental,0.3028415140270677,31,11,432,981,549,66.10722608962212,9890
e358e9a4-05ab-4e27-92ba-75cd55bea150,Residental,0.0525622001175563,27,28,227,950,723,76.3816147850879,4004
e2fc372e-c3bb-4fc2-9d20-2b75756124c4,Educational,0.161445399917569,20,43,460,757,297,75.86877149440524,9837
69f8c3a9-e7a7-4dff-83f9-2ad91c4e9a64,Healthcare,0.24809781513925822,36,42,379,868,489,13.792851423325246,7294
2ede3cdc-90b3-497e-9e38-cc594b652323,Educational,0.13201501549913897,23,20,274,345,71,96.79771075045517,1025
62db245c-6b1e-488c-8cb5-b0a5e1e30293,Residental,0.6186988903601047,34,26,664,1248,584,35.17481069705363,4117
4b482818-26cd-4f66-a276-11458b125e83,Healthcare,0.9388860734538581,38,14,68,1301,1233,75.4102638027583,2115
46f5c6c6-7fee-4526-998d-60c65e4ae5f9,Residental,0.08296727122508407,41,25,507,715,208,53.68082631921582,6697
6fa05cbc-3eb5-4e85-ae16-182e10bf1462,Residental,0.91326846456455,33,49,700,910,210,70.85473487992883,6101
41367a4e-51a3-48e4-831f-c118e133a6fa,Educational,0.6549408459660433,20,32,69,1009,940,57.58916233069981,4403
fc2ade8e-48f1-4294-908c-36f146dacca9,Healthcare,0.5603235433244587,27,30,52,876,824,42.54182048519396,3040
e760f63d-d51f-4769-a173-4f8f80ae8064,Residental,0.9839385506598874,2,46,714,1265,551,58.496920984207335,2433
52819971-9f38-4269-a685-bb97afea9059,Educational,0.9827302595456483,21,5,118,487,369,28.97164248403889,1560
520871f1-2993-4398-a76a-aea8df0a0744,Commercial,0.7303438794451224,38,6,663,836,173,91.96450363623366,8886
f6acc449-b78d-49e7-8541-45d5997f8bb9,Residental,0.28078056792691075,23,10,90,700,610,38.75940361291863,1860
4f2d5b1a-79f2-419a-a6a0-d7117eebb2df,Commercial,0.37318854679512203,41,46,648,780,132,84.89826134070168,8170
acbb3f72-60be-4ecc-896f-05471920e853,Residental,0.9425541400260976,43,31,224,1024,800,70.50994062367371,1098
9355c4a3-5628-469a-8073-3bcd683ee04a,Commercial,0.0018569274343450681,13,24,312,812,500,35.413168076688216,8329
487bb1ff-f665-4b18-bce3-7d76e4f1495b,Residental,0.7252221304225616,1,5,516,1369,853,58.917712920626364,2550
8fdc20f0-4489-4e5b-a007-ab0dcacdc6e2,Commercial,0.7189965291391467,39,1,335,1162,827,54.22911055284973,8001
772a2a20-5312-4670-b51a-1ccb8e2792e5,Educational,0.9972337264568545,31,28,629,976,347,29.008665884812235,3948
57ed61b2-b69a-4d44-9562-506a83d80a43,Residental,0.9997290816721982,38,48,152,962,810,43.83622031715943,7266
ca970eb9-cdb5-40c6-9b34-3ee40090f685,Commercial,0.9477454174687514,30,7,615,852,237,75.52428435267029,8842
bd83f660-8c31-47ac-872f-e3d128ee0a90,Residental,0.14183789050975215,42,34,209,724,515,72.91125872976568,2382
ae556d76-4ac8-44a0-9e44-3d5bda4856ec,Commercial,0.8946850712370998,30,37,23,562,539,48.596177812575455,4636
96175ea8-6249-4d8c-ab66-72f79411774c,Residental,0.9686365828678506,26,36,74,89,15,30.262199486040235,6861
cac678f6-4883-434d-9fac-4067e23de72b,Educational,0.6538339187276118,13,9,433,1222,789,57.30680919308322,8323
34939bb8-2e6f-4cc3-96be-7ecbaee3ab19,Commercial,0.7977679211210056,31,44,564,1045,481,47.73025775778278,9490
1cd758ca-90c5-4466-a255-5a7d56b4ff0b,Healthcare,0.09449743044928072,25,28,347,840,493,28.868012692539075,8862
8d953f96-507f-45aa-bc53-9e2ddc2405e3,Commercial,0.8906752008870135,30,6,650,1035,385,47.41438689489007,1345
45542008-635c-4791-86cb-a9816bff5b8d,Residental,0.8209926475546604,38,17,282,447,165,66.01797760277466,4868
81b333e9-83cb-4117-8581-257e333d5388,Residental,0.17979905673289154,5,25,696,1120,424,65.7888628628463,5100
89313377-6e7a-45dc-9fd2-b9870475178e,Commercial,0.28548148583952915,8,16,126,194,68,70.63826391663716,2610
c94087f9-1bec-47d4-9d08-e025887c0c8b,Healthcare,0.012154151559733761,23,23,606,1241,635,99.43549022025876,8926
3b56f385-d666-4461-98cc-b71cf0dd0d49,Healthcare,0.46702322245961003,20,6,596,724,128,22.208959950879375,6389
2864bd7b-1f7a-49ac-8f91-0f9ec03a1c4e,Educational,0.6140796655458767,27,19,467,1190,723,79.63281670208154,1750
432a11d6-12dd-4211-b004-53d0ee112701,Residental,0.013106183001512783,49,40,614,1172,558,27.164073677813445,7740
513fe5e6-0116-426c-9024-27bd4417408a,Healthcare,0.5594834043512732,22,50,447,1351,904,98.91186110290052,3485
94f925e6-ae51-4139-b2a1-bb7a01017053,Healthcare,0.098231604526139,18,13,42,807,765,71.46562710840693,9439
d4bb5f49-a349-4b2c-8bb5-5183d21d82be,Educational,0.9242184851327345,43,20,466,694,228,37.84601321812003,5377
caffb2f2-7c72-4f1e-af75-c624f03557d5,Commercial,0.11624712208721977,35,40,371,601,230,79.48217860681396,9416
a822c849-a8d0-496d-931d-be3ed14deb92,Commercial,0.6541961891933911,32,11,261,1199,938,76.51655460533631,6957
e12c0705-13e3-4a9d-82a2-a777d5cf60ae,Commercial,0.4416559024011617,44,19,659,1189,530,65.23236631209882,7268
8f223c81-0b59-41b4-85de-ee2dc860df77,Educational,0.9005698474547447,16,3,23,680,657,79.58374359729804,2104
3175a885-9f6c-44a8-b41e-536e12b33ce3,Residental,0.5951162834830578,13,44,22,816,794,29.561301808975042,3252
7e0f2529-2cc3-409b-a2b5-b5449e4953cf,Educational,0.11223224320173752,36,8,528,770,242,21.84837730243222,2581
c3436372-45b8-4eb0-b8bf-0aa1bc085a86,Educational,0.4384376615169977,48,20,707,978,271,37.15123155297742,8483
ed412aae-d08d-4bf5-8ad8-08452b400b05,Educational,0.2925847426143553,3,35,464,1038,574,84.92389785279528,2203
f2ad4367-50ea-4387-9d27-ba746b770406,Healthcare,0.07122399773333554,46,16,544,626,82,53.21798250317193,9109
7b308cbe-7ad6-47b5-871a-0ac25a225b60,Commercial,0.5041773406550997,24,7,405,814,409,50.70543200295732,3401
3589207a-36e0-403b-ab55-de87291590ac,Residental,0.9272932669349973,4,40,233,805,572,45.749484461521014,8053
97465345-11af-476c-ac1f-f79243556e8d,Residental,0.7586659629312681,47,38,99,221,122,87.02294557033078,4049
434bffd0-6a62-4561-9554-e5772f7ab8f0,Educational,0.4657353103766171,48,7,469,709,240,75.98885479583743,7216
757716b1-3f95-4d1a-8542-c0dca1d1bed1,Educational,0.03535777168250376,13,22,35,622,587,69.85884191847359,2551
3beba1c4-201a-4cb1-8fb5-7b2e80069230,Educational,0.9874579100418904,19,19,245,963,718,43.89291064669096,6259
bda8fa51-e602-4798-9378-8d92612ec7fe,Educational,0.7722138261136338,7,27,375,964,589,87.51841419766222,9930
01a043f0-80dc-4d60-929b-5444c03f909f,Healthcare,0.8570813168822151,20,2,110,1020,910,33.92596240851034,5202
7f81c1dd-0df5-41ae-a4d7-cb9c809d4da7,Commercial,0.5268084541002374,6,41,252,1185,933,47.17805770985912,8285
e33a9afa-8eb9-47c0-8404-92daa599e324,Residental,0.01604371595626619,18,7,553,1417,864,41.69796210684658,5054
5d0bf0f5-c4bf-41e7-98e4-136228e135cf,Commercial,0.44755279121442726,32,11,535,905,370,49.14807986513967,7827
aea21225-e99b-4e31-b249-925a1d8c5f7e,Healthcare,0.8203905927852106,32,43,184,1166,982,82.12934827032076,9540
d817cfc2-435e-48d6-a734-3ba9b10a4b0f,Commercial,0.29874791300117076,42,1,605,664,59,14.705608218624294,9690
afe4fdbc-c9b1-474d-b56d-75aea880618d,Educational,0.3946400100789965,28,23,381,731,350,21.140531876180518,5940
1b1b83aa-191f-48fe-8c0c-13af81e43509,Educational,0.36961617303472283,33,4,440,882,442,13.555833633940486,8032
dcb117f8-19bb-45e2-9972-8bffffc89dec,Commercial,0.27025821126060623,21,16,7,1177,1170,21.34142015632299,6378
261b7baf-2e36-40ba-a17f-9b143e507320,Residental,0.6016202417646169,49,38,624,1381,757,91.88142030752084,6943
0c6c61a9-2dc4-4f6c-8eb6-38afc22141bc,Educational,0.4654407855169752,6,1,149,251,102,28.620681249263832,8133
d7c8e4aa-ce6d-46ec-b656-be6c8425019d,Healthcare,0.8444556641806723,33,16,596,1098,502,52.398782410194904,5561
f4b0a8d5-fa71-456b-9988-2e24cbe78716,Educational,0.704913252412608,39,40,488,826,338,37.48963982942645,8813
533b29fc-5a47-491e-995e-ea0df8f6879e,Residental,0.7057472119567936,16,31,579,1163,584,16.83714771832023,2711
e0c939e4-b234-4d84-9d52-c0624ae3a583,Healthcare,0.4416524733411119,10,20,524,1060,536,84.41828333524168,8950
5ef2cb30-6880-434d-add5-25e52cd331e2,Healthcare,0.8126746950350674,17,26,664,1231,567,38.47410685790756,3818
215adf46-aaf9-4cd0-a432-43294144f37a,Educational,0.2173292508898086,12,33,716,1204,488,13.314717282047635,1544
0433f2ec-e0a8-4872-949c-fede3bf477c1,Commercial,0.5096512479813908,18,5,515,951,436,57.95343560807663,7891
02304c7c-e5fb-42a7-b04b-7dc7f727508e,Residental,0.7133738349181997,49,41,330,808,478,62.77213682108576,5949
7d705ff3-b2fa-4822-99b8-71fd8cad9f06,Residental,0.8444381757608272,17,40,323,1111,788,53.157873092473196,3717
09db7f67-54ec-41e8-970d-374168c4b0c7,Educational,0.8099958950898277,2,41,361,475,114,52.106993198388466,8254
c6fb2e88-5781-4778-a66a-22cd9125d5de,Educational,0.12170152322524741,50,24,55,849,794,43.84474902401056,1161
7f3c4783-4417-41da-94dd-4a257839091c,Healthcare,0.02858458428822297,23,27,248,383,135,24.133569621422783,3185
b45ccdd7-62a6-4645-a175-d1f2e253f1cc,Residental,0.17916296229775341,13,25,532,1427,895,71.69599778889375,4676
0cd5a479-dc8e-46fa-a23e-ad635ae44185,Commercial,0.6795910455224848,19,20,669,1399,730,67.63312117908166,3980
58f924c8-ce13-4ca7-a005-ae344a0f264c,Commercial,0.788366295835891,10,16,358,935,577,10.584415934398212,3271
d8621e8a-aabc-42d1-a622-23a1b015a8ab,Educational,0.6738016954764873,29,38,528,1046,518,43.88722211059297,2889
13e2cabb-52fe-4209-bb61-7d7e7c9a6529,Commercial,0.627720172119969,14,23,485,530,45,32.64228362858843,1855
3900dc99-f831-457a-9ba6-d87fffe0add8,Healthcare,0.6755871442109097,29,41,393,500,107,92.52150138277851,1749
a00f3199-7de9-4015-8f47-3c309acf236f,Educational,0.9562157377934487,31,45,504,1112,608,22.469129393479015,3798
4ee87727-85d7-4a4f-920f-8736e71b3835,Residental,0.5045908392141067,37,17,72,1388,1316,18.126533752087177,3271
d9237981-f45a-4431-82d9-d432666495ab,Educational,0.9277660785429477,36,14,50,554,504,14.14951740953415,6975
088cd43a-14fa-4943-8d87-8379872fa50d,Healthcare,0.21339264280302295,12,3,708,1440,732,78.39812083389397,8746
518bc123-7fe0-452e-9746-7a450c774e4b,Healthcare,0.6958906320337468,26,41,162,235,73,42.03516690163531,7138
1f3c766e-04b6-47f1-92cb-b1911ffd514d,Residental,0.36252705515958494,24,27,699,857,158,32.6635913755387,3142
f8682636-cde0-40aa-b338-7227751e951f,Commercial,0.5378393917827511,11,30,549,751,202,35.67859895973622,9682
1257b45c-34da-4073-9a76-2ddf461d9dc0,Residental,0.6614597353419255,50,1,435,1051,616,52.501110071504414,6605
c7bb8063-b9be-46ae-9b52-2c5fc918dff8,Residental,0.7131877384665195,40,15,674,921,247,71.88862296010396,3761
4549777d-59b6-40f7-a947-0c6d7151341e,Educational,0.09676887820667934,38,5,415,1105,690,40.96576696277461,6458
aa4ac3f4-9303-4c2f-b883-9cca9cf98b55,Healthcare,0.3804898367385712,1,6,525,691,166,75.53747008363148,1234
169f444c-fd04-46af-8ce9-1257d22326d1,Educational,0.9021372696785385,5,10,287,1362,1075,51.55245265894239,7730
d2d1e34b-a4e2-4c92-ac40-7f0f428c4a99,Educational,0.1525674749232978,27,46,383,513,130,86.26318591650173,2087
2cc71402-6060-4a8b-acf8-cdd24e1a071f,Educational,0.3047182877066372,3,21,202,841,639,44.53708947803624,2407
4d9419d7-fd21-4da5-bc89-97692eba4f88,Commercial,0.5997751714962021,48,37,52,441,389,86.43292725475875,7002
10d93fa2-9c32-4899-840a-9248ad8d9eee,Educational,0.3359846664854804,43,47,238,1080,842,61.78723822254276,2318
40859173-6d61-4934-8d8a-a330a8713f03,Commercial,0.4894357567647001,39,49,146,403,257,80.92347461393078,2721
3ed4ffb6-f3d3-4e01-afe6-28eebc0c9490,Healthcare,0.8103737692968841,3,30,9,1266,1257,55.759211967907426,2676
afc6f44b-a9e4-4f99-8d6f-04e6222823ed,Residental,0.0013312712743559496,1,47,442,1144,702,18.99082439819708,3474
e5e919e5-876b-46b0-b0b2-5e1a6f5b906b,Commercial,0.4040476447919801,34,36,356,553,197,27.220205419781877,8545
5bf89f8f-23d4-4195-b429-76eaf1080e54,Commercial,0.5554345080565484,22,34,156,1323,1167,13.345299772427932,6046
8aff8a18-61d3-4eb0-ae51-e52ee31ed5ba,Healthcare,0.4653518633411664,9,1,219,479,260,30.617449157694242,4371
fd438b8e-9c81-47bb-a322-e3ed25c453c5,Educational,0.6547725741642713,32,40,166,1294,1128,73.27248824980987,2468
5eb5a96c-994d-4a17-bd31-4103bf8d35dd,Commercial,0.01995473181364693,11,36,636,966,330,40.86794379737114,6862
d3f1e47a-f760-4f96-b9ab-8c0be9150f7e,Educational,0.38914233243261864,48,11,486,1051,565,74.79693970603195,4409
e594dc80-bede-4fc7-b69a-68d821c1272e,Commercial,0.07864620969369729,46,46,5,681,676,54.36085240927115,4838
f940e435-4ba6-4beb-b369-b4c782dac06d,Healthcare,0.5751854468945207,14,45,575,1414,839,53.23422773563275,7894
ed83229d-9058-4dfc-bcd2-eda102942f53,Commercial,0.33521367825798387,1,14,256,1052,796,62.22961754260615,3276
0eafbfda-a5cb-42ee-92a4-e17d8a43e206,Residental,0.3033305686676395,10,37,454,1079,625,26.44487183756902,5541
533de957-bcb3-4314-86a3-4e5846ba42b0,Commercial,0.9584008215331404,33,43,16,1108,1092,65.84670082939323,5010
3f966199-a24e-441c-a866-1f34280bbd93,Commercial,0.96522462191504,49,3,536,1161,625,81.99369556353568,7613
51dca07c-1f31-4ce8-b9d5-f3ff11f29b83,Educational,0.3126875584689851,2,31,308,1060,752,35.13521219446921,2591
c75acecb-5e31-4130-b5e1-28aa9ce10ffc,Healthcare,0.18428955562015026,29,24,597,721,124,85.62786446618995,4862
47ba8c81-3889-4208-8950-e4d44c58764b,Healthcare,0.7247915657346284,5,41,243,292,49,33.20201542741728,9327
e39b4a78-389b-463c-a8c5-6491c8790ad9,Commercial,0.5889119072914912,12,10,401,1352,951,88.82642807672408,7652
636741a4-b11d-44a9-a6f7-f4793168b693,Residental,0.944104458707075,45,29,372,907,535,82.03884936208739,7245
8607205e-3846-4859-8689-3a6e5c78ed43,Healthcare,0.9618378164685958,27,44,703,1139,436,36.8217969690017,4602
b521dc45-f059-4b2a-8b5d-3ca5477796b7,Residental,0.9366279636481181,42,1,604,949,345,87.30712507412366,6097
f82a6d53-1955-403d-bb46-dc678c8ec843,Commercial,0.2039524326347929,35,26,665,1174,509,87.0338790171173,5940
0d4a9617-2f44-46cf-951d-478c2a6a3f47,Commercial,0.8426593138790596,47,19,692,979,287,48.18332840241798,4117
f3a146a6-e164-4d11-970b-13af13b4cdd4,Educational,0.03403227334282277,42,15,471,478,7,13.166709931604101,7646
949bcd48-4eae-4e18-b812-6680952153d4,Residental,0.014148218850060124,17,18,129,898,769,36.803009407502515,7040
4ea0311c-9946-4a77-9ba7-7518d33ff662,Commercial,0.34257832653069165,10,9,387,838,451,83.84127432500748,1207
c100374b-bd87-4197-85f6-235243e28c7f,Healthcare,0.09121393941034894,19,43,208,1183,975,56.09141464585136,5120
33a7c724-fc10-448f-97d3-186b2ce23bf2,Healthcare,0.4184583958033915,20,37,116,159,43,54.27837762642379,3700
1f0f3100-52ff-480c-b4f6-1eacad0a2d3b,Residental,0.12365568596629395,3,2,484,508,24,27.102486498559806,7304
b13c7776-2388-4c8d-8ce6-b74b167f86f9,Educational,0.3687338172972575,8,11,496,1339,843,66.57114676197466,6146
81753f78-2a36-4467-abb1-1fa85eeb24b5,Commercial,0.10369282879685404,31,33,264,1240,976,17.29916325989295,3793
b26c168d-6d04-474e-a1e5-d3591361964b,Commercial,0.6466912132776643,41,49,509,959,450,96.12135365879374,6331
d007ff5c-724d-4716-9fc5-81dfb09c01b5,Healthcare,0.5187098208108271,47,20,292,672,380,18.757034295209834,4833
c304e600-0d94-4e27-8388-139bbef75e7d,Residental,0.18738060800913103,31,9,452,952,500,12.951319884483949,1957
a1ec4bda-3c08-424a-b0bf-dd476ba1e456,Commercial,0.5279231841805697,50,20,361,362,1,97.67565302960807,6468
d8ef91ee-c136-42bb-a9ec-134c05b67bd5,Educational,0.36817322577588485,43,21,117,736,619,53.53256328097082,5416
3ffcd383-8e25-441e-8ff7-d93b62a303ae,Educational,0.9584777947911574,29,21,192,714,522,71.36379401414203,9048
85490814-67f9-4906-becf-ad398a0675d1,Educational,0.3291293803163645,30,16,102,116,14,72.81502882427887,8475
f04cc9d1-7e25-4392-92d4-e9e9038202d2,Educational,0.9112915641759278,1,47,711,1066,355,68.59758880753209,4090
807dbc44-e2b5-4fbe-adc3-451446c5a2e5,Commercial,0.735074645478109,43,40,445,668,223,59.6036413017502,3730
1896f584-17ea-4b2d-b21f-faabcf6d9a3a,Educational,0.8357270097435706,5,49,218,1279,1061,54.36392552821061,7011
6f765863-3447-4761-a508-106af355f4b3,Educational,0.8420649342904796,5,15,36,517,481,72.89932038662369,9036
8f850c6f-ae00-4c37-a0ad-7121f8b8f9e4,Residental,0.8099035388049699,3,17,326,1305,979,73.5996717048654,5364
c7a86b16-fb2a-4372-803e-e08b18af12fe,Educational,0.35343145825352795,22,34,342,632,290,98.96069309176404,6865
cd7f32c7-5f0c-4914-9e3f-9203b7e56a3f,Residental,0.7480910635700636,44,6,556,603,47,72.53839492989226,5963
ca784204-9505-41ef-9ca6-28019a3906bf,Residental,0.8896501690544648,12,45,615,834,219,69.56711079358824,9631
e8998099-61ff-4b0c-ad59-d42b3b715a5f,Residental,0.468089252778337,6,50,548,1075,527,43.29016594503417,3289
e8618899-9fe3-40bf-b3dd-a9e8ebca9586,Commercial,0.11010505382815072,42,3,330,431,101,98.63520772047012,8189
5756b6cb-81be-418f-b164-74569c99febb,Commercial,0.49620826644381755,43,35,353,1197,844,97.34401264008393,7506
1198a941-52a0-403e-96ea-493e162570d9,Healthcare,0.7124976834393798,25,13,686,738,52,84.98489316729032,7477
ad718a48-0630-40a7-aa73-bf7209098314,Healthcare,0.7670448703955282,12,14,427,1133,706,40.82941273151326,7652
fec77241-2d1e-44ad-9830-2487285e9329,Healthcare,0.40249160595481626,13,4,26,893,867,23.453113558917302,9734
467acbd5-ffaf-488f-b78e-096752da0507,Healthcare,0.24339736212172458,16,46,49,54,5,32.76578300634564,3517
36ede7f7-ab20-4b77-ae0c-fd89faa5561c,Healthcare,0.32169557082882827,12,36,346,1376,1030,43.80291429478901,3647
aeaa8ab0-58f8-418c-8995-b92bd92a6266,Healthcare,0.6787303503528517,45,43,650,654,4,26.412229435242168,8552
cec2dd96-cb3b-4648-a8b8-9b7efd4345fb,Educational,0.03155094759845489,3,47,479,704,225,84.06808112419996,3119
f7e725e2-aaee-4ba0-a678-0437e6c2ff51,Healthcare,0.1933923352169361,9,43,93,888,795,61.6019770376603,3274
0724f773-ce99-4ed9-8ab6-43f056281664,Healthcare,0.22217384279488273,37,41,116,820,704,19.986563362494277,7273
9591f749-c8b8-42c7-bfea-ca355499b48a,Healthcare,0.8782085300687118,22,37,497,1158,661,31.043731088839735,6486
ac1086b1-7316-4346-94f8-3ceac3c08e76,Healthcare,0.33284466434150073,38,34,112,559,447,70.10513875709864,2776
b058368a-97d6-4054-815b-3bf30666fd4c,Healthcare,0.6558543081674483,14,43,41,262,221,81.68386052673304,7405
956905e4-e1db-4f3a-9251-105c96756b3f,Commercial,0.5335179657335228,17,4,25,702,677,88.2860402620143,2659
e03b1568-3f71-4a72-82f1-fda1152c3a84,Commercial,0.606120601421708,25,43,3,1050,1047,85.85315647482803,7747
d691e031-b5f1-47f0-be91-8338e1f0ebeb,Commercial,0.920697276035196,6,34,30,961,931,59.22139861335781,5215
392ea49e-779c-4fb6-8286-4d349fac967a,Educational,0.2899997443234019,31,40,9,1306,1297,76.08540485915145,7661
216855bd-dcc7-4baf-8009-9dd1987a3154,Residental,0.6977725475569128,11,9,228,1071,843,90.04073964848119,5132
5448459c-66d6-4686-8c1c-b0de8c2ad907,Commercial,0.6505586980135721,31,24,335,1125,790,59.49433632866382,7723
dd6c158b-1d95-4a23-a9f8-98a3fe0d55e8,Residental,0.4581244619284456,26,22,88,1076,988,33.95530629590411,2578
a53c9319-b6e1-49a1-b348-e2c0faf77108,Commercial,0.30126062751829574,35,36,227,621,394,12.541849120671117,1721
671b003a-ef77-4b64-96c2-b8aa13ede462,Residental,0.7714788817738161,1,49,621,1069,448,50.47238894004929,7004
477b7636-9b11-4d56-8e7d-01d135502165,Healthcare,0.38597077115725265,3,10,655,1379,724,10.885765163198064,2807
48fa8d1f-88b6-4dc4-96aa-f0e19e087eff,Healthcare,0.6234388851004528,30,13,329,853,524,36.38558428355495,6984
e4e26c85-938a-477e-9f99-e49b9d449da3,Educational,0.23055673207366534,17,1,589,960,371,46.17136945047038,8674
a2751734-c9a5-4b35-8fa1-845e0fbd1c9d,Educational,0.26299161880633826,46,44,60,1347,1287,29.7666810586144,9414
ec61d2e4-2487-43b6-8604-b10428db1d18,Educational,0.24183891056761475,46,11,507,740,233,99.60035522062131,9680
cf2a5439-94ff-4e5a-9bb1-5b0e885d743e,Healthcare,0.8391364801200482,2,24,288,621,333,40.458067987622414,1873
81ec493f-19be-4edd-b721-55549bf83436,Healthcare,0.0776578346067609,20,1,362,652,290,83.16904002434102,6098
e2e018b5-e83d-4fb6-b0dc-4c27278bce35,Commercial,0.07254246578492107,20,47,383,1275,892,80.36040457704404,9271
9128f1d4-5394-457b-a46c-f4214a0b2185,Healthcare,0.8444898889507749,14,29,448,704,256,42.99443801168613,3025
bc5fa185-b84b-489c-8649-72152c06a688,Residental,0.3951307848779325,10,24,4,189,185,60.75788343857395,9764
79e06916-666e-45bd-a805-d8015ea4f7e2,Residental,0.6937424454675836,30,40,416,532,116,16.67138452811063,2025
72d46dc9-cbca-4b99-a16a-63a48840a5a3,Commercial,0.23925911496217178,23,41,544,1344,800,39.89197973123583,3428
679f60b7-917e-4cb6-a9ba-65e7be8481d3,Educational,0.12354579813515609,7,25,556,837,281,20.027395576292104,5507
6814fcdc-65ce-4fee-9c45-346fc742012b,Educational,0.6091311743344491,42,14,365,385,20,56.17557861192066,8158
af7ae220-a283-4431-a3d8-5819b803778f,Commercial,0.12328025788321262,38,31,187,540,353,26.15321972595282,4030
83ea6f8e-4aa6-434e-8c87-c80dbaca062a,Healthcare,0.9751380003281566,41,38,595,1163,568,85.57011394153017,1802
24d6ab85-249d-49f5-9f1c-7d1f04df9032,Educational,0.15800094773874085,44,8,486,1045,559,64.44011454234148,4531
72068862-c3c9-4884-94e5-6aaa23772578,Healthcare,0.27075177787956195,40,5,718,1165,447,48.04759432459516,9051
6bf710ec-97e1-4f0a-a072-6af0eee2d0e2,Commercial,0.7291846166728985,30,3,606,1292,686,55.26591918874915,1019
a06538ec-a7c3-4a90-9e13-cce9bdd0cc4e,Commercial,0.6258809650793863,4,35,518,1075,557,77.36506821807245,8991
95524c65-1524-4113-bf4a-fc26f700b93d,Residental,0.45589677873628576,49,8,52,365,313,59.02375625664456,5376
5965c901-db57-4e49-99e2-7ce0488690f1,Residental,0.23210714112928976,1,11,76,909,833,86.74314456196069,6437
cc1113f9-6c27-4c13-a0f7-e9dd643cca2a,Healthcare,0.6232260518778902,33,16,4,1120,1116,16.6764127560733,6079
c7025498-d205-470d-b6a1-9c027cadadd8,Residental,0.9375287043413013,5,25,172,701,529,13.55810916759781,3476
6a605636-9747-46c3-891e-7286928f0f95,Residental,0.5266456944041663,38,6,489,1005,516,80.3355631810608,8285
504798dd-8285-4034-895c-f6c914b13a7e,Healthcare,0.9557324906027391,23,17,18,271,253,47.33708877609856,1231
25813131-b811-4d6f-9ea1-615ce9c3185c,Residental,0.3057960294719061,3,36,496,1155,659,50.35407316375871,1558
ffeb88c3-9696-48b2-b661-34c3c54a62d9,Residental,0.5334241449329014,29,41,208,332,124,93.19442323902759,4176
cfeed9fa-414a-4ef3-8382-3f26c786cdbc,Residental,0.323193424980452,36,45,544,810,266,25.376186641487138,4369
fed63777-bb7d-4759-baf7-6a503043e827,Residental,0.5201468847234818,1,50,1,951,950,25.833338494430343,7715
338d9f98-fc52-4e62-9111-31e41882c0af,Healthcare,0.17185659136556797,49,27,232,1289,1057,38.110936870213365,6122
6a0aca77-95d4-4c6f-80dd-3e4036e00dc6,Commercial,0.2632938131084809,2,32,383,1169,786,48.22478303503295,1095
d0a54dfa-04a3-4543-99ed-ad3fca409e00,Healthcare,0.8142791516739816,10,13,87,1092,1005,38.56049919828541,8332
568c62b6-dabc-4dbc-a5e4-d7f396277ec0,Educational,0.9290909836822031,50,44,81,245,164,88.50137244481745,8873
f4c26fd3-2ae4-4bc9-bfd0-5ff0dd02e70e,Healthcare,0.9627030078983961,39,15,689,1194,505,46.706513970202685,6768
15b153ca-cc89-4525-a895-a2e6f7cfce41,Commercial,0.9659290144246903,32,50,695,1348,653,87.33914844229214,4619
742611f4-b354-4beb-8872-b771666cd1a3,Residental,0.9040866279906058,35,20,97,1132,1035,24.15666081532006,1731
189806d3-8512-4a06-bda2-d39502cb49b7,Healthcare,0.9258391189241867,8,35,356,481,125,56.78364230403102,9841
6ef1b1ff-fcb7-4226-a2e8-6be4aa5b79c6,Commercial,0.2625788286545766,28,15,261,505,244,80.09533568474673,2823
d77c1468-c3d2-467f-af82-d0be700b4028,Commercial,0.3338053255192964,43,22,246,814,568,19.242543477527857,6637
d6e83bc2-1ff9-405e-962f-d4da4f76e70a,Educational,0.9213560950728436,41,3,677,1009,332,74.21066474918905,6264
6006bd2e-6a68-4cea-837a-ec2181337518,Commercial,0.14419129709087897,16,39,283,1399,1116,11.223507817954015,4969
6c2b1445-e7d5-46c2-83a7-7dc8d4de3948,Educational,0.11334243227530094,6,34,264,971,707,73.91884983650426,7548
7f3e9eaa-991b-48bd-9556-ce0fc231df34,Healthcare,0.0251305385443662,31,10,291,1209,918,41.901943795230615,6320
7ccaa4bb-9944-4fb2-9d43-3bc3137fff1e,Commercial,0.41295142674581464,8,11,242,484,242,76.82657728155938,3519
90c9c42c-db7f-4c41-8ab6-443f049801e8,Residental,0.7884387688559946,23,32,601,1282,681,58.46763259873274,8702
689cce33-1b42-4b03-992c-5d850018d22f,Residental,0.8131304024767162,4,50,180,1120,940,78.31077521584383,4183
a431baa1-48a0-46ad-9f76-d6eaca6a0a13,Healthcare,0.7124538662730105,13,23,621,1124,503,38.938135553185575,7634
7d8999fe-bca1-434c-91fa-5a2b2d8b93bf,Residental,0.9107498337166913,38,34,39,811,772,42.75257699079396,7531
a6fe20bd-a3b4-43bb-a0cf-5bff74707d17,Commercial,0.059322534150543116,14,4,371,574,203,27.16843855968357,3311
e1302e89-9a2b-4789-a98d-4fb893912f81,Commercial,0.7159970401622222,15,2,257,1363,1106,15.710985971110814,9093
4f9ed795-ec4e-4b21-81a6-b68265dc66d6,Residental,0.9159677720933379,22,8,692,731,39,99.52029167646613,1489
a663f1c5-b5a4-4290-a0f5-f34a41118b3d,Educational,0.5220563544546412,35,23,552,1403,851,56.04508753666337,9517
6dad7abc-ebfa-4e47-be59-3a804ab5f77c,Commercial,0.2165435949982838,23,29,705,1138,433,36.92605658507715,1613
db332eb7-1121-4232-8d10-c22684b88aee,Residental,0.9058789966102172,39,36,177,1091,914,89.93807244258365,6381
7404902d-82fa-479b-bf94-cfb4f41f800f,Commercial,0.8364564592871657,33,12,638,1342,704,25.642587699257366,3300
50a0dee7-a268-4f08-a953-7f1b172264c1,Educational,0.28706915089707163,32,12,401,818,417,33.38761717640622,7535
9893e7bb-bcbf-49ec-b9a7-16a6b1f54fdd,Healthcare,0.4579470425112937,45,34,200,744,544,68.40062616037514,7469
1d3854e9-f335-457c-acaa-0b17bd4bf8c0,Commercial,0.9868137077413035,42,30,195,967,772,27.184021666665018,9416
05de8323-0861-47dc-be0c-89864c55df45,Healthcare,0.780524043776083,50,47,653,677,24,24.786269452461354,3410
b3492b8c-0917-4ce3-bc9e-2a8809d0ef19,Residental,0.8829278524624836,34,47,622,947,325,40.08188825470607,5851
215511b6-99ad-4119-bb89-25504ed45dd9,Educational,0.5245661153153757,40,7,247,964,717,47.14250993310878,6820
d0e8a6c2-eff8-41cc-993e-40bcbbc52f08,Residental,0.4622627067160525,35,38,291,1355,1064,46.89662642357538,6334
dc40b42b-e5a1-44b4-8ef5-2ebe01e1d8a7,Residental,0.6204842353343415,5,44,673,1266,593,12.24342877051507,1813
daf25452-5698-4848-8830-319bec3acbf6,Educational,0.36411602541568355,42,38,205,567,362,95.66971248788933,3024
9ff12e4a-ebd6-471a-b599-ee8b24e22c66,Healthcare,0.683639719110028,9,3,666,1369,703,41.077686260946614,3807
5c7b95d3-a18b-40e5-8fa0-5cae3743e454,Residental,0.733109083566302,34,46,631,873,242,16.585544821893205,3389
cbce18c1-d139-4abe-9248-c113f9494b6f,Healthcare,0.06810582414080868,3,32,421,685,264,46.74819585747572,9268
a79805a8-dba6-4cc4-b1ce-8e7c41f24d67,Healthcare,0.48783485233809754,14,45,464,1145,681,81.02503275525498,8411
2553daef-71a8-4fe0-9284-89670dcd44fe,Residental,0.7337295211133922,19,39,619,806,187,39.57190122036256,7106
c3e02fa5-8cdc-4385-ba00-2e37394ded15,Commercial,0.41966728632133765,19,24,577,1312,735,36.57692463135328,3117
ab3bd4b0-350a-4ace-adbd-2d07565f97b5,Educational,0.0916809111536756,43,4,613,1041,428,69.95929535660395,4873
68a25894-4118-4226-be2d-dd7988b4ea7b,Residental,0.4286407572497015,38,3,469,1277,808,89.22999469922502,1788
0242968f-d38c-408e-905b-e9cc4eb2aa2e,Healthcare,0.5377588425839424,25,5,719,1341,622,42.821533057293024,9640
0fde1a20-7b09-4789-8ab0-4fb84722aa8b,Healthcare,0.9318788967277993,28,23,278,720,442,62.553538490531245,3836
8ab8bc98-2fa2-429e-a8c3-dc0dc603c5d3,Healthcare,0.525637928520558,28,15,695,1407,712,78.90828332349606,8878
17b7d33f-0a9e-4adc-a665-ccb4d5d78e50,Educational,0.3489825738862178,37,47,623,1209,586,90.14495726521308,5612
cba93cd2-32d5-4a2d-9481-597f6d61f24b,Educational,0.11920959255760166,18,25,499,594,95,97.95441385964483,1851
9bdd51f6-807b-41b4-816d-513a201d4010,Residental,0.1493009685199248,36,15,36,64,28,29.394146558623362,8726
9675cae1-9515-43e2-8d1c-1c9889e787a4,Educational,0.252452695293121,25,35,506,1130,624,34.59691015093862,1755
2a95058d-c79b-40b1-b80c-4b3600e17b5f,Residental,0.07814502321904337,17,34,606,925,319,71.3637580841932,4319
07d9ff1b-53a6-4e00-afe2-c5a1a6d5f1c7,Residental,0.49236513792680847,16,6,715,873,158,20.318819611050287,2029
5bf8ca1d-75d8-4fe0-b1c4-6d947e5b33c0,Healthcare,0.5091922404587425,33,25,470,864,394,25.86301840371192,7382
d57beeb9-25e8-4196-994c-9ec72fcce68d,Educational,0.27584916507832014,13,17,569,1341,772,28.224420120788263,3784
8d43f9c6-785c-41c6-86b9-6b852e550e11,Residental,0.5623943031936555,15,34,436,963,527,85.55025834649342,4390
b847e5e3-8fd7-442a-990a-7d9cfb833330,Healthcare,0.4299596214714516,11,36,128,1036,908,94.40630897729353,7566
3bc38052-3164-4569-ad9d-d7c47b8f8843,Residental,0.6344516278203216,2,31,239,794,555,78.7240418309187,5583
1ba6011c-3aa2-4866-a1d4-6b5a67725a15,Healthcare,0.7386270251235767,22,11,79,1211,1132,43.379681727269784,6258
29e27e84-1ee5-4753-898f-2e00fe61268a,Educational,0.5241666341344358,27,44,273,466,193,13.856303771633259,8806
4e29f2f9-de6d-490a-ba8c-220e12393576,Residental,0.8462110038529327,9,9,155,716,561,14.568888304004364,4197
ad52fe71-df20-47f4-80cd-e48ef9a09988,Healthcare,0.515793036551943,42,4,436,558,122,84.47277779290371,4217
5b36d68a-7b15-43b9-a6ca-148f9478d988,Educational,0.648495522170509,19,3,147,619,472,80.36276242303117,4041
08f63ac2-424e-4c88-baef-a5101bc7f3b5,Healthcare,0.040068986308513854,42,39,525,1176,651,29.299829210516343,2427
3a02325c-2748-452c-9f2d-913f471b5a24,Commercial,0.8762574435417975,10,4,472,657,185,49.465631692946545,6260
8a1484d2-e6e3-4b3b-b4bb-c3f599016aef,Healthcare,0.9558210670533187,1,48,582,1301,719,38.546636041517644,3270
3e32fe1f-061a-4cf7-95a5-e59069a48f4c,Educational,0.14320594871171022,13,34,362,865,503,60.4360684135961,4426
3e39b942-2214-494f-9ecf-eb3e152fe8a7,Healthcare,0.6663283642635266,17,46,548,890,342,47.93673779733805,8975
47a43048-2e92-4462-8bec-96f74a395bfc,Commercial,0.7052738639504866,47,40,617,1359,742,69.92815027120707,1463
e8c84386-7602-4bfe-b325-668c9af26b3e,Healthcare,0.44961533834103407,12,21,257,1355,1098,44.49056961840699,7066
1d41ffbd-33b8-4a3f-a66f-b56c9dff64e3,Residental,0.6846547438949059,12,45,206,1409,1203,34.08731518664444,1889
b6d82cf3-b3cb-4ec4-aa6d-705efb26c755,Healthcare,0.5340962253198726,40,14,95,523,428,95.67858623500472,9970
d73fe035-f76c-4919-8260-705a4894de13,Commercial,0.9281527138594459,50,26,405,1362,957,81.9867876261689,6876
3b761a73-f305-4ee8-9640-8d0ad80bc595,Commercial,0.8765121685352895,50,7,498,724,226,48.433035776366054,1569
7598fb75-db7e-4d44-9417-073830ba16e4,Commercial,0.14487201005397554,38,22,471,754,283,37.3927157092758,9244
c0f9a309-57cf-42e4-bb6f-b032d7d84ae6,Healthcare,0.32497021161037365,48,1,32,1047,1015,18.36749009733929,2434
948295a9-5372-49aa-a901-234e7e310058,Commercial,0.9291709476899588,29,49,603,1201,598,76.50476846566688,6238
79dca556-1c94-4e61-983d-463809c194f6,Residental,0.07907936000899418,48,30,471,812,341,76.31642929387141,8808
2281a63a-6bc6-49d7-bb4e-20e51c0aaa4c,Residental,0.5017714042680731,23,2,465,1284,819,68.29835960688672,1457
6b2011dc-ad13-4f79-9101-160586b32ffc,Healthcare,0.4763820335192047,2,4,673,781,108,35.659834892014686,3125
c8e246a2-635f-40ca-a55a-f6db34509023,Commercial,0.11747355349717692,22,3,25,891,866,29.597041714317967,9831
a2563d14-6074-4108-a306-579d39a918f2,Educational,0.6627371076943951,4,5,706,1437,731,91.00191149293119,7195
b8670f89-794b-46b6-a947-f23f27e80e30,Healthcare,0.4105487849284456,15,27,623,1074,451,51.54778743702057,1166
4b760ef6-5d6f-42c7-8d98-7843ce795844,Educational,0.38884510721330423,21,44,611,1072,461,15.69307413589373,4252
d7a576ed-8110-437a-92ee-ea1ac8d4e452,Commercial,0.755455824101014,8,46,720,823,103,84.76561918221365,4375
61bd876c-6c8d-4278-9aec-979f0e56a543,Healthcare,0.2089924365508431,8,35,332,651,319,85.81284730230828,8610
9412e424-6399-46ea-a52b-0f2e28eaed94,Healthcare,0.8171371950547243,28,35,25,843,818,55.39459812509187,8727
e093b6de-910a-4f7b-9851-2f95377471d2,Residental,0.5451964403828128,5,29,54,698,644,74.27234383421337,6592
d95e62d8-47d1-4ea7-9bf2-b8ad968e0ef7,Commercial,0.4894442013156699,39,10,133,920,787,93.29332911640091,4665
78ddc23b-12a9-4756-993c-41a058a5bf92,Commercial,0.4102523925358561,7,39,258,1439,1181,92.37578217612682,5404
85bd80f8-f8c8-4779-a7ab-0e1e3da215b4,Healthcare,0.7718033992023676,10,34,251,1373,1122,55.04446577145473,7602
4b9fa9ec-6959-4d49-aaba-f207d26e1b19,Healthcare,0.5777933563460469,49,2,472,746,274,17.602016058407138,8934
a9fe5b79-fede-4500-ae79-dd0aad57eee4,Healthcare,0.13692701458299716,2,1,96,1051,955,86.48148655178534,9314
12bb8f75-9769-4876-917c-d788c8556728,Healthcare,0.5411922856911939,40,1,306,326,20,83.85791332150838,9933
8ec6fb02-6a21-434b-a00e-032b530d6f35,Commercial,0.47290321897144305,2,23,452,1368,916,60.068416644127595,1400
5a6caa2c-0f67-40ab-bf3b-6f1d0f7d475a,Commercial,0.1640037998056192,14,32,237,1287,1050,89.66196020544896,4724
8ce9d97d-9c18-4266-b290-3b3a3d231942,Residental,0.30910628358168846,4,10,720,1060,340,22.345182748626122,6171
cbb0bc94-d2de-400c-8c5c-dc65fe97766d,Healthcare,0.9518094523910369,25,1,68,159,91,77.01673110604554,4523
cd442a0e-6375-4a3d-b91f-aebc79f590c9,Educational,0.45283367000652996,1,46,487,581,94,13.111225130771043,4099
5c66b545-7328-4e1f-ab1a-0c538473b282,Educational,0.5743171803349686,38,14,520,708,188,78.11126529467958,8019
046ea56c-84ff-4158-b459-0c39e5ad021f,Healthcare,0.9452492770302695,48,36,285,590,305,69.71854836136075,9474
feb93302-74e2-4584-85d9-ed9b0087f106,Educational,0.11509595534940453,12,22,530,1201,671,98.88487247683626,8875
816d258a-7e6f-4d76-92f9-be8ca0ddc663,Healthcare,0.6525937160801153,17,22,30,1163,1133,73.79852547730101,8503
0e18c13a-9e43-49ac-ab9f-82faaf4dcebd,Healthcare,0.7871562428295105,8,10,201,1022,821,13.006740693946156,5248
c037832f-78f7-403c-8c94-8b898d771f84,Commercial,0.2198468897918312,18,13,698,1301,603,23.48458468531804,5355
c515ce96-6507-43c1-8c90-ce8b14bf151d,Residental,0.9410647465413804,2,24,288,871,583,39.59759278721307,1094
f74a4c41-a4b7-4857-99f3-2c93d39ab495,Healthcare,0.3974453309030772,20,42,500,1429,929,92.20927731219037,4710
aa53a1c9-f535-4c6f-885a-cf8d300ee38d,Residental,0.6180401644421922,22,21,56,1087,1031,19.66565763799278,7197
07d61620-c2db-4d07-8cf1-3cff9d6fc8c9,Residental,0.8071193788242503,24,36,48,495,447,81.98848734828789,2772
b31af06d-bb45-4932-aa93-20a20a31d8ca,Healthcare,0.9096661171475146,1,5,683,1130,447,70.41311004424676,2157
a398358c-b66c-453f-b725-ef0a7a4c3f6d,Educational,0.38461787215062204,23,43,647,1378,731,55.30271816693579,5378
12f729e7-7a1a-4203-addf-e5bbfe54117e,Residental,0.25652011560122434,42,44,175,987,812,19.986423572987547,9650
a420d487-28f8-43ed-b76e-bf6e54cf7d9c,Healthcare,0.6922330166184049,46,24,548,1015,467,99.65942652430486,5414
b656c30a-13a3-4ac3-8697-e26a921a5c36,Commercial,0.14619079491675546,32,48,444,978,534,36.48600615130802,7884
013a2c8b-ba49-4fff-a95b-fd0f0195c0e8,Commercial,0.11399623964477912,37,2,223,1328,1105,34.82683370860191,7756
c6f68075-3f5e-4102-ba41-66eb775198f7,Residental,0.347195131720645,38,11,330,1120,790,20.070215989765316,8561
7a41505a-ecb9-40e9-a729-09c86de3ecd9,Educational,0.5214321382769915,48,43,607,715,108,77.01698683262343,1390
897b69e9-634f-4e76-afc0-99f5d6e910fe,Residental,0.16980912608639886,33,7,170,193,23,33.82131988109009,6553
a853926b-109b-4500-b3c4-0b26325273a6,Commercial,0.41297399557392933,26,16,266,1085,819,63.06359560455327,5329
a141bdf7-5710-4d31-8827-2097ded0a4f7,Educational,0.7019437694392548,21,19,330,1218,888,13.450386957441658,8095
4301fa90-d318-4c8f-8e32-8da943c26082,Residental,0.26122917992742667,35,48,582,981,399,26.85880789124692,6426
d2a50ca6-5a32-41cc-9a7f-db5973674c0f,Commercial,0.602144806719251,9,42,520,711,191,73.9739247106739,7065
cf755878-6904-48c5-8fd1-e85cc8e6a77c,Commercial,0.9202048453597632,29,29,720,988,268,38.115567112271194,1232
b5ce0ba0-5650-4865-9c28-2322d39ed83e,Commercial,0.7512530025550999,18,33,324,943,619,46.787660065958974,8912
c1ef511a-77b9-40e3-8c49-24cdbc04a4f2,Healthcare,0.2418103266926056,33,28,269,743,474,92.62397305983052,7147
2283675b-8d61-4027-a4f6-257073af26db,Educational,0.5690090340522558,12,12,184,481,297,46.33521848247879,7703
598428f9-8172-4c64-be5a-b399914573e9,Residental,0.5653030892778674,7,45,400,1390,990,25.82152405336982,4317
c9cc3eee-8363-408f-a6df-db303f225977,Commercial,0.9677584213474052,3,30,386,872,486,38.00337526980685,2370
92c72613-c315-4fde-a739-340021379c43,Residental,0.09087808433850053,20,39,657,667,10,62.90117717468854,7439
a36c3b68-6856-4ad7-bf33-715cd95de4ce,Healthcare,0.6791930860176523,44,31,113,985,872,13.187946560068731,6114
662f7047-6e8f-4fe3-b840-0040c7492ac8,Residental,0.4501347524729459,33,19,218,1291,1073,57.76537076297835,8146
b5c87cce-ae9d-4b4a-a242-cb5930aa5b43,Healthcare,0.9389318824580447,20,37,434,1033,599,79.24775316766011,5863
70405de2-7519-450c-a1d7-f0fc9c84c5a7,Healthcare,0.30179819580472045,19,39,644,1145,501,96.27604087571449,3470
6b8d287b-a212-441a-ab20-640ddcc9ebf0,Commercial,0.5187748478161408,24,14,283,734,451,80.2437792402978,3525
996f9e2a-1007-46c4-9bfb-8e432d2da14f,Commercial,0.429178182688298,20,27,708,940,232,66.93639537630136,4528
19dfc36b-5055-4878-8497-0f96224d1a9b,Healthcare,0.6186361367671478,29,4,12,1416,1404,10.860176781610388,6884
9a9d4ec4-9604-4801-90f5-fbc1ca0487e3,Healthcare,0.2723332805320803,32,13,505,1259,754,93.01104647580212,8887
f0e344c6-370d-4d54-87b6-57b4bbe76573,Commercial,0.2372572548561217,21,41,169,759,590,25.44269910733272,3675
48d2a8fc-a25c-4b21-bfe3-7e8dac1a828b,Commercial,0.07663702497321179,5,38,492,973,481,11.291266021526152,7883
5b85e964-a5e3-4c9b-bbae-4e8e50dda5cb,Educational,0.6679516637004572,32,43,207,475,268,18.084939166788878,9940
29426400-bd63-40d7-99a8-f13348852d00,Commercial,0.34822534136382743,40,5,406,487,81,98.70183829216447,2858
e54d8207-c936-4bc2-a1f7-4920d63d2ed9,Commercial,0.9689258794856965,47,38,709,1434,725,79.21278790782823,6066
3d82b7f1-ff17-4afa-bf09-3b9f4f4645ac,Residental,0.8596314404891507,10,50,584,1295,711,10.856775832945619,4284
8f986f1c-458f-4943-a7f3-4d5d2ed8d671,Healthcare,0.178559776346503,46,36,525,1194,669,93.362093723638,7258
0f1dd329-ccc4-4ecb-8ed6-f5831dc255de,Educational,0.5067211531180829,31,5,630,819,189,90.13060630955239,6096
b1b80df5-e15d-41eb-8353-f504b221e69c,Healthcare,0.8502386365222434,33,12,179,560,381,24.144206050725145,3351
98cb633a-867d-4eeb-b4e5-78916805f295,Commercial,0.5506720402793301,36,47,582,648,66,39.82764626740607,1537
89295531-ec5b-479d-8411-9041ad308e6c,Residental,0.4223062427089195,35,42,542,1268,726,90.86130167831337,1620
1143533e-381f-4f12-9c05-f2752201c83a,Healthcare,0.3217498274575299,36,49,325,1196,871,86.2906252098312,9305
cc56f379-5c70-4446-82d8-4f3d059abde8,Commercial,0.6101306119554156,35,7,712,952,240,49.64822095885233,7950
895718e8-2e31-4d7c-999a-03ba77a72a7a,Educational,0.07830511993536349,10,50,230,623,393,69.01196324811428,7892
7875abda-1d1b-41dd-9d9b-228aff008a4f,Residental,0.9222273021704955,36,50,683,930,247,16.03112483847238,7362
767722ea-ab49-4193-a431-e8e088fb380a,Commercial,0.06148575306555226,28,42,328,634,306,75.27838464896772,5779
556fc52b-942e-4bf7-8d94-9dd6fbf5877a,Educational,0.6644839750670949,6,41,283,726,443,65.66120696579526,9727
a2d1e248-5653-4b9c-8214-4b13c6167c6b,Healthcare,0.06877192670653542,50,18,524,1080,556,36.86265372978619,2180
ba464e13-d769-4db5-b2e8-a069c2e2e9a2,Commercial,0.7677881947030302,46,20,105,276,171,16.464423111897162,8763
6e8571f5-6441-489f-94ac-aa851aa3634f,Residental,0.7403527149404765,36,40,493,1126,633,31.881617179127527,2862
8721f245-9171-4b79-83bb-cf441d423115,Residental,0.7554850007230143,37,24,192,216,24,68.18174327221973,3166
cdb8e71f-6dbe-47a6-84ce-eff06d54f542,Commercial,0.7084901128074478,30,44,401,1042,641,57.56445166811593,7534
5cdc1f32-8159-4287-9193-1fdc012e821e,Commercial,0.9602613405601924,11,13,175,1347,1172,67.7377476024533,3102
5fbb4002-93b8-42f1-9ef0-7a19a1a94dff,Educational,0.3605886997782497,23,47,128,1385,1257,85.92832320264576,3409
938febc6-f07b-4e7e-a5a0-45ae2e398192,Educational,0.8372024104348317,2,36,540,651,111,32.57139768097814,5584
cfaa77be-e3cf-422f-8f14-c65d1fa95324,Educational,0.8602195902362015,50,11,328,1292,964,10.305280677872274,8567
e92cd5ca-016c-4830-bff6-417a36f25905,Healthcare,0.801754452265728,25,6,369,375,6,26.904946029154864,9488
f73c1d1f-a1ca-4c04-9647-fc0b0a22503c,Residental,0.7374832696094025,15,13,118,585,467,34.24043362013283,1664
a07a8066-0e7f-4a27-8894-99973c5f78a0,Healthcare,0.4985546075434778,6,1,300,425,125,19.113145486781132,9929
b49c4346-100f-4735-a30c-8303842a98fa,Healthcare,0.9732925051550314,16,36,480,1196,716,62.876688152354156,5282
e379cff0-3d17-47bc-abf8-1b7ea1e8bd07,Residental,0.573471920452531,6,30,167,520,353,14.363331789958703,4309
4a8dbc03-6b3d-4f22-81a3-83201062a7e1,Commercial,0.8774488365293845,45,17,142,231,89,70.98573532919423,6283
df84fe93-044f-46f7-a7bf-b2758a466e7f,Residental,0.48331716184891604,25,17,518,1026,508,56.32296082382555,4438
8dbe9cc0-7db9-4e7e-8c46-0583ab00750f,Educational,0.18870705698145052,26,5,76,1372,1296,68.11228422578085,1974
5356167c-e81e-42fc-af15-0f8c9794dc09,Residental,0.9556278740208072,11,28,230,766,536,26.231101434268034,2817
548c310c-fa87-47f2-878e-8f56f8d2128a,Healthcare,0.7352618007290656,13,50,317,346,29,98.16362421949513,1482
0438e3e3-73b2-4494-99d6-ac24001a59f6,Commercial,0.49979665234289317,40,42,59,1024,965,93.69035706415116,1061
74c0473e-a40e-4e42-b3b9-b7be9aa92577,Commercial,0.14108974542313635,32,4,378,513,135,78.35415876311565,6609
0f055dd5-338f-452a-ae2b-8bdd68133d76,Residental,0.36361183353255466,37,36,27,582,555,83.1716051586515,6580
50e28912-8fbb-4bcb-a3a9-21319207e291,Educational,0.09867144902747593,17,48,159,1319,1160,10.902546174823073,9647
80a035bf-85d5-4063-92e9-5fc5d40f52d3,Residental,0.8532361382643809,28,4,447,1395,948,60.552242506023674,6934
6a4ec8b3-dfb6-48c5-83f9-26391614bf9d,Healthcare,0.739613314966527,23,33,157,821,664,54.78342229938346,9233
d9ec07dc-b24f-4c4d-b27c-005e724a97f2,Commercial,0.20182307065932403,30,26,424,448,24,73.32570165979857,4653
73ece665-a886-4197-9d9c-ee131a4cbaaf,Commercial,0.44193961856741826,39,12,217,454,237,27.965806656738422,7000
964c130f-4be5-4968-a07f-99b57d899599,Residental,0.24378215106357115,18,42,315,918,603,25.060247756478844,4077
ad407b5c-3fe5-4715-bc49-9fdec7177a90,Residental,0.7307395980756599,2,45,252,1235,983,82.69555059684944,6507
63bfc6f9-7e16-4c9c-91c6-f1cfeae448f9,Healthcare,0.5790516723930744,18,10,64,646,582,35.582641753198885,8593
6dd88ee6-430c-44d0-8051-31c791351582,Residental,0.5666879866942997,50,34,553,747,194,37.54532971886373,2777
c3271790-55a1-465b-a865-f22929bb3618,Educational,0.41874257073334686,12,32,366,561,195,50.61621823105645,7180
9c3c24d5-7e29-4e03-91d2-8fb60fe8dfc1,Residental,0.8340188570644134,17,5,647,1225,578,41.39663410177532,3806
41b208b2-f4f7-49b9-91b6-209bbc40d28f,Commercial,0.8002892088153639,48,41,242,1398,1156,53.60210301124221,8521
c828344c-8150-45fd-b2d0-a472e491d51c,Residental,0.04267251631208402,24,19,71,613,542,79.27967085637009,6100
8945eedf-3c74-444b-b47a-80811fb5f301,Educational,0.1350294446524718,26,7,277,1395,1118,55.199232669619846,1185
188a2c0e-b26d-41c2-837d-502e9f7e3ef8,Residental,0.7944626691036424,3,42,333,1286,953,54.17992602853568,7956
f77fd99c-78a4-4f63-9c54-4d1b4625cb13,Educational,0.40040884362096363,41,13,215,1207,992,91.16369243150493,7906
3dbef844-0b1b-4b5f-80f6-6c45a82c485f,Healthcare,0.8859602621163679,19,34,473,1378,905,46.46591639446578,5703
ba5d371e-7ee0-44d1-8a6f-7449ca24b01a,Commercial,0.6740074788761369,21,23,164,1342,1178,38.547844680127696,8986
2476a9c6-1152-49a8-872d-02ac998610b3,Commercial,0.9598681447474909,18,43,347,1393,1046,37.549005047315106,2792
d43dbb81-b856-4b94-a696-c0659fbb4b0e,Educational,0.4151700537593379,15,38,372,1426,1054,92.903014067571,1269
ab10ed14-18f5-4693-9552-9df9a1f7b035,Residental,0.3425065267081281,42,3,656,897,241,12.246410901641138,8425
97ab93d5-6337-4296-8479-6225c6e1f12f,Educational,0.18332728761066608,13,24,261,1348,1087,52.64388045327616,1000
597206ab-69d0-4bb8-9687-caf5d8551024,Residental,0.48845299914056917,6,17,389,905,516,32.02348871701946,1907
76b7c6a7-93c2-47a1-9189-b3d89c4758d8,Commercial,0.3514877621170349,24,38,79,679,600,49.78314748168288,2800
a11cec2e-cba5-4423-b0ef-5e7d9466309d,Residental,0.7668458122916783,42,38,424,782,358,82.61176636948873,5536
d369caf0-334f-40b0-aefa-be36df30c3c5,Residental,0.6815051997173053,38,13,544,1308,764,16.483527902395764,5528
4fbb2121-09c8-49ae-8d5b-1826fa1997bc,Residental,0.2285642396123293,30,10,657,1391,734,76.20070509944013,2990
476a12df-b4ff-474a-bf88-5a5d33fc46a6,Healthcare,0.5366483920808124,23,37,274,1320,1046,83.79326157792002,1165
cd475bca-8c1e-4e43-9b3a-07afa8740c86,Healthcare,0.7717130373548665,18,24,676,1027,351,81.17477304903257,4188
50bb82c1-1906-4630-9c2b-39e781c41ad5,Healthcare,0.4380257289429995,15,24,84,1430,1346,30.320204407484017,3728
31fd1010-307a-45ea-9705-4ecf1dab99aa,Educational,0.15398377011782483,26,29,248,286,38,11.268555248935453,5758
76a9d84d-3208-4836-879c-498e9be4b896,Healthcare,0.07359383733246183,9,34,509,1103,594,93.5445412305391,6846
8d13cbce-a30a-4a6d-9077-089fedea4b8f,Educational,0.04078288436249922,30,22,273,1073,800,72.96616223159347,4680
3e86fad1-cf53-479b-b3f7-99d81a541230,Commercial,0.3230926018883984,5,40,512,1096,584,15.524464579702956,4920
b8712a12-c0bc-49ea-acbd-552d1f138d80,Educational,0.8510557667107961,29,16,679,951,272,46.460012638073344,4710
b5b5cd14-2824-4606-b65c-058c31817224,Educational,0.7287024232967867,49,46,389,1194,805,97.43907987060958,2667
4eee5bc8-8a48-407a-b75c-1ef1487e5771,Educational,0.4066822568628651,19,15,184,458,274,36.74927811626591,5529
f724e590-eaec-4cef-a81f-15c1399baf1f,Commercial,0.5741808768479199,21,4,585,1237,652,32.78675299521208,5440
5ec0b6c3-8937-4cce-be4a-a1cf587f8b0a,Commercial,0.6316615230095609,28,17,232,778,546,46.08649321289355,2261
1f092100-e89e-4f22-8d0d-d1b13dd7e322,Healthcare,0.8084030983027297,23,24,183,616,433,51.180742755171174,9324
71d137d4-f615-4564-9d4f-9ecd9fa13548,Healthcare,0.4917568057743371,15,38,176,1100,924,98.43682963706311,4020
7c2d2743-f885-4589-b2eb-d35df83392b4,Commercial,0.5855807146376657,38,30,632,1274,642,48.32103974876784,7556
5349c850-e30e-4c4f-90e0-52d239d85b96,Educational,0.9645720156636663,45,10,495,1204,709,95.68137216196384,2183
ad6a8055-6608-44b9-8fa1-111d5bd8cf55,Commercial,0.2700759164388825,40,46,53,1396,1343,52.767777627763515,3967
3d5e91df-3286-41b4-aae9-2af539074d0f,Commercial,0.6163638311758637,45,6,288,617,329,41.540446432857834,4523
f0ec6b74-c781-4f9c-872b-978acd1ad822,Educational,0.2770260863890165,27,17,190,1321,1131,75.28126447427879,7742
a437ed2c-ffb8-4a87-9ffa-9fb0746fe3e9,Residental,0.511201252601746,6,17,155,1384,1229,65.81666452455747,4493
aa8e8107-8669-4808-8178-856fb0c4ce83,Commercial,0.2788964466153334,24,45,247,422,175,92.45575194989286,4284
6ffb5af7-5991-4c76-85fe-1cfff3da09ad,Commercial,0.5009780531042416,29,8,436,843,407,26.960742193726293,6155
f261d05e-f5b7-41ee-86af-7e02ef70fee4,Residental,0.1008285269161544,46,10,359,676,317,31.304330657226867,2227
8af450db-1f94-4afc-b8eb-cf04a5aa38d8,Commercial,0.5889549816634495,15,25,231,1363,1132,86.06480379185884,8600
9a7d5f45-5931-43d3-87ba-cdcdab686c4d,Healthcare,0.9240383010724701,4,22,654,948,294,68.60972588959189,2724
15fcd466-0ba4-4aad-867b-99a7309a4ca2,Commercial,0.25017568206643903,31,29,616,1084,468,64.75586732585802,6633
6f8f6fae-ee04-4a2a-9834-5326407dd127,Residental,0.20072326034927612,33,31,278,986,708,17.136968517102744,2344
4238358e-b434-4a10-a127-a3849178d81c,Commercial,0.5939971080319668,23,16,148,508,360,51.26012611908657,1806
5261c0e4-e6bf-4504-a54d-1aa06102b13b,Residental,0.6932423996353746,3,2,60,411,351,57.30185550917889,3026
653e1cb9-0873-4a30-91e1-bb8d54947c32,Healthcare,0.30537801387577135,30,37,49,425,376,93.20452650941908,7224
25815eea-2c7a-480a-bf1f-91cf470f69c7,Educational,0.22883464641513285,39,38,425,876,451,74.06330389562194,2848
3be771bb-4c84-4429-ade0-716a8f951fef,Healthcare,0.6146541500300988,1,35,599,1141,542,83.49605295188579,3897
0470453e-6933-497e-b4a5-ce561ed0a7e0,Commercial,0.5068118775961948,5,41,688,770,82,18.729956950256756,1024
548e4fd1-b682-41fa-9be8-d33bea93e9ad,Commercial,0.3688041797794648,43,8,147,449,302,62.5769001028515,7412
ceaf501c-3d92-4a18-9244-5985250c2073,Commercial,0.88289918022699,38,1,534,1354,820,51.79742108170663,3773
29f83448-be9a-44e1-b12f-e30fe9b9a3b7,Healthcare,0.5983301148294574,22,15,456,641,185,55.3159103338914,9819
278f8f56-0197-4276-a6c3-3678ad4260c2,Educational,0.34002863276617723,4,48,74,1144,1070,40.741287698748515,4064
3acbf128-c8c4-4dce-8fc3-31f8f3c42b05,Healthcare,0.3345262117778287,42,17,29,493,464,50.11080484392713,4228
eda8bc6f-3010-46e3-a0fb-75eb790cf666,Residental,0.6403935323453545,42,38,465,1320,855,71.0592149356215,4940
cd7d904d-fc90-411e-a83a-bccf7aca07e9,Educational,0.992497378181014,32,12,489,902,413,58.968560436559656,1687
0ef6ba2a-a0e2-44a5-bbfd-d968aa636810,Residental,0.9850799724500859,40,49,619,1202,583,81.08525427418851,4598
6757bcd1-c1ac-4ef1-b538-db839b6521a5,Healthcare,0.7723842953973779,49,20,680,1249,569,38.518147447061466,1763
573d87b5-3399-463d-a699-3408fd3ada25,Educational,0.5629748964259349,32,21,687,1421,734,28.01344688464796,5599
b0991ad1-94b7-49b5-8075-38b02a88332c,Educational,0.306330147609159,18,13,584,998,414,86.0337954028318,1316
0d04db95-461d-4178-be1b-9786c168c76c,Healthcare,0.5432781055635457,23,17,187,1429,1242,17.144609937480432,8589
59600d1e-646b-41d6-bd5f-514e6965fc12,Healthcare,0.40896833290592793,26,44,416,892,476,91.30049714213605,9639
b7237fa7-771f-49c5-ab71-e1b3f440ff71,Educational,0.783150253466134,48,19,627,1427,800,48.217530923160915,9012
478ed919-0b27-4e8b-9024-24579829b8f9,Educational,0.4890266787604354,23,19,112,1378,1266,90.5521482278411,5272
8e49a45c-3c6c-4a16-9822-668a7fc2247c,Educational,0.7732008193454841,39,21,385,1414,1029,62.47406070275379,2633
4ebed31d-6d68-42ca-b1a7-d0ff63edf58f,Healthcare,0.94865050118146,44,28,4,1204,1200,86.36521529013366,1039
dec2e742-7c3d-477d-aa4a-6875b9d61d99,Educational,0.9526799729507779,42,34,98,1136,1038,53.66905339615782,5483
51f23d92-09e6-4c57-ad9e-a0082bda3b3d,Educational,0.3367837829538509,4,44,581,1381,800,26.02028897861722,2331
2aebca2b-9915-4820-842e-48f3c0e3dd6c,Residental,0.8777727049660017,29,14,154,1260,1106,87.35206944971664,6308
a5d24830-52dc-41f8-9175-afea224bf5b3,Educational,0.19958407916778087,14,31,445,1140,695,50.606632846691994,4480
c049145c-c0eb-490b-8bb7-03b655542e11,Commercial,0.8663546301990409,43,14,627,1438,811,45.59273757119068,1902
be73a4bf-f134-4ff5-9c69-9cf15b97a6cf,Residental,0.5483318742444089,14,44,206,1035,829,34.55409014955315,2386
84664bb2-ac7b-46f4-92c0-c294138543e2,Commercial,0.30054364846448256,18,9,357,627,270,51.58469293389995,2017
39ca37f1-3eb6-495e-821e-012c33010168,Educational,0.2567070544333607,48,16,565,673,108,56.06542448387172,5980
9bf9837e-34de-44f1-979d-03feb4cf0408,Residental,0.7731397760593387,46,10,670,1032,362,80.99361343847593,3452
01b75059-87c4-434b-8246-fa3838c32b3f,Residental,0.01770056508260398,48,47,124,793,669,36.80995910286575,7987
92e63fbc-dd6f-44ee-a567-272202f056cf,Residental,0.5432815185708934,47,22,473,1381,908,78.88643035843674,6581
a95b967e-28be-44ee-9ab3-c31ff3b411db,Educational,0.6470029534530234,31,3,333,844,511,49.33254142333992,8978
5e70eeaa-31da-403a-bc86-1f8bc427d25b,Healthcare,0.2809449361897586,48,39,76,839,763,39.22363626647969,9702
d9d9c392-1fe1-4e97-a816-4cfe5f94176d,Healthcare,0.7791162540626352,28,39,72,569,497,44.75649606242042,3555
f7852a3b-b575-41bb-8226-5558a4457fa2,Commercial,0.8291663050145575,21,16,105,783,678,20.407640551121546,9643
53232ab9-6a38-4e8a-982a-958412a150ad,Commercial,0.6117994274790216,15,9,296,813,517,90.85712946935463,8006
2cd241c8-cec9-47b5-9555-c6244ff0eba7,Healthcare,0.6295094744647819,35,7,321,739,418,71.73374562497096,5029
4723d6b4-3c88-47a7-97d9-6a6a1c3a2991,Residental,0.5514256416416496,22,42,719,1347,628,31.745644326823157,4542
31ac1dd4-b311-44af-b298-202b84b7c6d9,Healthcare,0.28050252695742006,35,43,48,1137,1089,42.367765151611714,4727
4dae1fba-fd55-4ee7-94c8-44413e6331b3,Educational,0.26698632537634337,32,27,415,644,229,39.50383532068696,4635
d7207954-6202-407d-8d93-76b0f805d73a,Commercial,0.6997602609415495,18,46,130,615,485,21.111048153512026,5809
e72e3ad8-0349-463b-a37c-e5acda118ca9,Healthcare,0.010499528815494874,10,48,194,661,467,15.089832246837132,6859
335837f3-0f94-4a97-bbd7-aa5d350217d7,Healthcare,0.17830980477744562,18,21,253,1115,862,43.684446793776395,3010
577e8aec-a659-41b0-a6a3-dd697b1da0e1,Educational,0.7367700214861042,18,37,410,903,493,68.41667836456175,1077
104a9bc5-4a99-4ea3-bc1c-75ca5004c583,Educational,0.44582778983199345,34,12,532,727,195,27.600746875284102,2740
7f9c95f6-a8fd-48a5-8e0b-7f4a9faa79e2,Healthcare,0.07800868817225592,1,20,378,759,381,46.05969489524734,8118
0aab6d52-0eb2-4622-9911-cc58d1a5ad3d,Residental,0.2992196596519283,8,26,240,708,468,22.097321229046916,8913
7ca8a21b-1491-4271-a155-e3a478265d3b,Educational,0.5414198081100067,5,40,419,478,59,14.728699835738729,4610
c0b75295-5f1b-40d3-9bf6-23938b52289d,Commercial,0.034885450416693,4,47,505,990,485,99.96147799165617,9909
170948fd-fb02-4c29-b452-c4ae900e938c,Residental,0.40884788209783707,12,47,485,595,110,22.06401817449136,8538
8265a58d-c0fd-4e09-9a73-4c77f65104fe,Healthcare,0.9563535263460816,42,41,689,879,190,69.44670876292048,9809
e4c5f958-a006-4fbe-b483-44ad922dcf8d,Healthcare,0.7755714910920665,22,36,108,446,338,13.795253966670156,1723
c52edf1a-b44c-4874-8957-28cfb67de77d,Educational,0.020331138972720653,28,44,635,1411,776,75.46996256916536,1794
65ad5624-4ff8-4085-b18e-578cc01040ee,Commercial,0.6048602318347099,29,45,27,645,618,61.69326478348719,1906
a281f735-065d-4d28-bb4c-6f8652e61c1f,Educational,0.3155385356268594,32,10,509,1036,527,57.308386741788894,4051
e3e1de67-41bf-44c3-8984-419b8fe25075,Educational,0.37645346437564753,1,26,109,1226,1117,24.209030092619727,2650
1e8f5874-65b3-4751-89b2-9b94c9d52ecb,Healthcare,0.6376167404722767,11,48,637,1302,665,79.78791512726062,6540
b151fc5d-afee-4939-b1ad-890d11710cb2,Educational,0.6452448590310361,32,41,491,1409,918,12.38185731362735,9829
920d4a19-0516-4664-b6b9-63cc5b1fd310,Healthcare,0.6589688173017016,4,28,200,744,544,10.090644033757833,2901
ad1389ce-17c1-48d2-b994-e63a09ca2701,Residental,0.27094827229953433,18,7,410,662,252,81.29586506803278,2263
346ff3d7-d77f-444b-86ce-5eb69a8cf470,Educational,0.7913211693419075,47,15,681,1331,650,46.104770913898534,3230
d28f534e-5d8d-40cf-b5b0-b9662b93d0ef,Healthcare,0.42958775932286164,23,24,103,949,846,77.94715704713553,3074
e31f4bd5-f1d3-4f93-9743-929395f83837,Residental,0.8875254543370786,10,6,514,1387,873,47.36207662810397,2868
76e44323-e2ca-419b-a15d-c5915d922f25,Commercial,0.07683314827164711,50,46,537,1183,646,49.76174094730803,9580
2f6e5b90-bd4c-49e2-b2d4-a7dc8a329111,Commercial,0.8708139663432665,25,3,27,989,962,26.29708997009711,6737
afbae21a-311c-4080-9f30-ac1d380ac3f8,Educational,0.5435276372347848,10,1,20,176,156,28.05567635366849,7112
9eea3bdb-1fa1-4350-9205-268ddfdba118,Commercial,0.2559556142902435,31,20,639,772,133,45.43504037280751,1099
23e7d670-8979-4d90-9f92-d03aba9cd07e,Residental,0.8394160507414977,31,3,267,1387,1120,51.79748578165019,3580
293bb87e-b3c9-4d6c-badf-1cc5f60f9c7d,Educational,0.835852533327106,13,35,2,841,839,30.10678999973807,7399
01503633-becd-435b-9394-258d00e52d13,Residental,0.6188879494813545,37,17,99,613,514,73.61022694700941,2939
37e3f7c4-8573-4a67-bb43-16bfd05088d8,Residental,0.5852642868458657,41,24,43,431,388,98.63896117534189,4877
41d47d98-ead9-4b71-bfe7-87e715f2bf4c,Healthcare,0.22382374459319865,19,46,370,796,426,86.45524861775796,3976
204dd6c7-7ba7-4b13-b101-9bbab6106127,Residental,0.3686879279869225,46,18,354,1280,926,31.460774169823218,8835
cbcac8e1-9fc8-479e-9f82-993b15c7af24,Commercial,0.8981951206713896,47,24,398,804,406,39.06481604162656,3653
8cbc3f44-732a-44b4-aa8a-01ecb768717f,Residental,0.7497799715116357,47,27,514,978,464,81.82050448612473,9850
6354fa11-8649-483c-9790-1ede0d87367c,Commercial,0.20301343374799108,4,4,103,1095,992,39.45211051162586,7598
51332673-76c0-4d49-848d-16e53a178c41,Commercial,0.06145613106478065,1,41,125,484,359,99.55636491683372,3848
e9e4a120-806d-42a7-917a-00823e978801,Educational,0.6228522514239229,17,48,332,638,306,61.33321127335869,1103
310dee10-afac-4dca-a5b0-58fccb19f0fd,Commercial,0.9414070302274281,27,43,15,746,731,62.52328874774335,8329
6b50c2f2-1d9d-4ec8-9701-cec17fea7715,Commercial,0.2204275431115783,17,33,480,1034,554,61.58287528301787,5015
1b17538c-cfda-4438-bb46-7f5e106cc8e8,Healthcare,0.6635131233221332,20,10,477,649,172,68.16366578310968,8376
323ca4a4-e743-429b-92eb-118b6ecfcfa4,Healthcare,0.6375407664807802,15,44,119,310,191,16.190105368425627,4950
9413cb75-d213-4981-a787-7bda5e9f28b2,Healthcare,0.6134392137440147,15,14,639,1090,451,50.01140482792988,8486
b24402f0-fcc4-49c5-89ef-94a1cce8683d,Educational,0.6560014877228723,22,31,630,1309,679,45.65550233539074,3428
260a06c9-2343-4913-9990-5b07d07cfbb9,Healthcare,0.4858759467713931,13,25,239,787,548,97.73467901322535,1974
3fc06730-091b-4411-9573-7c435c79e42f,Residental,0.6898329303728336,6,43,479,555,76,73.90503051654437,7023
8384728c-62b6-4224-8da4-8ab2b74228e4,Residental,0.6244723877801408,8,35,588,704,116,37.53134151360632,8144
6303c212-7c6d-4bb0-8173-40a7ee17f4e1,Healthcare,0.937798760817503,29,2,713,951,238,23.559185168209346,2807
208e3885-d1f3-4354-a382-d78e1fe47b26,Residental,0.01867083043314255,39,22,501,1357,856,89.90772157918263,1794
8955c5ee-f5d4-4360-9268-525f60aeb480,Residental,0.9056465793339105,11,30,129,138,9,78.08165454333636,9413
652e4a7f-809b-4564-9302-bed8318ce128,Commercial,0.3183695575227864,27,33,645,1324,679,83.81219094160903,7613
ca09c110-181d-4353-839a-880c784eee3a,Healthcare,0.4422244275459354,7,30,79,771,692,33.210935619208094,9675
90b976b9-a5a6-4665-ab38-6907314c1d5b,Educational,0.6885991964882108,33,37,353,537,184,31.152106494365448,3956
75ecee6a-d0fe-497f-9238-3c21961de724,Commercial,0.8906472305684681,25,30,591,653,62,95.02232125703146,7898
16b347a1-6ea6-47a8-b847-5767ccdf46db,Healthcare,0.857352311466782,26,35,693,726,33,48.67768423258096,2003
2c93e4c4-2931-4b81-a808-38a7f40f5442,Educational,0.2791643064037074,25,6,406,522,116,40.717299671596166,7795
c38096b2-c345-4150-b2fe-e256c52b49e0,Residental,0.41582942893961483,8,31,200,1033,833,82.09377978923861,4052
528eb0a9-952a-47dd-91f7-4e8bf26090b4,Commercial,0.1031354149507181,28,25,90,1186,1096,11.877923246019092,9613
aac2c94b-9a51-4d99-8b03-c076584ab522,Residental,0.162132798920685,44,49,372,1093,721,61.82605014803951,4218
51fadf59-b56d-4d06-9262-af779b8e4d00,Residental,0.664176918909741,33,39,600,1173,573,63.82598642246373,7314
a151d8a4-86be-46c1-bda0-5e957bf9909a,Commercial,0.24876275495552613,33,4,569,743,174,94.38387081957528,4011
6e97d0b1-22b0-474e-9816-c206cf2d8875,Educational,0.3897862561117834,50,49,385,547,162,16.80554308100869,3785
18b5cb1a-cc20-4a69-ad27-b93d5ddfb125,Healthcare,0.5979052727544799,42,2,128,277,149,97.88842066243538,6507
a47d9c24-8ca0-4e75-b670-29bad0d37b8e,Healthcare,0.41285959733700794,35,26,62,1130,1068,94.76321599638644,9090
b3ef5975-4862-4787-bb0b-760fe298c8a4,Commercial,0.4593950193796159,5,50,346,1115,769,35.26811758115832,3459
ba9abd0e-966f-460a-889f-00d7091e6ea8,Commercial,0.17990618535264968,18,3,57,145,88,72.8813178993915,7849
be87f961-ea4e-4ead-b223-91f5a8fc6234,Educational,0.9610760112703006,17,1,658,848,190,92.68285135126466,2477
41cf7dd3-6c22-4bb1-a887-069caa33a886,Educational,0.11484435835172269,28,22,16,405,389,30.16131055861361,4217
7025a7b6-1664-40be-a283-cd368254be2a,Healthcare,0.4542329389652693,1,32,316,984,668,76.78692152925763,1704
e78c67f1-5b95-4d1f-9049-2bd9b6ee0e62,Residental,0.7528889354186219,46,37,528,1118,590,36.14376334093788,3398
17861c64-2998-43e7-8a89-6134583c0f48,Healthcare,0.4839501321395214,2,29,655,1211,556,93.72029040578572,1398
1aaec14f-88de-470a-bff9-683d3971b4a2,Educational,0.21704011575069304,50,50,352,748,396,24.49920452893243,9015
6cbe5f84-73be-4035-af5e-7c66d659d518,Educational,0.24410278618882664,38,40,145,348,203,37.05782027730628,9865
50d7967b-a699-4755-9e13-9360ba5394ec,Commercial,0.5146562758871112,49,50,209,967,758,40.57388649541858,1078
7bc6d850-ade4-4c7a-8b6a-bd525ac5d4a2,Healthcare,0.6802790759604198,42,41,1,564,563,91.26625254844919,3395
c89d97f7-b725-4d4c-bc88-5def3b380cce,Educational,0.6569220689215162,43,41,590,1380,790,21.518445576308068,3166
72fbc055-64e4-4f54-a79e-4f1a37e82f1a,Commercial,0.03914405611374505,11,4,683,1215,532,44.74190466800927,5105
1aebe9b7-cbfe-4dff-9c4b-2f4a15cc01de,Healthcare,0.8339561615572825,46,2,665,1263,598,58.17123028573929,3689
ecaec7f2-d4d3-4de3-8874-c1a798bcd3ac,Residental,0.3641859184857019,22,29,594,784,190,97.95157647509939,1320
3baa6550-83ea-4583-ad42-35e0e72e8a2a,Healthcare,0.7763298080888861,11,47,715,1294,579,59.95237498309484,6465
230cc909-5ba9-441c-af3a-745772c836db,Healthcare,0.5774861024827727,41,1,621,951,330,41.06578390755503,1403
c557373d-0447-4e6b-b140-6f5e03e4610c,Residental,0.8341064256292358,7,47,596,857,261,69.9128569036011,9786
820f1f84-1a34-43f4-809b-15a9ceb2f8df,Commercial,0.15473998257273658,28,45,6,1333,1327,10.09776632105422,5275
6ea36f61-f06b-4dd9-b2f3-93e70b0d1b93,Residental,0.9561555194800566,12,42,470,1050,580,46.53517278673338,2209
f7e1fbd4-fef7-43b1-9a9c-339f73cde20f,Educational,0.3051301395998268,34,39,669,950,281,76.2375451269911,9433
4a9a89fc-c141-4b61-b4b4-94e4e416db8f,Healthcare,0.7500607968295914,2,34,645,925,280,72.69555039146903,3389
7621d6fa-7b96-4807-b29d-f7de98894675,Healthcare,0.12739437588510105,4,25,171,1271,1100,31.391609418780977,2850
95ddaa8a-9bb3-4e06-a42a-bae89a45d78c,Commercial,0.673300086157321,32,6,570,601,31,18.647267239397877,9368
3d490921-cead-4f8f-b46a-6a808f3a1fda,Healthcare,0.9708887051200042,9,1,557,999,442,34.89157288574843,7742
3e040e63-975f-48fb-b7bc-23e68a991bcf,Commercial,0.2774186302766246,34,10,191,851,660,12.569778915789142,8679
4bc00255-44f4-4418-b0c5-1e1100d43502,Commercial,0.8450871370450073,32,32,628,1392,764,40.145312693034185,2818
cd3fbf1b-bf77-4f18-b017-4ade43f83842,Residental,0.11076341855305571,35,41,717,744,27,80.59251946710881,9913
c3dfb840-2198-42c2-8f85-9c453da465d2,Residental,0.191929913930173,11,19,68,95,27,78.4317403114807,6455
d2f8acfe-f592-4cba-b319-3dade890aa40,Educational,0.5353322032810698,45,50,298,336,38,25.79242662817181,9450
7a164c4b-a963-435e-88c7-3bd9ef2559f8,Commercial,0.296756923738004,37,3,556,925,369,87.09403755769523,1282
03cf9e18-04e8-45d4-87f7-d9baca604b9c,Residental,0.5151075144237459,44,16,504,1289,785,88.74157783478252,8149
ade5acfa-f93a-4fee-add0-cfd264f67dd5,Commercial,0.7258786424935678,34,48,328,880,552,52.293431637324716,8906
86b9f5e1-8471-4605-aaf6-d05822092146,Educational,0.08657673405846811,44,31,246,639,393,85.8299357202605,4572
3bbdf204-9186-4776-a11e-296e41613bdb,Commercial,0.5675313513049929,16,9,217,1169,952,60.477392084017424,7571
e921f126-1425-4110-8ef1-f7bf7135fbfb,Educational,0.15388090006292598,42,5,407,1080,673,14.867745323842264,3815
c05432ad-f386-42a6-a61d-7196b8219ffc,Residental,0.8175843487603773,30,8,210,986,776,56.96360020850218,2855
e68e89e5-2096-48da-a0ae-978b31945afe,Educational,0.34237266699024294,32,37,86,321,235,24.756209608442212,4828
572c6b2a-bfc2-4d82-bb3d-d5f981b54ea9,Commercial,0.433885058231426,13,3,684,1092,408,50.25947442426564,6460
1fc0e842-4f3e-4ec0-ba2e-af7fa69d459e,Commercial,0.44576147450034176,15,29,432,1219,787,66.68477620940783,4265
47ce007f-0f5a-4838-a474-09fbad149bb2,Commercial,0.5381541875498472,44,34,485,1067,582,43.202826430281306,6448
5b2932b4-5ea5-42fe-bd40-b6ec845c9ef1,Healthcare,0.6894666330003453,34,40,543,591,48,50.705472402355205,9706
a160fa8a-0b0d-4b0e-987c-750657c20936,Healthcare,0.062491012203804375,43,33,596,977,381,49.18061740534366,5659
a300838d-282f-4b0a-b8c7-5e28431389cd,Residental,0.0644063319176329,44,27,590,627,37,47.84098045964106,8570
d6490a39-0b8e-4828-af4f-782a5fb8c8ce,Residental,0.06178163809156634,10,3,461,493,32,42.98960978674524,9971
baa55ba4-6cbe-4fa6-b2b6-44b019c9fd1f,Healthcare,0.44958870804807727,14,10,523,779,256,82.10869597722181,9751
a6ffc9e2-4eb5-4612-9160-82a97dc30f2c,Healthcare,0.05090324505504551,32,42,386,718,332,21.069072231979433,4586
6db8c2cf-8624-4fbd-b611-67156ed415d1,Commercial,0.23987316151175675,1,35,617,843,226,84.52368596620953,1599
272b74ba-7252-4cbd-a674-5a88956dc52d,Educational,0.6599674057882017,49,12,275,286,11,18.754618810714696,5908
bfcb5574-3a92-41ea-a24c-02f28cfe36d7,Commercial,0.2886189689386368,1,16,131,833,702,57.455600835504804,5133
f1bb1acc-0fed-4eb0-9e39-63458d58adc1,Healthcare,0.6082467560438602,8,32,204,301,97,99.63938784406777,6823
a29d854d-b0cf-4ea9-a002-df0466e86882,Commercial,0.3754479863969993,17,32,442,697,255,51.527979976492865,4732
ccb112ae-5099-45fb-b1c9-14ee2d0c636d,Educational,0.6852971439355708,39,21,240,1068,828,52.50800423925382,1592
38c04580-c3fe-498a-bd25-e12f989d22cb,Commercial,0.24521280927078748,49,37,673,936,263,44.95089075883416,3996
c2138e99-6d62-4fec-9291-3ed7775e8704,Healthcare,0.515784219926492,36,9,311,602,291,86.10846828666999,8224
d25c54eb-1bad-4bb6-92b6-847ed5bde3e4,Educational,0.1980073734737694,5,24,298,646,348,48.54898624254247,2824
44e250d0-421e-4a88-9666-86e6ec739945,Healthcare,0.3756255869051639,1,44,629,826,197,76.75687492224465,8097
d71267a4-c992-4bc7-8a12-85a55bc14ef9,Commercial,0.6492290644687672,43,42,402,898,496,15.733937385941967,8298
bdf7e0fc-7221-430a-9589-17f8865456f1,Residental,0.16495470065963824,24,10,614,641,27,98.63646013419185,2111
45f078ab-39cf-419d-9f87-8ee503ada459,Healthcare,0.7861334483498883,45,18,693,1304,611,74.06103140226664,1793
2ee6332c-845d-4c0a-8c5e-cf8a1db22073,Commercial,0.2454464498496266,1,38,168,1144,976,83.08767118154687,4338
3db91a8e-b28a-4695-b333-151924b8505e,Commercial,0.5245778322792065,19,16,611,906,295,86.91562048397225,7373
1753ca1a-5546-4645-98ac-e5e898ed69f5,Educational,0.4915187914397279,35,38,643,864,221,60.76274545418277,2055
47d379ce-54c8-4802-a090-42c09dfd648d,Residental,0.4779592904245614,31,20,6,577,571,57.938529948911764,4720
aad71678-71a1-4316-b143-40a66af66569,Commercial,0.22413695432827008,44,30,101,695,594,29.528881520030225,6870
a872bee3-ca55-4582-9ebe-f2de0b6a2aa9,Educational,0.04870705942929565,4,18,136,1336,1200,21.871585744141193,3292
7046135d-1bd8-4f60-8b51-0dc2ec54d09e,Residental,0.06262165780344076,32,47,149,265,116,76.87718272025819,9723
274439d2-05b7-4dfe-94fb-1c4857fb5d9f,Residental,0.8238182507244068,31,7,616,623,7,32.03287025097062,9196
e8e003eb-b1c9-430c-b4bf-af66edbfbeb4,Residental,0.6710713844251499,48,42,241,859,618,64.68003454950049,3697
d53cabca-a84d-4bc1-a39b-031563005f08,Residental,0.834483892818523,18,47,192,1365,1173,45.20096687411287,9242
9a9058d7-8699-49de-9c8a-23b7711a7daa,Residental,0.9852576138372042,36,13,508,616,108,47.10327785229748,3707
40397014-9346-4d0d-ac52-9d798b7c9879,Commercial,0.07751021620355014,27,42,251,544,293,52.76236420561446,6263
3d0342bb-4d1f-4021-82f0-a24f2f51bb3c,Healthcare,0.13203046879219826,50,44,185,1292,1107,82.06035853466973,2702
4df474fe-708d-4f92-8e56-9c613d8163cd,Residental,0.03404358783046291,46,34,705,1341,636,19.214728669021333,5185
8f1849a7-a27e-48fb-a962-28fbbe49083a,Residental,0.18847386687802314,15,37,139,729,590,56.58005380488392,5261
6f7057d2-3fc8-434b-9434-bb0da2f9f5c7,Healthcare,0.3752200907587927,31,43,436,1255,819,96.61754899738214,7519
4c474cdc-59a8-4def-944c-9dbf1008500b,Healthcare,0.04089159212476212,49,46,203,959,756,37.26932574191308,7339
2e07f1ca-3db7-4de9-822d-4155b9c98f85,Commercial,0.6403005215868515,8,11,118,1382,1264,71.13014558864187,3623
5795672b-20e9-4d6b-9d8d-ad4c4103f4d3,Educational,0.18623390916305183,2,37,466,538,72,17.461993664494692,4508
773332dc-1c4f-46fa-8c4b-4387c0e531b8,Commercial,0.010609041315149281,45,33,652,774,122,62.68581416994704,4454
1622f0c7-ceb0-4f9e-b644-f4c9be14979d,Healthcare,0.6335132769917626,40,47,385,1430,1045,68.40901732148521,5075
97adb3f4-b03d-490b-993b-6547c2d804da,Residental,0.7619340096176065,9,20,310,1120,810,89.47666838300825,8026
b17b7d94-405d-482a-8de3-1c230f35b9d2,Residental,0.023449466867822788,45,11,303,914,611,62.31883167986506,3324
93013693-abea-4ee8-a128-20a35b8bc4a3,Healthcare,0.08811345877305077,30,15,698,1320,622,82.41703622756856,8820
ee06e4d2-f9ef-4f43-86f5-a2e9cdbe07c4,Educational,0.49578656179365677,18,5,135,1436,1301,31.242274161949126,3187
5356f0a7-430d-44b6-8c0f-13c036ec74dd,Residental,0.5028484088614704,32,4,598,1268,670,53.44628574930851,5278
86081613-b1a6-4d00-9ebc-40ec7eed4b68,Educational,0.5277306922569616,12,4,50,724,674,36.721755894228046,1180
a1faf5c4-8470-4f06-9d5c-6b3c2c180fff,Residental,0.2827768931063115,6,24,208,1280,1072,78.38763077365262,8740
2f5ba3fa-0d95-4925-a871-341adf485708,Healthcare,0.28671778505063616,26,1,229,408,179,34.96753357087513,1095
199303de-9335-4f15-862c-d786f481b9c8,Commercial,0.16296048380688077,22,36,158,1048,890,91.21002215957476,9036
e33be04d-f4d4-49c5-b9c3-10d56726d142,Educational,0.16766136676293508,29,43,502,819,317,21.89226036836084,1352
266c977e-e663-4dd3-a231-23d2911bace3,Residental,0.24004766863797267,48,23,530,1226,696,51.28577663022502,2713
d1c90617-5887-40d9-a8d7-a3c2f12f11a5,Residental,0.821432779130434,8,10,242,1286,1044,96.69145613307928,7499
8f62985a-5960-423d-b051-3235180a2bcf,Residental,0.5993520905094029,23,6,352,1227,875,49.90322952244728,9173
f523a646-1d2f-4f41-827b-e7edabc9c70e,Healthcare,0.9611233968698337,15,46,544,1023,479,70.64168007681226,1291
0235eee6-18dc-45fb-81f9-8a00544d5fd5,Commercial,0.8494602278238019,48,28,277,984,707,77.43134854947645,7238
10bbbeb9-cae5-4cb3-820d-08790ccfceed,Educational,0.3641589474386787,29,42,168,1292,1124,52.83097922004249,5236
6aafad2b-c602-40bd-a395-306c749d52b5,Healthcare,0.60296258074895,24,20,519,527,8,27.311727060502303,3194
499fd65a-1f65-4795-8660-b275828a3e5b,Healthcare,0.5292313388065881,39,47,686,828,142,73.73173845435127,4550
a707f288-adde-443d-8373-4bffe3e27d76,Commercial,0.368436760975979,6,30,440,1073,633,53.79833503015438,4347
18d84576-e136-42c2-858a-de79e4f94126,Residental,0.9075078678974932,15,33,285,648,363,98.30613882207517,5512
515e5a58-5a22-4423-ae6e-d1ed7e42d838,Residental,0.737798606608386,8,32,470,1076,606,41.27734835078368,8166
c7f136cb-a8d4-406c-aff5-c1590f6dc8d7,Educational,0.24925873624235062,48,46,545,707,162,34.57208443053558,3558
3385eba9-32de-4c41-8562-3c5766a8164c,Educational,0.3933983930361378,2,10,512,1287,775,45.019181349802516,9438
c5cd0508-e628-442f-a19e-b12449c312d9,Educational,0.7808461439549392,5,49,484,516,32,76.88563785200138,1133
a5ec0965-7bed-4474-a197-118447b239a0,Residental,0.17283239927330596,22,48,685,695,10,73.28659995415467,3831
70516435-161c-4622-8f9c-ebb3d8304e34,Commercial,0.33239761708276505,42,42,651,726,75,22.129987526781804,8941
52fe427b-684f-4c99-b025-927f096eba75,Educational,0.4308623141683574,23,7,251,404,153,91.15452393159546,7111
95c396c6-b7e3-47fa-894d-9a594afab390,Commercial,0.08770030452104216,29,15,10,1135,1125,88.41091852872135,1401
decf19be-fcf6-477d-b9dd-e62952b1a292,Educational,0.9433772404756339,4,46,9,1282,1273,74.74772798653382,7623
9489d8df-af66-4d1a-bec7-a6d626eccfc2,Educational,0.38735754318965765,19,22,283,1033,750,60.03171958971132,6421
42bd1d61-894e-4444-bf69-74ea3ff4bedb,Residental,0.4417793570844515,42,34,620,1262,642,96.63494029639587,8562
ec281096-a1ae-4312-bc67-780c097f6a01,Commercial,0.9637439617127588,38,34,535,1016,481,89.7133042562679,6215
f968af52-6343-4b2f-8f15-08f500912add,Educational,0.09663441491108504,39,39,560,1360,800,26.920186495517274,6695
34a3a1c4-d02e-4dd0-84ea-919e401de123,Educational,0.3194912850714481,7,6,512,1349,837,38.91271197188421,8324
3daaba6e-a0ae-4e8d-b7f2-129c382a463f,Healthcare,0.8820924892907064,45,45,117,395,278,68.01489353816201,9012
c2034602-4e7d-4cfb-a442-d20da13c7f06,Healthcare,0.1721857406686984,9,5,399,1195,796,31.60780995319324,7967
8c4b4603-2bf3-4af4-9b3a-421efa3cb818,Educational,0.2015382357621317,31,23,114,1202,1088,79.74187938379515,3429
2c13f46e-2e42-467c-9028-d6ca699dfc80,Commercial,0.7423115539132772,16,2,593,625,32,68.89084150420456,4911
316fe5ae-21bc-4475-abd0-dfdbc1c5adc9,Commercial,0.11182082968052831,43,8,702,906,204,75.97997847022162,7526
46a8d4d3-5ef0-4f5a-acdc-e0c38aae9707,Educational,0.8110560343386758,32,50,70,394,324,75.06758391604976,2424
2f433a8b-5fe1-4e3a-8e96-c254ff25847b,Commercial,0.5380417456113228,47,49,220,944,724,82.94799345626582,5800
b768d566-b9f5-4910-8a63-cc19505ea87d,Commercial,0.3722209487494954,43,19,151,1418,1267,44.541704181270404,2654
cb7d289e-0790-48f4-b517-81801679a181,Commercial,0.049190448674480636,18,45,201,1402,1201,66.00557488097255,5343
6394f302-d2d7-4f9d-8c26-85c4545b8377,Healthcare,0.08764728309502512,38,18,463,1432,969,52.286516207156815,6051
85961084-20ae-4baf-af24-1eb6a238fa8b,Residental,0.5230571035413595,42,9,428,774,346,37.788364054895354,8555
b75e46ad-b900-44e7-81dc-a826d0738346,Commercial,0.811470979425318,39,30,394,1163,769,94.42167974111366,6821
2c371145-4edf-4da3-803d-ad9298fa7f1d,Educational,0.7321976980769206,36,47,314,1214,900,35.74122000293204,4614
c06dbff9-d250-4c25-8100-644d37d39877,Healthcare,0.08155286144697504,48,39,383,984,601,14.785832104447408,4391
b580a13d-1c59-4a97-8bd0-8cc92bbd31f3,Healthcare,0.6724440035659015,40,3,25,1096,1071,80.2114529158473,4037
68266f3b-8cc8-4ae9-a8ad-140105262af5,Healthcare,0.4060963381980238,39,25,515,528,13,51.211244917517774,7305
3fcd3277-64e3-41be-81a5-f40fb84e5116,Residental,0.7855161780326835,17,24,649,1170,521,99.45964843062066,4059
78e8c763-31f6-4302-8ca7-92981cf782bc,Commercial,0.2635374810143112,4,49,574,736,162,58.26666662497785,9137
ee4fca72-4c81-40a4-98e2-d5230a36c56d,Commercial,0.2236313270122564,31,44,376,390,14,62.66352463509756,7561
ba7a5590-3295-499f-8fe1-b453b4bbc541,Commercial,0.8952031864767735,6,31,153,772,619,63.348294348052384,8559
e61ee1d2-0448-4673-82df-8baab0c60469,Residental,0.4199022410839067,16,3,90,659,569,82.96578799429756,5211
4076f8bc-ebe6-4528-bc3b-e622b5ebcb1e,Educational,0.08117981003287711,28,8,146,816,670,30.157326490934874,8398
4a53088e-f369-4f9b-9ce3-4ddb9b9ef2b0,Commercial,0.4121943683472977,23,45,492,719,227,30.371285612941588,1925
b5cd31ec-fa33-4de8-87f4-d38625a12738,Commercial,0.8254902868513667,27,30,603,1172,569,44.53089368373159,4220
59edee0b-1c78-455a-a510-56c93e7840f0,Commercial,0.8768648209324497,4,45,376,592,216,48.88395192886359,1167
061343a6-a34d-463d-b507-8e0aab7b38a9,Commercial,0.4813566658513806,43,4,628,998,370,19.836924157139304,1920
86236326-5fc5-460c-a993-3dbc8fc75804,Commercial,0.6830737094373762,16,47,129,926,797,60.10163719519477,4458
31aeea1e-017b-48c5-a30d-cdf736b8ee7e,Educational,0.08672118720104316,17,10,132,656,524,48.49963849489429,3698
4eb5bdf3-ef51-4fcf-a681-5ccbeb7a317b,Commercial,0.20741321544126334,10,29,691,770,79,71.30293567306303,8250
bfb77076-44c4-41c8-b161-2077727cec15,Residental,0.8945857895593639,4,7,582,624,42,97.76314392916179,7246
39dba4fd-8bf8-40d5-880e-0d6a877bde03,Commercial,0.7476312598707356,4,14,413,949,536,50.2252740169863,1241
7c5ffbdf-7ede-4366-8e2d-f65b91f53091,Healthcare,0.6494052700397859,19,49,5,708,703,69.90015563225101,2457
4820fc4a-bf46-4b71-a268-6e5a84119e50,Residental,0.28449171375332527,47,14,402,606,204,80.98637991024177,2433
179c7e5d-f337-4628-9db6-dc8bc48b0c79,Residental,0.5328513974553423,38,31,218,1423,1205,46.1727986497734,8042
b099cc68-924e-4a98-9755-d9e8b50d2b87,Healthcare,0.029410573962184716,26,32,172,1007,835,63.36022082431533,1744
cf4f828d-d270-4736-b79a-2feeccd051ae,Commercial,0.9699469375698668,18,36,113,252,139,70.15831426008192,4628
37bf9bdd-bfc5-4261-8617-15bba11da8ec,Residental,0.7269391288450872,26,28,681,1169,488,45.55155537075923,9376
55172adc-ed4f-4ca2-9509-98c9a9787090,Educational,0.9244573370735284,31,38,711,1348,637,51.12245647244949,3780
5352710b-c248-41e4-8590-0f5a35154eb0,Commercial,0.5241224487245691,8,41,245,474,229,23.942332993538372,4068
e6043b32-89e6-4fc8-a1e4-25b065ddb84a,Educational,0.45008415283855385,29,11,670,1207,537,51.03892289168955,8220
875eb9e1-e4d1-486c-a683-e6fc30f7c73b,Residental,0.3879141524680323,39,40,154,1336,1182,75.94198650221705,8361
c09c43c0-f348-465d-88d0-1a314091844a,Healthcare,0.4537123300092576,3,21,14,986,972,29.54852756370318,1436
7df8837a-700c-4a02-9346-b77959da81c4,Commercial,0.3139288926982212,6,13,330,1169,839,10.598563000820295,4819
0ed8e627-4a35-4883-8c95-59bf45c5878d,Commercial,0.3583386384366599,21,20,448,670,222,72.22628639439014,1780
03348c9e-9bad-4d91-8a38-2e41188b9996,Educational,0.8135948304018079,46,11,80,823,743,99.99830546791864,7358
a0a6a6b0-6f44-487c-bb90-fe38dda4ba50,Residental,0.20586190536240823,45,28,631,1150,519,57.26781024008208,4259
85500e6a-2e79-454b-ab03-5fe21800cd02,Commercial,0.9251031854622751,4,7,464,1431,967,60.542308597031955,8523
a3da84f9-3200-4da0-9e1a-286673208853,Commercial,0.15198198039390753,20,33,98,1385,1287,91.64018414516231,7384
296b5eaa-948b-4b16-8e0b-24fe41ef042e,Commercial,0.2167886499635503,28,7,360,750,390,81.7063274802451,2582
d5c7ba75-3f96-4a68-b7bd-83b557668200,Educational,0.19731454659930114,34,22,676,1260,584,86.07649884198689,2334
9a2db94c-a59c-46a8-a2d1-06ed4d829135,Healthcare,0.584657891038106,30,4,624,872,248,59.3319697874436,8619
39c20940-866f-4c96-a812-c67a00d075d3,Residental,0.3945208755710615,27,2,295,549,254,91.85942295980206,1564
5427d415-61e6-437f-b32b-2cf22bc8724a,Commercial,0.9156368294049129,32,8,530,1062,532,92.37107777279022,8307
c88ee6c9-25b6-4b30-a0d1-544858483718,Healthcare,0.5678922199888069,36,29,288,899,611,85.31054591540887,8915
8727d079-6878-4a46-8cd9-02d6a281a87d,Commercial,0.00013693987173979405,43,28,212,1201,989,18.221600107423576,4674
dc679b4b-2c90-456f-8e18-777005702edd,Educational,0.21566952058629874,30,28,682,1167,485,56.22855131537521,6132
e7fb83a3-353e-46d0-a5f9-e6d21b61181e,Educational,0.6154517507615145,28,21,582,862,280,31.551371797877223,7440
4b34e194-4f45-46b9-918e-8777f38ad2e2,Healthcare,0.1018611878962048,40,17,403,676,273,77.86589567649081,8170
85681d98-dda7-4f69-b3e3-e29c12025f41,Healthcare,0.9255837896448509,9,42,499,803,304,38.99580067248206,5442
aaa1b287-3aee-47e9-96f7-6f9c48aec5c6,Residental,0.6978533250792968,24,26,280,671,391,45.90680722275317,5245
304dc8d5-c975-4196-b57a-f9ad1772762f,Residental,0.9806428100272986,8,30,272,508,236,11.778649305498526,7751
56f92fa2-3d9d-473c-83dd-2f6303e7ada4,Commercial,0.34061875169868094,50,10,293,1052,759,97.00785425081018,4358
f79b1a71-73e8-4495-be61-45dbfc11d5b6,Healthcare,0.5612222155658473,27,1,107,691,584,15.03807014031173,1754
6c58d9d5-c4c4-4963-9641-f2d2d7c44de5,Educational,0.5758027459018068,24,2,380,1006,626,55.03142612797646,5751
0de01f1b-62e7-4cc6-b79f-e0a21ed1a1f8,Educational,0.11423526598427769,11,27,593,843,250,20.55385313397993,3810
f7dc5071-3727-416b-970f-3fe708652389,Healthcare,0.029130531446293406,15,21,456,694,238,46.65813244924111,2861
15a9f9ad-f911-4903-89af-d2ff4c8b9f1c,Healthcare,0.9030633292609578,36,41,207,524,317,12.490780232805859,8026
e187f36a-2be4-482a-a090-868dcb2b05f1,Educational,0.11704530724185991,14,39,199,855,656,29.272847394936388,9374
e136c62d-6ac7-42e6-b736-a6dbc179bf8d,Educational,0.8550561155568235,48,28,417,851,434,78.71871156140423,4908
b6323150-9771-4658-aeff-19a34602942d,Commercial,0.7606587228868376,49,1,337,468,131,10.453824098846173,7405
cd0f174b-ef13-4c4f-a369-bea871968ca4,Healthcare,0.8248683330079234,26,45,636,690,54,35.954080714449546,7115
467922c7-1454-44e1-be4d-62c127e89946,Commercial,0.07311117213961849,1,19,505,1397,892,90.02326024391087,3888
1d1d4964-abc1-480c-bc2a-b2e0b6cd3a75,Commercial,0.26145957875778214,7,26,36,1068,1032,46.46065409310577,9832
6d66d729-b4ae-4bcf-a2cc-00068a0a902f,Commercial,0.3095847697687746,44,26,475,770,295,27.83646302187943,5667
5006e1d0-9940-4914-a61d-4dd19ab58b65,Educational,0.8898969834840856,6,27,230,1296,1066,66.31795173360601,5421
93118833-1081-4e3c-939b-30a3885547e9,Healthcare,0.276780966954393,12,27,709,1074,365,96.00160275487713,1657
68f5b2d8-63ea-4dad-8218-f303476b263a,Commercial,0.433329551539438,29,50,605,1417,812,70.65326199121108,5404
3e5cbb6b-6c91-45d0-8382-29545d16d3e4,Healthcare,0.5796944681151905,38,4,279,899,620,46.21835883790665,5382
bf0c4f37-7009-472d-bad0-852769efb7a0,Residental,0.4294306678874823,48,8,145,649,504,20.24874094519645,8016
461ebcee-d766-465a-9976-178a44afddaf,Residental,0.8076122142380198,20,14,614,1196,582,30.339350515511097,3830
d446e8ee-98ce-4f44-9647-efa0c18277ed,Educational,0.11128516434466973,35,36,209,454,245,48.31890163100904,5161
45cf96a5-a328-4270-bb5d-eb8d3559dd4f,Educational,0.19019307887230696,35,25,97,724,627,84.48548257167684,3070
614458e7-b146-4154-8607-0365de689a38,Residental,0.660112174612722,5,17,182,978,796,39.22393477529146,6426
d873c225-9a8e-49eb-9ac9-eadbef8195d5,Residental,0.45475849078500163,45,29,546,899,353,42.20449227594178,3779
908f36b5-5a1a-4608-92d2-85545dcdf683,Residental,0.9263877359299877,34,9,525,990,465,59.95780454011669,3442
e47b9efe-27a3-414b-8f03-17438c5aa094,Commercial,0.42710654105888446,13,19,314,630,316,11.159742811033151,2091
81de8619-e73e-4e27-9d3c-72ddf145f88f,Residental,0.7124640737372455,47,5,558,1374,816,12.572414225257258,1929
6bd6822a-88d2-42b2-a4c3-bdd5b20f8c93,Healthcare,0.4898117386588312,39,16,171,630,459,64.24532945711009,9133
24612792-28a4-4ec8-8b7b-84bfbda54028,Commercial,0.9355402988907258,27,11,556,891,335,66.46878833204818,2703
14bf6dbb-3667-42b4-bf70-97e737398e34,Educational,0.07206724884643023,27,42,574,863,289,82.1176591981794,1054
02ded389-cc62-4d2f-a34e-c5394e6691c1,Healthcare,0.26857739639951383,28,35,439,646,207,22.769462801816818,4333
ce1223c1-1471-4239-8d2f-dd4486ea7d6e,Healthcare,0.6204062336481985,11,47,469,1028,559,46.477893822919725,6407
98097aa4-c504-41e2-9bfa-8a7b84c12dc8,Commercial,0.7654336574960319,40,33,273,731,458,36.51896303596068,7040
d76b9334-6994-4c30-9e76-beefceb26358,Residental,0.43631202831137006,44,14,79,332,253,65.04703395968278,3998
45067f71-5a63-4780-9ba1-85a8a11c743f,Commercial,0.5247078814504995,39,9,398,565,167,71.6828393371375,5075
d9efb8b5-3bfa-4150-99f6-a3f9593da17b,Educational,0.3876286247908193,40,29,184,762,578,49.15408114354851,2651
e3bd5c56-18d4-4122-aabb-4ba9bbff7c43,Residental,0.18585491269535748,25,20,553,682,129,35.61764142531606,4138
091b3dfa-e64f-49a3-bf50-0e38c6499c3a,Residental,0.9022945136111757,15,10,155,1049,894,90.2534671350564,6235
f15e9265-d1eb-4549-866a-396fdf3c78cc,Educational,0.8482709538224773,3,3,143,1386,1243,86.65189034885454,6596
e0bff7df-e76e-4b0f-af45-9c0b2b7c0313,Healthcare,0.9992725270206407,26,29,165,934,769,37.59777224509215,8161
771e6540-7951-4077-9407-1bf52377388e,Educational,0.5235059011864047,35,36,699,1247,548,53.649995664045555,2244
6a2fdbab-d4c4-46d1-830f-68c77c95af80,Residental,0.5095047320907382,23,44,573,1432,859,76.84473709354157,9947
3f43a496-bf3d-44fa-b8b7-dd64ff6ee783,Healthcare,0.8872521991282126,41,50,582,1219,637,98.86014232542819,6956
ec25674b-e036-4482-8040-4dab7cd3f4b7,Educational,0.3714534924810997,31,14,160,947,787,91.96264033748473,6229
620b5243-2444-42f8-94e1-d90b79094437,Healthcare,0.8510255317193335,30,6,265,1096,831,15.56032172875587,5875
6200f56f-dad9-4f7e-babf-bbf13d0cef24,Residental,0.522830345709355,48,36,228,1270,1042,32.213157466965,3906
673860a5-587e-4288-bde2-6cc26a8d7411,Educational,0.9007039512475029,27,35,129,1068,939,92.3516351153218,3540
44a9df50-a33a-4fdd-abbb-8f68e09385f2,Residental,0.39406595821809054,40,22,702,821,119,78.05214145790657,9102
fa708055-209b-47cc-9700-383d3690692e,Educational,0.6519654900425217,43,42,707,1140,433,64.90585603813116,4328
73ae6482-aa0b-4a49-97af-82eca7fa6e9f,Healthcare,0.6146388828182964,2,48,635,729,94,95.96289057899118,7072
d89399a3-9ee9-45ed-8c5f-fd30f8e6b647,Educational,0.819949553849811,7,10,433,1245,812,55.876721684687574,5644
fdffee35-a541-4dc5-bb4b-bb57242b8b32,Residental,0.808026748055149,13,10,219,342,123,68.73005158602314,8561
49406527-e769-45ad-aa60-4f008558f6cc,Educational,0.40988905241244733,31,35,177,612,435,45.54556732229017,8697
4e8b3b7a-ba5c-4387-86de-93da9e31b539,Commercial,0.5136260979199705,32,24,151,161,10,78.99214141372374,9023
2edd89ee-a370-41c9-9a95-21c08d869b80,Educational,0.5559571516101821,31,36,344,1062,718,57.64388328973131,2512
f6b14e5c-a015-442e-ad3b-2c8bef5db052,Healthcare,0.27075467752743954,38,32,250,1333,1083,11.883280615244248,6121
13a39e57-56ce-4591-ad04-53bac898c1cd,Residental,0.339849380542976,37,38,48,716,668,47.68381596511468,1473
7d0f4c3b-1e46-4d70-98c5-95e7e852b101,Commercial,0.11755111689401809,32,27,684,1061,377,68.85084506512246,8743
b1401b22-7bac-4b24-b77d-24d678410bf1,Healthcare,0.5374053172185213,36,12,405,1438,1033,44.124187908643115,8347
918f561e-b725-45e1-8647-ac44adcbe2ee,Commercial,0.634000450486235,12,11,266,986,720,61.963296702081905,1065
3b281648-a853-4277-884f-e374b14e548c,Educational,0.6903141947097696,13,16,639,874,235,50.75672183148715,5109
8ec95b0b-baf3-4a3c-928e-b7ef0c037c3b,Educational,0.448604896160845,25,31,190,614,424,21.813665626588588,6866
94ec4144-00ee-4c4e-bd42-8b40e578ce95,Residental,0.27311039906522816,43,8,442,1002,560,80.4463496264772,7961
11584ba6-05ca-49f3-8572-af41b4f595b4,Residental,0.020115424235873536,16,11,256,1245,989,71.66758650740937,2918
66c3b37e-24c7-4d23-9ea8-900b50ceb4d1,Educational,0.011599496282828636,26,12,504,979,475,91.3916423990032,9887
32f8e480-a316-4559-a661-9fb99e93813a,Residental,0.20594683084391774,47,30,383,1100,717,94.80884190492193,6780
34b44ef2-59db-4340-b910-a77f97a98423,Residental,0.6350087673691395,10,49,704,874,170,25.07578992310008,1814
65fd4602-07cb-4c6a-ab60-acbf76064c46,Commercial,0.5082685621899282,39,24,449,1311,862,79.41814971203368,2520
09f3945e-ef41-40c9-be3d-09df4a924e8a,Commercial,0.6138616463193878,42,2,256,816,560,37.103030166805674,3378
f770af2b-5164-417d-80fa-96fa89a9e718,Educational,0.22541750093651436,21,46,503,764,261,53.61580861505086,9113
045104ac-5be0-4e0c-a204-7a61a47c7770,Educational,0.6001327185532123,35,10,216,568,352,23.535548681807178,9542
a17d4f07-d7a3-4c51-a1bf-10a346e853b1,Healthcare,0.32846998065175004,5,1,190,455,265,41.86304241211421,1267
1d426e2a-0d6b-48fb-8ae9-dec8b82c484f,Healthcare,0.23888508822996535,17,7,556,1053,497,71.39015971706255,4505
d6c96841-dcc1-4123-8c90-cbd369b94ed1,Healthcare,0.732593814270235,42,9,257,1256,999,56.52888638296676,6100
2ee16df9-5504-4836-bb05-608d87119133,Residental,0.16386866157230962,11,43,237,1048,811,10.879261139838047,1264
902c764e-48b1-4fe5-9a66-15280ffab014,Healthcare,0.7473647148981691,7,1,684,1332,648,98.78080032706147,9344
9c24c304-7151-4925-bd20-9ce909f827ef,Residental,0.3480392506948241,38,24,198,613,415,38.365311114145385,4384
9aa3237a-d503-4d7e-af64-a19ef289aee1,Healthcare,0.4775825745872474,27,26,459,834,375,41.49888614961724,3836
3e3ebe82-8818-4d63-85e2-3280d1eab0b0,Commercial,0.7742400260985036,15,19,672,835,163,31.70774543086024,4328
497e0667-2e64-41e8-80e4-b7e53ad848cd,Commercial,0.7815286114191502,44,19,19,1402,1383,72.490443808685,5788
e5190cc5-c271-49f2-a0fe-bd4c7712e232,Residental,0.455249127561726,21,27,573,769,196,87.1542882914598,6684
40e452af-1b98-4c24-9897-18a4ba96cd2f,Residental,0.04623420330823247,49,27,625,634,9,22.233866403695753,9556
130494ae-e5aa-4695-a25a-4750a0978220,Healthcare,0.7092737912672855,46,8,100,807,707,80.03016209311187,3865
4a482256-93b7-43bc-8b85-b9552f176a19,Commercial,0.046704139157920266,29,23,248,1272,1024,54.16784092310581,5965
34b6b407-9e68-4379-affa-cd6fcec68771,Residental,0.7980113228606468,30,13,522,1178,656,26.883385991486904,2556
360164a5-93c0-49dc-b99a-be85437b02c1,Residental,0.13552147459754227,2,35,710,1165,455,48.277039910505465,5748
91cf148a-e2d2-4056-abdd-e80cddc0d21d,Educational,0.37608449214166795,29,15,86,1259,1173,19.49439326462314,9669
08b93ef2-6052-48a2-96d6-4982685d2c6c,Commercial,0.7472783708514282,12,1,301,873,572,46.43286370274084,7334
472a5e70-ade5-4960-b8d7-b75bfb8e6a06,Educational,0.06569174271208045,37,28,559,1201,642,92.22677784670024,3303
bc3b78e6-329f-4545-9294-a50d55ac1ef1,Residental,0.9359409933988759,50,28,225,1042,817,75.44299553576468,5253
5ad81fa6-a973-4f5b-bdba-3ec82cb2bf3b,Commercial,0.9898081915985689,46,47,271,833,562,70.55990135735195,2229
bf0ddcdb-1801-4bf4-9403-0d8988f6c8f3,Educational,0.8230056038129009,25,18,288,966,678,39.38515260122536,4793
f010c2f2-b257-4f2d-adb5-e2bcbaafb810,Educational,0.15904081239510703,39,25,684,1416,732,66.5333339891426,6668
e6965839-f0a2-4202-8ada-f516c462ac7d,Commercial,0.0194469210310656,11,1,622,810,188,49.921836103990316,8700
0c838dbb-81a6-4e3a-85bf-948f0162a88e,Residental,0.4673844362683188,16,38,65,176,111,12.870012547977314,6975
9ef274d2-fe1e-47bd-b3d8-3eb02e623782,Healthcare,0.24536317258739815,32,1,720,769,49,43.58842875197168,1435
4dfb51ca-50e9-4f9e-801d-5415b5e81cd0,Healthcare,0.5161304033630841,48,34,312,548,236,23.468387716204994,9248
a985fc19-2b00-43a7-99f8-b36c885b5346,Commercial,0.6890814168959488,23,10,497,507,10,29.451982734304494,3840
b736511c-7682-4e09-8282-4bef75829067,Commercial,0.21519440533253287,16,16,244,275,31,99.26114220908619,4436
7f28860c-be2d-40e4-8039-1e89eaa36180,Healthcare,0.08061738312768452,12,9,366,482,116,13.825226082814947,7782
0838eec9-1b59-46d2-942f-6b18f437ebeb,Educational,0.8730390436008949,17,11,466,512,46,99.19149343665586,5973
f444213b-d5ef-424d-b9c2-dd8e5ab448c6,Residental,0.24836288438598098,28,47,19,590,571,49.87748986793942,9507
15e5ea09-6141-4a34-8bdc-3b093ea6ddd4,Commercial,0.12193160527035407,21,42,705,1425,720,18.99851888526581,5419
8a89d4f3-3a21-49c1-bdfb-f715294d4a11,Healthcare,0.39184085279912095,40,20,515,1135,620,33.554593844361094,4132
23b3bb34-5733-41fb-9bfc-3273dd205d33,Healthcare,0.481160671743733,15,18,120,366,246,18.39930573015544,9042
864b61b1-cae4-4e24-bea6-41bc55f397bb,Healthcare,0.4072978285574843,41,5,190,200,10,69.94236679681393,1427
34be0f11-fd79-4c87-8d9c-715eb642728c,Residental,0.049868081628381855,15,25,264,909,645,14.728756566714196,7013
e4e704be-37a9-49c3-b3a1-2ee9872306f9,Educational,0.2201727468608572,2,33,199,1218,1019,94.71008991141358,3594
569aa4e2-9405-4c6b-90af-6bfb8c3d8d22,Commercial,0.448000890043758,18,37,404,1437,1033,27.65697036504162,8043
52f023e2-80e2-4a95-979d-71d6b49ea92c,Educational,0.1829408041107966,18,3,438,1196,758,95.64562147912713,7494
53defa01-0305-4deb-bcb8-91412800f981,Healthcare,0.032964227834297644,15,50,613,1085,472,23.6533149477938,3087
3915992e-9007-457a-b330-2879d153635a,Commercial,0.36084865054944637,41,16,8,618,610,62.44534637794189,3242
2cb4d151-53fc-445b-970c-15c5dc8cc77b,Educational,0.4866789101401683,7,46,582,702,120,39.537285881980345,8842
046b9206-53a2-41aa-bff5-42cf049b9166,Commercial,0.13988373414955013,5,9,553,601,48,87.17566682689842,7879
e23cb1d4-4bba-45b5-b060-0be354a8945b,Residental,0.23702609701367716,16,12,530,1304,774,48.87533003580673,2529
c044beef-4a87-4c2a-8aa9-38322beef7d8,Commercial,0.3713616806992336,33,36,256,1055,799,51.71431712802302,8495
dcb7ebbd-b593-4395-9597-020742f45ee5,Residental,0.5740476983367476,39,33,636,708,72,20.36306954864271,6826
ff93bd7d-98ff-4df0-8efa-60104ace579c,Commercial,0.7256900521917393,35,31,112,151,39,59.413764203540225,8642
74ee517c-dde9-4b6d-a0eb-2ed56ade1358,Commercial,0.827638769719566,47,9,422,1150,728,95.98255192725331,3904
935826a0-f605-4ebc-9614-43c75e9cdd85,Healthcare,0.14314640501550957,41,2,481,1038,557,61.07157113107064,4781
11e862b4-bda7-4944-b1c0-71176d32e5b8,Residental,0.47139856673249114,26,7,594,645,51,26.26266273554835,2667
5ca1b7a1-4265-429f-a020-55909d92a96a,Healthcare,0.3995784420442776,18,22,260,985,725,41.647075294427495,7867
5aac7b1d-bfa4-4182-be28-2a6b0397a189,Commercial,0.17164975327991594,5,1,161,329,168,72.72205120600917,2208
cb27c692-e00a-4434-9c50-c8c207444bee,Healthcare,0.6605094511238921,11,14,494,1017,523,42.64468731143005,7538
2748d014-9a86-4ded-b40b-2f33eaa399bc,Educational,0.3179638278514392,27,5,442,1144,702,87.58251550499565,4022
1dc1269a-78b4-4d77-abf8-21bd2af800e2,Residental,0.32692696145485467,40,16,171,233,62,38.92453991001537,3170
a3558d53-7712-4b14-af39-f7da9dbbd806,Residental,0.06609684377948766,11,1,406,1309,903,43.6849896091075,8869
9978fb6f-4c22-4838-8e64-16e4575a99e0,Commercial,0.08487639499185429,50,19,198,320,122,35.113824173175814,9174
b7e2102f-4419-435d-98ef-993726fcfb0a,Commercial,0.84622413417346,40,3,493,667,174,63.36326249502851,5227
af8eb9c6-fbff-4011-b26a-650bf8e5a0be,Healthcare,0.8443826057880557,3,50,702,1101,399,74.70286512053221,4960
dbef5620-96ee-4b0f-8600-340d8cddf088,Residental,0.8673809350657735,39,48,567,573,6,95.37230441935047,2598
250e4377-e6d8-4c47-8eb1-bd95f5db6c3b,Commercial,0.2387259364803701,18,18,250,525,275,69.77635407057059,4341
ce65c0e1-7e3f-412a-81d2-0a6e6f84313c,Educational,0.5748342549345495,9,13,539,1030,491,55.81896811073327,4130
a4a41754-fa4b-4d12-b303-1c91233f4f93,Commercial,0.335496827335669,9,28,222,883,661,38.36073740359933,2270
e0bd2b4a-2030-40a2-b887-8ee4898ae6b2,Residental,0.35499275878748837,46,37,561,1079,518,51.88077097020821,5366
f64e00c7-58b4-468c-b396-a93b63d23930,Commercial,0.5011127234451167,10,14,425,540,115,23.362240990593158,2777
96256e73-5879-4c45-b809-e5e0ba7013cb,Healthcare,0.4959898349239539,13,9,113,514,401,57.53427561474241,1151
ba277950-f547-422e-b80c-557620762510,Educational,0.9413812994992727,31,1,495,978,483,50.958359416902496,9376
bf8f9a2a-ada7-4ab3-afc9-0f9b73123a0b,Educational,0.4855557933039557,41,20,679,1368,689,32.23310625976359,4045
521b2826-3156-46ef-a67b-74d85c4b015e,Educational,0.4791983977931201,26,21,486,892,406,27.076391744425806,2962
b0bdd611-b761-41ac-a950-c784d8ab245d,Healthcare,0.2406829523413312,17,3,498,1315,817,33.79209562122726,8304
246ff5f3-ebb5-4d72-85d8-0a1e782c6d2d,Educational,0.21712257088763565,41,22,655,1266,611,29.47455915846519,3786
f9e9228e-1d5e-4219-aa7e-aa558e335ee1,Educational,0.8541059947315602,35,41,151,1047,896,23.226516979023526,4280
3b5bb433-eedd-45b6-a294-55516dbf9832,Healthcare,0.8168849655177104,24,5,537,551,14,77.49840489029732,1042
650167dc-dabb-4d39-90af-9e368616e963,Commercial,0.6112959464776848,32,49,159,1241,1082,91.62749997122887,8719
4c3dd92d-8797-412c-b7f9-6c600d6bdc6c,Commercial,0.9996205837428646,27,19,415,1187,772,89.95189632398966,9517
105c995b-f545-4015-b9ff-5d748b488baf,Educational,0.9007921889489534,42,41,6,48,42,12.404864893608844,3544
8d23dd54-7ac9-4b77-81f4-8a45f606f3b8,Healthcare,0.696633320385559,47,46,183,1264,1081,56.66217542118608,9389
be8e9e25-66cd-409e-b3e8-473bef23ca3f,Residental,0.4335559982013776,35,20,272,559,287,69.56363131693098,5407
2e970f08-b810-4bd7-930b-4a213d486543,Commercial,0.09614431144050573,37,4,618,1364,746,52.505518162245,5699
00f896e9-1d22-4fdc-9e79-cae2dc97c4a8,Healthcare,0.27390585306826676,13,13,717,839,122,94.81673864418143,5900
aa16e5bb-d0be-4c51-89a4-27c2112bd9fb,Commercial,0.8914427938704993,5,45,171,175,4,16.082139847150597,4416
dbc89ca6-9d61-4f11-bf96-e90b3247fec1,Educational,0.266164351263699,29,23,73,1199,1126,98.20956305915583,4133
eace01e5-4065-4e69-8e3d-7392ab6c6748,Educational,0.37854057771236427,16,22,231,1173,942,58.87071838481127,7965
f0f07741-af36-4e63-a52e-22c343c61464,Residental,0.3158828081495273,29,34,190,317,127,28.354293089742942,4178
1572046f-0eb4-4aa7-8cf7-c91e2b4cf36c,Commercial,0.4345042116944329,38,17,670,899,229,18.258003179003985,8753
93951387-9bb9-4307-9f09-3f6e6d3aa171,Healthcare,0.926247181149088,38,10,437,543,106,50.753982751825326,8226
14a2d438-7d97-4a57-9a7c-07a555d0aa5e,Residental,0.47739655804843817,42,9,142,1034,892,88.69102296475936,4554
055dd203-262d-497f-8208-3b35a80eb813,Residental,0.7339000706806761,35,37,659,830,171,56.90087062072552,8744
06060e2a-fcf0-4913-af6c-f39c1685aa6e,Residental,0.1395298574119216,42,50,500,765,265,11.783612517402489,3846
d9cc93a9-b22e-4b54-843e-faa7ce9ca779,Commercial,0.017011017301094333,25,11,89,902,813,85.20405914540659,6799
9f8212cb-0bbe-40a6-8962-2fcc39b6d512,Healthcare,0.34505968473273496,47,6,399,735,336,30.390459696344557,1855
4cfca02d-8dff-4185-aeb6-4cb6fe97cfbe,Educational,0.9924363108715469,34,23,148,1416,1268,51.32210346446077,9988
bdf83ff7-0e17-4ccc-a642-a4ad4d0f9ed0,Commercial,0.07119846888868764,7,30,146,890,744,34.44590442806029,2937
d6e1b2c4-5690-41bd-8f66-1ec4032fc5e7,Educational,0.013328551360383356,29,15,551,708,157,30.161740686768482,8811
923c59a2-883f-4434-9168-bf93fd5151e9,Educational,0.36721113206781375,47,42,54,398,344,90.04113311706038,1786
7e202b6a-306b-40f0-a5d2-c14c38ad8911,Educational,0.09460701879715117,33,19,258,897,639,77.30462045710507,9348
432a1d8b-1f81-4fa0-aac8-ffd9f390754e,Commercial,0.8904117046566521,44,22,173,959,786,58.443528356941634,8664
e8f4b0f3-6d62-4513-a5ec-914f3167d221,Residental,0.17714275139471936,30,14,301,700,399,59.20960755681147,6003
f4e069ff-515a-4a6a-90fd-d1285be78c0e,Residental,0.3633150763527331,23,29,307,908,601,40.91872335238125,7646
a6336385-d64e-4a40-a6cf-4cfa3e85ff01,Healthcare,0.8492986254349942,29,30,633,1398,765,91.9025044670915,4640
bf888579-db5a-4f9b-ba8d-c55a949652ff,Residental,0.8314163441543996,12,21,269,282,13,12.574305062341505,1907
6d2f23c5-7691-4cdc-9032-7001204e4a16,Residental,0.27358941458623987,50,45,42,344,302,66.63690416855644,9573
e111f5ca-24da-456f-855b-20963bafe8cb,Residental,0.989129406215975,5,8,351,713,362,65.67157131624602,8847
e71b61fe-534c-40b5-b88f-c113a91aca66,Healthcare,0.5009040768805474,28,21,514,1414,900,16.08171152366097,6810
e55c8ef6-f664-41ac-9730-27ad71a90ffb,Educational,0.9090037939487365,24,7,535,1014,479,62.44940851346959,1665
9a963325-d9b5-4258-90d9-8022feaab8b0,Educational,0.2166262342525247,5,24,525,564,39,91.40459608368974,3272
11f47670-8de5-4f2b-984b-525aaf65e7c5,Commercial,0.00944269005063092,6,7,17,229,212,15.362079447079301,3383
368dc269-9924-4850-aa45-225c2e9ebb7d,Residental,0.8670950216384942,25,50,274,275,1,91.98314343774821,4787
54f86a30-2429-4db1-9bbe-394a2ad9823e,Commercial,0.03165416453655445,7,26,317,518,201,20.10367046464315,5705
1476d23c-669b-47d6-8935-9f0adbbb2a5b,Educational,0.5845275542830143,17,11,30,1133,1103,18.86002273975363,7902
f31e1edc-20ed-4798-acde-1edd4a3922fc,Commercial,0.3950738920005561,30,38,128,1405,1277,70.79992839482651,3461
2b46fb87-57b1-4edd-885c-879cf3fdff33,Commercial,0.06794376276959468,16,38,147,1062,915,39.65233176119622,7829
df569ce0-3437-49ff-a680-7fa09955183e,Residental,0.14260124114975037,50,6,646,864,218,65.07506006051833,9573
2b9beea0-e974-4fa5-9f99-06fe03faf480,Healthcare,0.10906062238435099,42,28,607,1010,403,89.81644022295978,5591
bcf060f8-5050-4ea8-872d-a8b08cfdeaaa,Residental,0.14878863017104427,37,8,25,67,42,63.44082053337886,6326
46cfbaf9-cde2-4403-a0c9-e253c9a9f176,Healthcare,0.13446362271292212,2,33,272,1229,957,71.92291641769921,9739
3ee791fd-cf28-4e57-8bb5-6b6663a93cf2,Healthcare,0.943739345206227,34,25,625,917,292,88.03106293318068,7655
a1e23e7d-cf35-4632-900b-78c61487eb8a,Educational,0.33359537362386193,38,36,651,1357,706,23.07394740838192,7591
546882f4-8ca9-44f2-a867-b9d64c8dd0a5,Educational,0.24272439775379817,44,48,221,900,679,33.460182026205615,9557
86cd9811-1fb5-4f83-a796-007d8816d019,Healthcare,0.6504715851065987,32,46,205,841,636,32.676773553490975,4334
c3103101-469f-491e-bcb9-85f9d2689400,Residental,0.9022985877917318,24,29,331,348,17,39.42138916660647,5892
58b7d17b-c2df-4837-944f-dd66d667cc85,Educational,0.5251611851757295,16,5,153,533,380,14.316791846613768,8168
660ec8ff-5df7-45d8-931e-17f5433f3ac2,Healthcare,0.17762848606378157,21,24,113,1304,1191,84.69732579389841,1634
6e62c0af-be0e-454b-b73d-5811573bc067,Commercial,0.6096957196947426,46,27,512,906,394,16.16119056538254,6919
fb8dfa9d-b64c-42ec-b4db-0e826b47402d,Residental,0.10504619267167115,28,11,34,1311,1277,89.35803541788366,1131
4864cf9a-6895-45d4-8c3a-0d1fa7e53292,Healthcare,0.2675878716307508,35,45,472,1075,603,55.71677693896858,7745
19d17fa5-1694-4704-9b99-722cacce0055,Healthcare,0.6917840194517167,23,25,19,98,79,31.44448204140526,2240
bd6edcb6-6f4c-48a9-ac17-ed6f2e8b05e1,Educational,0.9773839462078685,11,33,570,605,35,23.627444369360532,2791
4c410f97-bf9e-4668-b185-0aacc7bf9399,Educational,0.4012103046223059,5,4,452,1360,908,84.96096176025527,8111
765f766c-4b4f-4f61-95b0-2fc04ad8511b,Commercial,0.43720078069750834,19,44,539,1220,681,65.70766309915707,9660
2dd0039e-b5b6-4a39-a959-03d87f17050d,Educational,0.86194513035851,15,34,387,723,336,89.49630316220592,9136
28f4e955-2de8-45a2-8a4b-30a85299786b,Educational,0.4571085607606693,37,6,531,1199,668,34.16090687588999,7066
76857b5e-fef9-419d-87f5-ab129e740123,Residental,0.31527519782043145,17,16,659,1210,551,92.86382030171815,8296
acf99f71-1752-433d-a26c-c91407616662,Commercial,0.15049569823590636,30,29,252,1267,1015,26.220210884764487,1515
d3662d2c-0091-4264-a5aa-ee5dd0fe79ad,Educational,0.5469874242933094,12,29,292,1307,1015,40.33909057648641,3620
3454743b-732e-4601-864b-21a1320b776e,Healthcare,0.4917673208925071,17,27,27,267,240,38.452538514410435,3487
5d98c69b-646e-4c2d-bbc0-da03b37739f5,Residental,0.6218585533962563,30,16,322,1341,1019,15.859444596544504,4480
57998779-6d59-4d85-b3fb-b866e9975279,Healthcare,0.4483285273147416,24,41,310,769,459,73.68247045958844,7190
82903e93-4bcb-45b4-a29e-952a8ffb7948,Residental,0.5408421980832555,7,17,98,1310,1212,86.20244902062278,2979
1badced6-f464-423c-a28b-eb4d25c1107d,Commercial,0.24042267480572788,24,10,319,818,499,18.96215352287578,5606
95cb6d2b-2b0c-4920-953f-de24c581422a,Educational,0.08017987849646213,14,50,491,535,44,74.01975858701033,8995
f2734493-1b05-43aa-8851-ae9779597111,Healthcare,0.6850167298050219,40,39,122,296,174,87.20981412023441,5893
14304442-6ab9-4ca9-89a8-df13c5a8bfc1,Educational,0.6831920554677817,34,36,567,1393,826,61.04307531735173,7779
ac9589b0-afad-4c85-8cd8-e1632f0df621,Commercial,0.5214840615593104,18,40,185,1414,1229,82.21009061939355,4304
2a221705-74e4-44f6-86ab-7c610e4560b8,Educational,0.9423347216384297,15,17,92,1046,954,66.19606074910902,1885
febddd94-3e6b-4bc6-bb38-5a3483a5867b,Educational,0.9988772470166132,32,40,605,605,0,15.934849466054693,8449
8eb182a8-3005-4f53-ae08-3d152bd9ecc9,Residental,0.02940579714827618,38,45,44,894,850,58.32239814121928,4867
043b0e08-7a4b-4d82-b433-5923a8cfe8b5,Healthcare,0.22756138422659045,10,24,78,1430,1352,73.8299254766263,2477
60866c9d-a61f-42c5-9e80-29f3f98f4ae7,Healthcare,0.949716337425076,12,2,292,720,428,47.081903076751956,2031
3c1258b0-4217-4b81-b8ca-f3bd65fdaffb,Educational,0.7096168949168635,37,17,516,664,148,34.21015439535555,1201
6109fded-417c-4959-936b-15e14d508215,Residental,0.8017953882940448,27,31,330,1010,680,77.1962149432259,5066
981536de-fe1a-4524-9128-07ee7b2d8869,Educational,0.7622221911115883,49,46,566,1361,795,99.50481181231743,7727
cb4c672f-b3e4-4427-a93a-cdb17aa20f3c,Educational,0.11080212074611961,26,16,445,1314,869,78.04612330025405,6462
3555a29c-97d2-438f-ab7f-178d8f2627a6,Educational,0.9348992151056567,29,33,459,1367,908,32.42574715649704,4800
1ed0be3c-d936-4c44-9c74-0da0621ad8e3,Educational,0.7172029666400855,24,1,708,1028,320,11.420912538053022,9686
332d85df-b5d3-4763-b665-f78b0c217b22,Commercial,0.3017923175711653,47,39,604,1252,648,58.78039756633497,2900
80412b5d-f150-4a45-bd02-da600969be59,Healthcare,0.5183134906008785,23,9,304,1106,802,18.261985429499262,1308
2cf10c73-14bc-4193-bc37-1d4e96da31f7,Commercial,0.8061608914762356,2,11,487,1393,906,24.19763255093065,9797
59bfcdca-015c-4439-9610-0160bc2cdc5b,Healthcare,0.27372037362380197,31,38,350,1251,901,15.408783820058645,4535
c7f7c6d8-372a-4eb8-9cd7-27cd791d31a0,Commercial,0.3703415640931452,48,2,362,482,120,45.99413622615186,4080
813c8234-3f17-4471-b085-92484f450c08,Residental,0.5980639813606727,45,32,83,956,873,68.4683540598047,6005
575439e3-3cf4-465d-8a10-f629f397957e,Residental,0.2788707488479303,48,17,434,754,320,87.6947287239295,9886
d4eb6492-d2c6-4ca1-b36d-be239b1fee94,Educational,0.2651663567894421,45,36,615,788,173,69.95078152233079,4445
954cb6b2-3f9c-4cc9-9cb5-09b44ed58d43,Healthcare,0.9815748058444098,24,24,517,1403,886,54.70949556375173,1346
4ffb94af-3b19-4802-89cf-1e3d623a95d4,Commercial,0.22850777550643986,25,24,201,940,739,54.387018990259044,2127
6925bf5b-1b52-460d-b3a4-2f8e1cc2342b,Residental,0.8617712453237026,45,22,160,230,70,46.22737890837,3041
39c0c94e-469c-4027-8869-29b1e239f5af,Residental,0.03693918537533991,9,5,37,994,957,53.65161920412332,5866
3fe0a7e3-f9b3-4596-9193-abb21196041f,Educational,0.2440147191177361,39,30,390,1274,884,75.35823590701547,5682
5d0fbd50-1e12-4f2c-b1d3-5d6e84fc9fd5,Healthcare,0.6675860147739431,33,45,205,889,684,80.76708359160844,7550
918816d8-6c89-4cd4-8632-2f3114333074,Educational,0.33878597499404917,30,48,639,946,307,82.9997030610302,5538
2ffead46-a4fb-40fb-8bb8-d92bbf3ce196,Residental,0.31411395576680323,8,19,492,693,201,73.03394935876477,6756
a3a31bdb-21d8-4d49-8166-db9c13158ddd,Commercial,0.8989586400874577,6,30,313,690,377,94.49724022959636,1889
3306c9ea-ed34-478a-b04d-14f922ccb9a2,Educational,0.03281821838170329,30,15,78,600,522,66.80604426594786,6252
fb389556-bcc4-4feb-a2e7-c53e1d2d4253,Educational,0.4143563460986772,6,4,216,676,460,73.71319293745432,2888
a61d57c4-9d8d-4869-bf7c-ce8c78057793,Healthcare,0.8049774218091125,35,49,111,1107,996,73.88273991663192,7538
c45ca6db-2e66-468f-a4c5-cee2770913e7,Residental,0.6769591032654235,46,16,50,571,521,47.03479732479188,7791
5cb2d873-33d2-4619-90fa-d7a5bdaf3313,Commercial,0.16164841240395944,16,15,301,521,220,68.10939992846738,5167
a6b42767-3358-4718-b5a1-f32547d85928,Commercial,0.9016482025409585,27,46,285,1437,1152,51.45278411083908,1326
7ce7b8dd-8382-4edd-bbcc-ea6ec33f2835,Residental,0.6121217342244376,6,22,713,991,278,25.12240622415496,8735
5e565087-ca56-4166-bbdd-b390e45e6831,Healthcare,0.5110763177093913,35,31,299,477,178,64.2832662206444,5444
5962d564-9772-417b-be23-036b8b4ae764,Educational,0.8741658087437837,31,40,637,973,336,89.89720178507575,2329
e36857b8-27c8-4d37-afd4-f6bb44796292,Educational,0.10946060586442596,1,33,266,1052,786,42.323308369391306,2030
dc1293a5-26fb-4888-80ba-41b6a27cc23b,Residental,0.47993702289969786,48,1,669,839,170,31.913691428628663,9273
afb356af-046e-4506-ae20-530613dcf254,Commercial,0.5407285738321846,49,24,206,892,686,34.749539166374284,6793
e13c106c-c44d-4d18-899b-b379abac6c6d,Residental,0.621718505198844,47,49,695,944,249,21.62944226228547,6065
6bc2f1f1-2f33-4fef-a9de-cb2e6665fadb,Commercial,0.10859231119765989,21,47,236,478,242,66.88188170603439,1148
95882c5d-5b58-469a-9ee2-92f3a9fc1f40,Commercial,0.05882483529725635,41,24,693,993,300,60.8730359031283,8162
6cde02ad-3d91-464a-b270-8ba2e8e67a33,Residental,0.961321318502614,22,20,595,787,192,68.57138637945661,9426
636b41c5-a8a5-4559-b68b-fd935e125ca0,Healthcare,0.18550565966451638,6,24,225,1034,809,14.511698988135059,8555
c8b260da-f432-4046-acc4-88b873fb35b2,Educational,0.45662953404624806,24,39,286,597,311,62.809547975560754,9613
773af029-3201-4892-8bd5-29188973b5af,Residental,0.5646781597010961,30,10,91,1371,1280,29.439713877633597,4323
ac23887a-6738-40b1-b83d-a0161de53258,Residental,0.55837175440686,1,23,491,1220,729,14.029951128270259,7426
8396f102-ea63-45b8-83ca-5548af165c86,Healthcare,0.596512640799997,42,8,147,292,145,91.75193427530785,6025
49f7cfbc-0c8c-4d48-a610-bb85a1cd2fbd,Healthcare,0.18790753803270532,4,36,654,889,235,46.79081470958313,8954
bbadda57-7007-4854-a9fe-4f9516feb7e3,Commercial,0.0058171659992865,20,11,521,681,160,13.845536741104542,8965
d986b691-e838-49a5-a6bd-790b8c71cba2,Residental,0.517721184057384,47,23,27,1249,1222,74.35435333759385,3692
4ccd8b76-c0df-4652-9ca5-fb21f0144431,Residental,0.6460624901629406,25,37,570,679,109,76.90443704139844,2550
71e7816a-a94c-4d3b-8ae4-f1999ebcb956,Educational,0.9228460844026873,50,10,155,663,508,63.9305946526654,3455
dd09c9dc-dbe2-4733-b176-dffbd2f42b83,Educational,0.2919046352122364,43,28,406,450,44,49.49629845133956,5580
e01e73fb-37ad-40a8-8300-afed33a5cca8,Commercial,0.46026410730831857,48,27,365,1432,1067,87.84968917702344,8699
f73d3afa-c0e0-4c3b-8fc9-4f7abf4df5d2,Educational,0.14287898647013353,33,15,490,760,270,17.60063769639212,6758
84779f95-e894-48a6-9dca-6f1141a95d26,Commercial,0.24376181716233314,6,20,605,1217,612,30.954838492753613,6985
10bda34c-3fb3-4fa8-87ff-7eb4d6a16211,Commercial,0.49595113872474217,10,3,395,1129,734,63.513686776909736,9904
bd2c9ef0-33f5-4360-a71c-dd4650917848,Residental,0.8086847629281158,50,14,672,745,73,89.95701982961707,6580
ab3444fb-e4c1-4280-b208-2862dbb0080d,Healthcare,0.309513662032873,15,8,507,1045,538,54.40797934501932,8194
ba83742e-f32c-4581-a06b-b577cbaa2ccf,Residental,0.10233702615902407,42,31,606,1127,521,12.27777845241148,1224
6b3c136b-f639-435c-8bd1-a5cbbe69326f,Residental,0.5626244299335836,36,46,95,1174,1079,19.575309242388755,1886
9b78bd50-eb5d-4297-97bd-983619b3c331,Educational,0.3842579318827719,22,32,114,449,335,57.293659860810116,3118
7a48c26f-7c6a-488f-8c73-6d7ba4d1e6c2,Educational,0.8906071044002495,16,16,255,535,280,22.89155074423217,5123
e72a3fd8-f0e8-479b-86bc-410c078d7f65,Educational,0.05027423392971386,45,16,60,799,739,60.37270042403934,6679
60904142-7a6e-443b-856c-dc7f9e0ffbe4,Healthcare,0.8589976103111571,38,18,174,1398,1224,80.87556852024024,2331
27774a63-1e1e-42e5-89bf-5ed61c823d9e,Commercial,0.07449610382558147,4,46,320,322,2,30.187495531124018,4041
6a513ef0-4019-47a7-8758-79eb40436e58,Healthcare,0.29817847406673836,36,48,65,125,60,56.34134024089712,6911
e12329a8-8fbc-484c-bb31-eeaf82f4e8c0,Residental,0.16456038144449625,38,18,188,1246,1058,75.66425475780069,3885
f80fe45b-80e9-403c-8bf3-ced2e1070123,Residental,0.6268010308709829,27,6,406,1283,877,67.05158059456846,3933
a22ed006-b6ac-48a7-b08c-cf87b38afb16,Commercial,0.3413290201790089,41,20,688,742,54,57.572916003935354,4296
5f48367b-c678-4af5-ac44-613a53c20b85,Residental,0.6566664309493546,24,45,484,1176,692,51.72600072011243,8299
a6201050-2bd7-4e91-b484-90b58556c1da,Residental,0.07412179291981302,5,18,356,997,641,55.522109521247785,4576
bbdacf15-6875-4e79-bba1-d03e470a1887,Educational,0.10797190564046355,35,45,523,1272,749,49.33960739856312,4713
6682b315-2bd7-495d-ab68-17a45f4669f5,Healthcare,0.8968190399039683,32,10,466,1187,721,39.13082866922581,7161
55b2f170-c4c8-4074-a243-9134cab9bff6,Residental,0.03298877837992176,14,45,625,643,18,98.57230338211855,7091
00dd7bf5-c64d-473b-9e31-0f0a9e6d4b73,Educational,0.1343635218095579,39,35,380,749,369,29.381477092642932,1607
6f39e5bd-6f71-4306-8c39-e6a9ae401e96,Healthcare,0.7251429781620791,5,14,133,816,683,42.72553105249294,6677
f10dda59-f1e8-4221-9445-d2e9cb3341b0,Healthcare,0.9088555553732379,35,18,170,1154,984,54.866591437685145,2484
12e42510-985e-44df-a4fb-9ccc464fde92,Healthcare,0.9546169649025618,19,25,524,869,345,52.596811028384266,8529
6c1a946e-c2ae-440f-bafa-b84a8d0f9d8b,Educational,0.43402746317944907,18,45,431,1108,677,94.03125762446464,6065
cfdd8628-db85-44e9-a7e6-d48e4c682276,Healthcare,0.9386930971154718,23,3,260,967,707,39.669712816897274,4223
9954c84d-e778-498d-8adf-6b1bb3ffea4f,Educational,0.8036994075057936,4,27,494,1089,595,21.23707913423012,4805
b8f1e3d2-80c5-4a5a-9d8d-48674ab3ae9b,Healthcare,0.5698497591489141,9,21,618,925,307,82.41817629608353,5319
6d766311-910d-4091-8ab8-e681f1e0e999,Healthcare,0.49466154641568294,26,1,661,789,128,56.11516547927325,6312
1efe43c4-d634-4ee9-8638-9a827a4070e1,Commercial,0.3173039437614752,18,10,119,1200,1081,58.58687283041082,5188
658d4ad9-072b-46b6-8342-d36ca632c80f,Educational,0.9529717254983827,1,39,424,1341,917,85.04184418391624,2346
9679f752-956b-40ce-982c-845135a039d0,Commercial,0.01960234683269746,30,18,270,1180,910,53.14278046213359,6430
685f2737-dcbc-41c9-8d04-daa7241e6cfc,Commercial,0.655341484092798,17,9,304,437,133,74.59466501328805,6554
11f9c6d7-943a-448f-ad5d-9478f1cbde46,Educational,0.09063269160074805,49,40,245,1182,937,96.67256253851092,5094
2f3ae449-284a-4f67-bb2f-13d88e2d20f8,Commercial,0.9721553897557863,4,19,79,574,495,77.35570843149144,8249
b4a1c7fa-7878-47e2-abaa-15b35fc86271,Residental,0.06667070510815132,31,43,361,1063,702,16.287424772493388,8957
442eee4c-9bd6-4435-81f8-62e87deb35db,Residental,0.2996993036557495,50,32,628,975,347,28.613925145820048,6209
01c39e2b-00bb-434a-8290-5c7de1bc6a91,Educational,0.07735532286851665,10,41,378,1320,942,72.03683156574253,1348
69170d05-0c25-4781-9431-8de375ff39c4,Educational,0.08290827623691532,17,2,710,740,30,70.54533883194492,6188
e7cf37e9-094e-4886-92a6-d813f125dc5a,Healthcare,0.4580737461868468,38,27,468,890,422,84.84211843049655,1363
60fa8510-542e-4890-92d4-d35885f83949,Residental,0.8235245366542419,23,21,43,1410,1367,74.90075872011704,9585
d8712133-1cb4-421c-b0e2-b838718f5618,Healthcare,0.09930641625711167,2,24,486,831,345,91.56791717555045,3940
9e19b605-398c-4b58-b762-5246dd20a2a4,Healthcare,0.6038315776443204,39,7,58,288,230,66.12340498882052,1832
f652495c-6474-4903-9b94-32a93dc5aba1,Healthcare,0.10193524461961889,17,6,553,850,297,11.685215765258658,2293
ab41fd22-455f-4c4c-9ef1-c45ce2e5ebc3,Educational,0.2897144840520469,4,40,179,675,496,79.24519947360187,6961
8cb0bd59-c5e2-4e23-8405-6f4b998e8ac9,Commercial,0.04739298172457096,15,34,666,735,69,42.276987393929346,5442
f7fcc575-b41c-4381-be6c-80c61d42592c,Residental,0.8126945062383353,44,13,606,849,243,82.52424873556687,4893
725757c0-1247-49d1-9261-809631b2eb3e,Commercial,0.8096398796690215,35,21,281,374,93,77.74859250307003,2937
bcaf9969-062f-4683-9521-eea66624ce21,Healthcare,0.4920557689897609,42,30,563,1196,633,75.72392932323666,4082
240e3f5b-0207-4837-8a89-66cf5e7a84c0,Commercial,0.18007245074991507,24,34,405,997,592,83.56795537424307,9493
b67f6412-f96c-41a0-bf87-09a3b08c4cdc,Commercial,0.19920482064541734,7,3,525,576,51,86.63549268889881,3033
5ebd90a3-dce9-4014-a87d-ad0856b16051,Residental,0.36389099608926256,23,7,611,1109,498,99.56282379511423,7034
4df638c7-85e9-4548-a3e7-fad55798ea58,Healthcare,0.7788486485077221,4,14,196,393,197,13.892792861697114,1147
4c677d39-fb3d-4350-b101-c9f507051c86,Educational,0.08309923625092863,28,4,496,1236,740,13.650925863168982,1217
634402f0-a6cf-4a21-a645-61e4a4083a4d,Residental,0.5117297643854887,6,2,696,1412,716,37.03466881820735,4679
9a480c4a-1974-4ae9-9226-1eef9edae07a,Commercial,0.9071462954260423,17,33,67,432,365,28.485200919050644,8456
1e00a37b-d31e-4b15-8ec1-cdec5359e6f8,Commercial,0.7854620976466323,41,5,220,1067,847,43.49021342963873,4160
2c06f0a4-595f-45b9-856f-c3b5a0045c83,Healthcare,0.01866780516789701,20,28,501,1142,641,83.30300262749624,4257
85da060d-edfc-47ad-b137-2746705dd658,Educational,0.9123482280102453,6,29,362,598,236,90.48196658834014,6547
79a5dbe8-5bf2-4b91-ad26-2dbcee4b91e7,Residental,0.6693021900069827,15,4,516,1331,815,78.66080170159637,9810
c2915879-3cdb-4036-8ce6-8d4b1bbc02ac,Residental,0.48352156214709596,47,6,99,1302,1203,88.97084583691387,3106
d9cf4a09-0a9a-4dc8-8da1-4d06c9b50de7,Healthcare,0.151430188749618,49,47,593,1032,439,34.28776925181221,6385
8fb3b959-4ee0-4624-a171-a301c3d4a5a4,Educational,0.43267406251529794,32,6,619,950,331,20.01223356039381,9533
383c4874-bb4e-4588-9b88-c469d9e67eaf,Healthcare,0.08474567227318308,32,15,229,304,75,29.87278360137086,7871
94fa9f76-69aa-4658-936a-78c07a37f825,Healthcare,0.01614340519168178,12,25,208,784,576,71.51795277924472,3081
d4c2a859-d8cc-4c9f-8c0a-e052f95d5cd1,Educational,0.480966611432026,28,22,251,563,312,26.115738810923517,3834
24ee94c9-0881-4cbf-8231-22dc1ca2478c,Healthcare,0.5684751715235664,28,6,605,1312,707,12.745760441230832,4320
daa5e3f3-334f-4da9-8660-fd251e87558e,Healthcare,0.8755794520777034,22,40,279,954,675,83.11900199095072,8874
bb6e765a-b881-436c-a348-1baf2e8f7f28,Residental,0.4161056829601021,12,45,57,1380,1323,56.349972497428794,6138
edb14b19-7457-49a5-99d7-5d6d79505df5,Residental,0.22378268621803454,15,30,179,387,208,17.54192830808656,3718
ba7b44a5-8a40-464b-844a-0ec6b591f1a7,Residental,0.1569243625379152,7,6,215,901,686,79.22497999897682,4461
b9359b99-ad92-47f4-a6af-f601a21bf1d8,Healthcare,0.6951282858346832,5,48,444,1180,736,24.298511462950277,6381
4e3768d8-1f31-40d6-a78c-6f2b355e2ccb,Residental,0.36970555826277296,27,23,359,1281,922,26.95816942981548,7972
85c4567e-8287-4535-8056-7b8496813966,Residental,0.009290675528442649,1,32,720,1234,514,55.12948149875739,8471
029996f9-59f5-4c14-8b61-f0e9d174f457,Educational,0.23468859723708824,21,26,255,772,517,56.80898023838418,4423
aab6741d-4f18-4d52-99ee-9d892c27370e,Healthcare,0.14770841094383025,24,25,104,1026,922,57.235849023605056,5165
a62f9838-55bb-4b31-abea-978d3f185088,Educational,0.47933260004252487,23,12,453,872,419,64.40104262318349,6359
4a91a319-6ce9-4737-956b-94eabb16af4e,Commercial,0.7272525877539483,47,37,603,882,279,25.76921653331366,8170
aad0fc4c-38fb-427f-bc3a-67dac307eda7,Residental,0.12685520877759804,39,23,709,1315,606,28.680712595394688,4309
d8c51edb-b311-4b9f-aa55-6a5b85a1b418,Commercial,0.699768368994914,16,34,614,833,219,93.03877008222645,1551
4b793ab4-5b94-49a4-80f5-491fc1017aa8,Educational,0.09301422368473855,47,32,252,1007,755,47.64432865668143,8715
00d36ccb-fff1-498b-98b2-b1084a717bd4,Healthcare,0.8177614984826284,47,43,458,1406,948,36.683159418553196,1080
27e8a4cb-1ee6-4f38-83cb-bfd51c13d09f,Healthcare,0.7287363387239802,33,19,393,432,39,51.0822258908695,6327
27e34ed6-c1ac-49a3-bac5-ec97bf435494,Residental,0.38216157414061214,1,48,23,64,41,11.391318093833124,1705
4b03a1a6-f229-4343-be28-941e79f5a4a0,Commercial,0.6902522709688494,9,36,316,1287,971,92.04263508968303,1490
d955cec5-29d0-464c-8a1e-52a517d1281e,Commercial,0.44195098409471145,29,11,284,1359,1075,30.30963402997528,2171
56e80ede-6fb6-4b05-80d8-9a2ecee13e31,Educational,0.13634600228042115,44,6,125,180,55,99.52318460398027,6871
0bf4f2a7-0fec-4de3-9b3f-b0941257e537,Educational,0.37751425836294716,38,23,177,1004,827,90.89565747715203,9448
6b36fa31-4b3c-4122-bc04-ec8c322f0425,Residental,0.09921431717672735,10,40,678,898,220,39.44648258133955,6340
6e5fb460-2cc4-4f47-b603-6f3007326318,Educational,0.6441439405226261,33,6,404,618,214,13.103713209959956,5333
52b6231e-1619-4751-9bc8-d1087d148845,Residental,0.8792152340397248,28,6,444,1420,976,86.99010374767249,8910
29a45067-8c0e-4310-b936-be008422750d,Healthcare,0.861021788350364,45,38,484,535,51,72.74981115518906,7708
f18e434d-5196-46cc-8097-34d7f521048f,Residental,0.14109827856613022,24,32,274,1314,1040,91.99189322139007,8383
e59b1561-31fd-4ec6-b318-8a7eea01ffb3,Healthcare,0.5853391725818351,32,1,610,1090,480,65.99798069751628,7148
32373043-a5b7-41a8-a892-d96a7099dc3d,Residental,0.08340532372864484,46,41,467,670,203,37.62505490619944,1160
83c1eb88-3cee-496e-aade-b55946b93f68,Educational,0.24111287330195152,10,3,688,1281,593,39.780780204214246,4488
8b633d66-7a04-436f-94a1-f266d11d9495,Commercial,0.5985086983192857,33,20,629,952,323,78.79304797264084,1499
c8968112-7c9d-445e-b4fd-d55c8a2bb000,Healthcare,0.1672289668148892,37,2,230,374,144,26.76402848516358,4753
51759da9-9b3e-41fe-8a8f-1cdea5afa830,Educational,0.42941182402056355,34,2,687,1091,404,76.84909875661491,5915
1ecd8bf2-b711-412b-9b47-7ee99c20e542,Educational,0.5706307394143738,10,39,472,836,364,56.666512570218714,3450
a50ef910-19fe-43c5-8769-bfaeb07b426b,Residental,0.44596571943850916,14,50,86,469,383,75.40224325026719,2577
0b7589be-a121-4297-8a6b-c0e715617dd6,Healthcare,0.255757098085552,17,36,397,1341,944,27.16855568624423,7532
0bbb9787-e2ad-4e80-a992-1b7c664acd28,Educational,0.5983047192882927,9,21,690,882,192,11.763343129316489,5156
6477e181-6748-4da1-8086-a764f08b11d3,Residental,0.011435949730337347,34,14,351,806,455,46.99654866874755,8637
94c1c1a6-2407-4e08-9730-46523ba9f8e5,Commercial,0.9066639763552867,11,26,638,1331,693,69.17949240981072,3260
784d0102-e009-4133-a9d1-33c1287af984,Educational,0.8375080747012951,12,31,544,1334,790,66.04260003350136,3776
c70f8554-504a-4968-aad0-99141f1d0b59,Educational,0.970350032188952,45,8,171,760,589,34.50436435620506,1881
89145025-1826-46b2-9250-f480ae1420a9,Educational,0.013494886246137927,18,27,193,475,282,55.04332578750726,7735
cca862a3-0212-45ef-a659-19bbeb1a0543,Residental,0.6999070540862058,17,44,163,1082,919,63.35183587231188,7535
16b12342-2a91-4e2b-b7fc-e8dafc8f214d,Residental,0.9965734244289932,2,4,504,998,494,58.254458537110764,9636
7810fa3c-5193-4ca2-80d6-f5910eb8d072,Educational,0.1765484863464416,41,49,465,1400,935,43.39806326511096,4852
efcfc4cf-70cf-499b-92a5-1f1a7b8703ce,Healthcare,0.47597935482511455,9,10,277,662,385,63.23087898162136,1290
bdbf9bef-3128-4dea-bbf3-e85dbf641e16,Healthcare,0.1292462469123261,34,5,482,768,286,74.85150605649227,2693
d5114d96-bf96-4e18-a02d-a2ad03145ef1,Educational,0.010862178063080208,4,2,561,1305,744,34.92466882717811,7945
5ca65271-18d7-4f02-99a0-12b1fec24d34,Residental,0.9303471577287159,40,27,690,1166,476,41.429085503134544,2757
d7947270-f03e-4397-9858-551a8f4f9b71,Healthcare,0.5801787049921862,23,30,148,451,303,30.236321212599375,3706
09e6bc2c-e8cb-429b-8646-970b74a31562,Residental,0.14322755659068553,23,12,713,1037,324,20.02838555282071,4541
a31be6df-cef2-4611-b211-b7ba869ead8d,Residental,0.7723151550175225,12,31,377,1220,843,98.91956130759667,7001
0837a1d4-ada2-4578-93bb-063b997db8f9,Residental,0.9877453252796629,34,35,509,564,55,68.22765108359147,6466
bc83bae8-9948-43f3-b690-099d03f22457,Commercial,0.2750078947391551,28,45,582,592,10,96.24460868391445,7302
b6ff8133-4c53-4f5b-b564-acd5117318fe,Residental,0.6017370116684598,26,40,387,401,14,91.35150546269897,1499
ceccb3de-13f4-44ee-b747-d169c4b31495,Commercial,0.0794614069450228,28,3,418,869,451,78.40737154602226,1624
37f2371b-e83c-462f-b5c5-c67c2ff4a5f5,Commercial,0.28732083594516444,39,10,333,1137,804,56.58748992625628,5163
59c25e48-453c-4f6a-b115-35383056f5ea,Commercial,0.6709052664431432,1,18,599,1291,692,59.02339036165895,8078
9e542251-d362-4916-8ebd-73977ee37525,Educational,0.8805971329694839,24,8,467,534,67,61.892849450774285,2802
bdd933b1-1aee-4788-b415-aa138339eff6,Residental,0.06069613886761749,11,46,151,751,600,30.59413836557836,5072
ba5674cf-de39-4a92-ac3a-455489b52b59,Healthcare,0.060464931907940445,14,46,342,408,66,14.992251860710118,6913
5dc5ca37-ff5f-4467-873b-00a50950c64c,Educational,0.9456320788625762,35,15,8,552,544,77.0349170317449,4217
2bb5b02c-529f-46b8-8d19-a35839494b9b,Residental,0.7792971890821284,12,45,559,1268,709,60.74339138512323,2138
f54b64c5-924e-4a0e-8488-8469c5384552,Healthcare,0.9634520376255572,20,44,621,901,280,36.907408950237894,7728
1603dad2-635e-42b0-bbd2-71d4b4027c9d,Residental,0.8957025909124384,39,29,408,1229,821,18.754857566391145,8657
13bc7561-252c-4a53-8659-f66ef466da7b,Residental,0.6578632695802135,47,17,574,1390,816,62.32873698588224,4085
f11c4dd9-6f56-4583-9e75-9cbb1f2ce1de,Commercial,0.8844056029498736,39,44,622,1111,489,49.06135411823079,4258
57ed7d7f-3b2e-4225-a190-7062ad715e6e,Educational,0.09431705817874714,35,21,212,455,243,53.72263505273919,9468
d8140ad6-ebbf-401c-92d7-1e1a89f516cf,Residental,0.5903955187074788,24,22,380,1173,793,61.602737007161714,7283
41ba0d0e-ca4d-4b96-a0e5-9dc4b3db2d75,Educational,0.7929684439431591,49,33,631,1072,441,16.73703372550735,1704
b813dcd7-99b2-4a56-97f9-37833bf21c97,Residental,0.06133212994961623,14,9,274,872,598,22.63777052695987,5753
db7a7664-c364-4190-9b1b-a2ec24c85c48,Educational,0.475783027023296,41,8,558,741,183,15.745796841803278,7202
d2472c39-9593-4d4c-83a1-45071622ccd5,Commercial,0.826609390134713,4,5,350,548,198,18.58538037151914,8073
cc5eba0f-7eae-437c-867c-977a32d5fb67,Educational,0.4835842490297656,12,18,447,1380,933,95.63111669526755,2501
1a6adfa5-8027-4183-a232-f38a680622f3,Educational,0.00153908944134995,8,24,110,898,788,72.15759419008012,1206
8ec52a6f-5b3c-4cd2-be88-07a11b915103,Commercial,0.8905592352708758,33,38,401,1100,699,34.95568881598999,1468
10acadc4-cefb-4e74-a9c6-a25d013257b0,Healthcare,0.10590798729314643,15,48,263,1151,888,85.84804774953,7205
fe58293e-7afc-4398-8d33-a09e7eb593a3,Educational,0.5004078627510973,35,33,400,429,29,65.87745744806685,8714
6903edf7-77ae-4254-92b0-ccbab9dc3af7,Residental,0.0056920693707547265,3,27,59,1317,1258,37.700574629802794,4319
9265acf3-8b2a-41e7-b744-8bf4004c7d50,Healthcare,0.23531098756645696,9,48,159,880,721,92.78912249493487,1359
32fae18c-9393-47c7-8be4-103dcaa80117,Healthcare,0.03794869152472913,17,18,474,571,97,51.49414121309769,2514
5ad2dd4e-9035-46c3-9ebb-05f94f038dbd,Healthcare,0.5468439524738961,3,7,153,685,532,22.326145887901124,3211
fd718906-b0f3-4bf1-b975-2f9473b18af0,Healthcare,0.23202024294431134,35,32,216,484,268,75.72233823935586,5822
71ed00ba-1a80-4952-a11a-edafe5155849,Residental,0.23755186429835629,30,37,164,259,95,29.33354796513624,2197
be1ef86c-f8e2-4a06-8490-f15112a6d65d,Commercial,0.4326636390380737,43,16,552,1430,878,91.9188580004571,5460
70446c2a-8163-4381-b172-e0a68d708752,Healthcare,0.13628966416778476,25,38,494,1144,650,47.51214751881594,8084
711e4fd0-d0b2-4892-b75f-ca11fb0b1865,Commercial,0.6300044280559368,3,5,95,882,787,11.319918658730714,1090
cc4f611a-a500-4e14-ae2b-139b14331610,Healthcare,0.05849612217421085,41,11,150,408,258,35.23047095373454,2440
f17768c3-78c2-4968-ac5c-e9d531fff5ea,Commercial,0.6880291567101886,9,44,318,1269,951,10.973115581019865,6498
8ce7f0b8-2e8d-4287-8732-38a2f8efa111,Healthcare,0.46915772783942955,50,10,25,948,923,64.95496720523025,5402
80dd2bf1-3d84-4168-b844-fad51fa197e6,Commercial,0.9722631925757852,9,20,37,911,874,14.305137387776481,6601
708ed73e-fa8f-49c2-a503-3571a625e3f4,Educational,0.35990469575410355,35,7,43,1332,1289,61.52335392073569,1671
d0c65f87-7abf-42ed-a651-cc03ae7f0baa,Residental,0.8708173842130668,12,45,260,860,600,48.16924340586381,8126
fc0be762-2c4d-4eae-93a7-c9f187a18d60,Educational,0.08357067996611767,1,38,95,1027,932,32.59862345027933,9209
206fcc0d-9015-4346-b294-20509aedb988,Commercial,0.824348902219901,48,38,190,877,687,72.10556119872919,7292
65e1357c-1c9f-479b-9010-6e375da44221,Commercial,0.5299520306092609,17,48,134,1074,940,98.51006173708006,9815
878e751d-3cea-4922-b6ef-335e67849196,Healthcare,0.9827094981588016,1,25,165,1356,1191,81.36381363323636,3312
09567ae4-d9dd-4616-9125-09704ea6b4bc,Residental,0.535988896000766,25,1,9,695,686,12.19015070768501,2179
30c157e8-558f-4b30-a999-1c12d92de62b,Healthcare,0.04753642485094556,23,39,286,566,280,24.056897887519725,1419
f7cc8adf-a875-418b-a54f-54ab9aa00774,Healthcare,0.25714966890868607,20,19,630,930,300,48.481886149126545,5283
56439e9c-9911-43d6-917f-8ff9f5a6000f,Residental,0.5056562619525513,14,43,86,194,108,28.10397499073429,4289
46b8e0fc-c99f-49ad-b6b4-0bd2c4d132b3,Commercial,0.9169389696043694,25,48,669,1185,516,66.07885296701377,3881
b22ed328-ad2c-4f37-9735-061c49939f1a,Residental,0.6956932689609295,4,9,405,1406,1001,16.1820549259496,2948
49502f54-8d1d-47ef-8708-0a244f3e520a,Healthcare,0.30930383567905706,4,24,275,1082,807,49.380672711106094,6008
4d1eab26-3443-48d6-b886-8b1d97fa3e53,Residental,0.2975683673713406,3,30,486,704,218,72.96141331052247,5632
52e4069e-9adc-4643-94b5-93f53aa3ff96,Residental,0.2515678663616898,10,18,30,1422,1392,66.08850592624353,4814
990753aa-b03a-4577-8c4a-62c685443559,Healthcare,0.415359486079537,36,10,251,884,633,78.03325880732517,7886
6a268c78-055e-43ac-9672-c85fe0e1d09b,Healthcare,0.39558733391334944,23,39,94,880,786,20.831435614034877,6573
849148d4-9a44-4274-bf93-2f966c72f6ad,Educational,0.682969409172226,11,26,132,1430,1298,35.09763198452718,5469
ec9c4a9e-b4bb-49a1-bae1-8934ab84cc1d,Residental,0.571145515708177,42,24,152,173,21,67.80852268471094,8152
c4dd15f3-5656-4c95-a999-dcfddce6209a,Healthcare,0.8215682891513635,12,38,334,1113,779,19.582264584201674,6147
ba666ff1-27f1-408d-b791-5e2b1517bf00,Residental,0.7687317903251284,19,50,63,1139,1076,31.751349143470932,5338
a71210d2-6886-4f50-be11-4728ee3e99e8,Commercial,0.39676034109591674,40,39,81,979,898,83.69861981587218,3378
a4ad49df-11bd-4f0b-bb6c-e70f230a8da7,Educational,0.8234731309152722,19,1,565,697,132,13.174425503971278,8492
fe5c8349-dc04-4c15-a8f8-e55a8d8e49ba,Educational,0.8419569887802651,11,40,198,557,359,61.13080643114911,7112
f6838f53-e410-4a7f-a38f-2dba7c5bae8f,Healthcare,0.9481623543292046,9,9,383,562,179,92.38744015553375,3142
b0ba0340-9ec1-4727-91d4-e71535682add,Residental,0.27361131877899714,25,49,325,564,239,19.26264000050382,7518
6812e02f-6a1a-4996-9d45-4b559ab1c1ba,Residental,0.31673053068786794,6,26,528,1112,584,37.375011239327804,9892
960e2ba4-bdee-4cd3-a564-cf34e949fb4c,Educational,0.009539816062138384,15,7,377,1001,624,85.69082736513926,9095
f4493b1d-4551-4c2e-b6d9-bce04b94b39d,Commercial,0.5063580004842589,27,33,275,510,235,59.5809641882012,3125
4625e4cb-4c4d-4025-9600-3a736fae27f3,Commercial,0.4326414661816861,25,20,451,1358,907,24.813624002371984,2912
88837457-2dab-457c-bcee-a96b73638d00,Healthcare,0.04643096172846761,21,45,3,553,550,33.161839932033814,2609
fe624bf0-fe5b-4ec3-a4c4-3cfb094ae52e,Healthcare,0.8592230856671423,50,12,623,1379,756,61.548549230082415,9815
6cdaa64e-b019-4a8a-9814-74b4aa506367,Educational,0.7247335198400908,38,8,74,845,771,64.9931270191143,9944
8a7eaeb2-ccc5-4c3b-b11f-494d3f90d320,Commercial,0.45293522743540315,5,25,449,896,447,23.313105999510064,8168
623e4f08-68b3-4a43-b100-99978fa9933a,Residental,0.45017215213627026,35,32,45,1243,1198,89.72929158269412,8107
d43f76f2-1bb9-45c0-9d59-5a402d99f2b4,Educational,0.9578818615137111,32,15,238,547,309,46.67926181639127,8970
ac056ce1-d621-43fd-8a48-512539264222,Residental,0.49961709396649223,8,5,565,866,301,28.88459444820437,8586
4d70b0da-0ff4-4a6d-80d3-390f2a693b18,Residental,0.4785438071125019,44,47,307,630,323,19.286580632475932,3642
4309ab46-1a75-40c3-9c73-16cf055c8070,Residental,0.2928624583294501,50,22,31,675,644,28.749387479006927,5614
f28d155d-2618-4b27-824e-73badd788f86,Educational,0.3983760599997298,44,15,394,883,489,98.21126513308829,3894
83a8128d-bd1c-4757-8142-bc5649f8598e,Educational,0.03534429318020138,21,45,572,584,12,55.98003621444398,4697
bf586321-7f71-476f-81e2-c7815aab532f,Residental,0.8446918987623602,47,5,291,965,674,62.43809190177689,7418
8b8407b4-59fe-486b-83fc-f91311b23aa2,Residental,0.8826829093398261,4,45,611,635,24,71.49429233629618,4222
634cfe2b-cdb0-4c65-8df9-14bf9254e938,Educational,0.9892448083141611,5,7,577,1051,474,10.945918405429971,7895
bfdedfd0-d5db-4717-beb8-b04e5a5ed455,Healthcare,0.8913754578529809,6,19,296,670,374,92.01015684557615,3933
2b4c1ceb-ed1b-4388-8bbb-7c2cf38c60f9,Healthcare,0.6193757427780963,13,22,366,1133,767,64.56863446035265,8370
d6b1cee5-efc5-4c3d-b834-b08937b8106a,Educational,0.02959058547806892,43,27,709,1128,419,73.21152704190524,6875
cb56253d-bc96-45e9-8a29-c5533c2109e9,Residental,0.47429008352623403,24,30,478,1079,601,53.57213773433544,5354
c0a79409-7bf7-439d-85c7-de0e2cd520ed,Healthcare,0.27210256139042177,24,43,85,191,106,81.20955497273266,6123
2a9eed84-c2fc-4a6f-9f38-f35e7661ff4e,Healthcare,0.9320650112529422,4,50,95,577,482,44.02501737599916,7885
2596b2cf-8cb3-4ac4-8eff-97b2f183f33d,Residental,0.9428433112133741,12,14,261,479,218,68.25152670521042,3195
7d514b99-6247-43a2-be27-61db44102b03,Healthcare,0.2200660408991184,22,40,94,504,410,79.50621787113704,9799
a2549bb0-d5d0-42b5-8f42-b6b4772b013d,Healthcare,0.6136801508896635,7,40,392,769,377,97.82805255834104,7720
45f34ffa-48b7-4b26-81ee-75fd45e6c9e3,Residental,0.9562117754433639,42,20,72,698,626,33.30235387568891,5675
5ef7fc74-ee76-46cb-9e7d-dac46b9d6d01,Residental,0.2889813433281644,5,21,230,373,143,97.06544429765185,2389
9c078ef5-c56f-4361-a2bf-6613adec17da,Healthcare,0.3576940637945042,17,7,140,262,122,30.056591438184224,7630
27304f29-5702-4490-9620-e7359941984f,Commercial,0.23379719544449873,20,7,373,638,265,99.19914946509114,3490
19ffe593-01b3-4741-9aaf-fd5c89e24952,Healthcare,0.2070138573521545,28,41,543,945,402,51.98465803393921,4266
2d8f250e-17fd-4bd4-9523-ccc4bfaea7a7,Educational,0.5837124178981371,11,48,370,973,603,38.73886301062759,5454
79e11270-e497-4fbf-a1e5-c156ee348c11,Educational,0.0932987922529942,34,37,42,951,909,24.014265940970507,5532
a44473f5-f1b9-4119-b0e6-d390d349fcc7,Healthcare,0.1840983185595152,31,15,109,885,776,14.405019757716513,2477
103d39c8-f6c2-4477-bbb9-775c851cda5d,Healthcare,0.5674895520418944,16,12,21,625,604,12.918094334818697,5523
dc604ae7-1b70-4fca-94e6-8bc0de3502ee,Educational,0.3021613022551417,1,25,248,827,579,92.25295511049772,5538
82d5e3d2-16f7-4e85-b9be-6ab72f1e4506,Educational,0.10863456035914221,40,20,359,786,427,19.52088318301525,6875
c7c06999-0660-4846-b55a-80bdd74bf2d9,Residental,0.8604310777525257,45,16,365,410,45,71.55616572908436,1143
17ce46e9-ec0b-4482-a201-d4b8cac7e03b,Educational,0.3628728247143125,20,1,117,1188,1071,69.69372435847487,9499
780233c7-40ab-47fe-8fd2-2080eea21c5f,Residental,0.1269586334707412,20,29,257,1230,973,95.56948320160146,9744
8a58e531-9c89-4656-b8fe-965ce3f7b3a4,Commercial,0.08944953704454695,8,50,252,417,165,41.685030945983144,5736
ebbdad79-ce4d-4942-b0af-b4c4da94a614,Healthcare,0.5417639194179398,37,4,671,1327,656,16.432524544781543,2777
128c5e80-b2e9-4469-b058-8cef00edc1b4,Commercial,0.9529396795161826,3,18,382,816,434,24.558416554570286,4252
27ebc57f-7ed5-4cf1-a690-45cc7abe163b,Educational,0.3102783098164261,9,50,719,898,179,83.73672737362475,6617
77ee9d20-ada2-4f0f-abe6-bb297ef0b0bf,Educational,0.44605273761788267,29,30,709,1236,527,32.470061435178565,9958
dca1910d-a31b-4233-b632-3fb17e5442e4,Commercial,0.08494808158785383,14,50,27,712,685,65.87871059192337,9234
28857809-fa30-4fb5-8a43-131418654a79,Educational,0.32565002925195163,48,34,140,759,619,32.54199497381331,9029
080753ab-af8c-4d6e-a3d6-9d696d480359,Residental,0.4184332637793665,28,31,158,1321,1163,87.93960071978091,6103
d8b7447b-d340-441e-a975-58bc49a07ae5,Educational,0.33446685364061224,31,24,676,936,260,40.01040488487231,2670
d59cc8fe-7f6a-4b37-a42d-b8806ca075d7,Residental,0.5743462808923878,40,26,485,907,422,89.87423408631841,5380
0acfdad5-2ffc-4b8a-b45e-590018d00031,Healthcare,0.19955560597001176,5,48,434,768,334,30.463553842795868,7549
91a63f79-9ac5-471a-a544-3c897f8568a4,Educational,0.4138887991268506,45,19,649,1266,617,31.164523140357485,8369
555e3469-dd10-41b5-a9fc-dd73f811d28d,Educational,0.8863584778756328,30,8,31,881,850,26.54853209335935,2843
6c8d2d8b-871d-44e1-9d10-a177ba27de06,Healthcare,0.285286927880533,30,38,149,1268,1119,72.22113613384315,3914
11e29928-8707-4740-a40e-f37892a24646,Healthcare,0.6544872617484443,18,17,51,318,267,46.64072429368872,4859
412f2f52-2acd-40c9-9164-0a774df206a4,Residental,0.9036470659232803,6,33,633,1330,697,17.844821254434358,6340
bc5c7ee7-4e47-46cd-9948-2dbf0f24c0ff,Healthcare,0.3824703217747991,12,25,328,1079,751,10.49584145495325,7628
9ce05cb3-17ec-4511-9456-bb0517ecbb8f,Healthcare,0.05376066962911297,44,12,370,502,132,97.2046714180585,1491
badf9a7d-a073-44b6-b743-cb30e0162365,Commercial,0.9985552934369853,41,18,81,1240,1159,81.64082786825212,2770
38630d2c-2d5b-47d5-9c20-d6af787e72a9,Educational,0.6867073536964245,14,26,383,905,522,49.008632880508785,1181
7e56621a-0616-4ee4-b930-2e6feaf53199,Educational,0.6046188381045403,21,6,527,1287,760,70.81558232886299,8874
90548c52-0d04-4e20-99b5-fb1871bee405,Educational,0.9896100484767614,7,40,72,97,25,20.350721488083476,6801
425c032b-2722-4820-98e6-e1120b02881c,Residental,0.8721299892756847,18,33,406,708,302,76.01899592678762,9889
2e0470c9-b104-4314-904c-ec500ba96a22,Educational,0.4350373257269271,26,2,441,1143,702,65.3699370275398,2952
9eaf0f0a-5921-42df-b05b-431be72615b4,Commercial,0.8527030260523822,19,3,509,585,76,12.776968798622974,4252
a4fdb952-81ab-404e-9d86-37b387a29678,Residental,0.1999978731622254,14,13,598,1155,557,64.0239711512402,2123
55b2d08d-92ca-4506-aba0-bd89e560c581,Residental,0.9167290416033052,14,46,269,1210,941,29.327993521817962,4134
c95caf46-78d5-403f-b972-b264ee05e8f9,Residental,0.009894173439270348,2,49,47,58,11,91.10190090980234,9904
a6dae1ac-08d3-470f-bad8-512e7605711f,Healthcare,0.5379195967971324,27,38,582,1088,506,44.4469111823538,4921
5725ef35-9b73-47c2-8238-665741e21686,Residental,0.3779908136612997,41,26,421,1229,808,24.747370456963164,9954
3d94bf7e-d9ab-44d1-9903-2bc343dfcd81,Residental,0.45548211021807405,46,19,238,694,456,89.92480766070474,9118
0c939389-6b73-4d07-ae4a-e4ed9b16da16,Educational,0.01448402369516355,4,34,671,1069,398,51.691805909016914,4107
9c2743bc-8d05-443c-a50e-ef5010b80cf7,Educational,0.5147520978530373,44,33,492,839,347,59.82366190897267,1492
19526d89-078a-46f4-ab98-d46dc51eaa81,Healthcare,0.8896029134036465,16,15,719,1183,464,27.162889903457387,4723
17ce018a-4de7-401f-bdfb-d649467c43ef,Educational,0.1414336176878821,1,15,195,425,230,14.165357826304504,5351
aa96f58d-6797-497a-9f0e-2a60489fdf06,Residental,0.6254603699398775,1,46,247,1418,1171,54.441451923866126,5501
cb6c3230-242a-43f8-8a5c-88f3d46aaaca,Educational,0.8549805811837368,48,47,183,271,88,99.31462389956391,1302
201065ac-a198-4210-8ca9-893ffdce3e5b,Commercial,0.4822308379061584,45,20,164,468,304,80.8813905378062,4552
99242b0d-6a55-4460-b1c5-4c61953c46f9,Healthcare,0.6708595189509206,24,8,156,1151,995,83.97409133109386,4342
fece12b3-12bd-4d3c-9b2a-f332ad892f2d,Residental,0.5091837958114146,23,20,67,95,28,65.39927129171765,4170
6a118e75-8f91-454b-9310-b0c22fd8b779,Commercial,0.4009101483534271,45,34,280,881,601,57.93684377452053,8216
5e4e102a-a9e3-49cb-9c22-521bf9a6c392,Commercial,0.5116841263584785,31,14,13,99,86,11.837213433955034,2748
f5e275a2-3f07-4e05-96a1-98c5cfbaf120,Educational,0.8944255661782213,10,34,685,938,253,15.124355737544978,8426
bc0ab46d-7040-4e1b-8e9b-00977f08ee35,Healthcare,0.00694852937360857,41,2,334,784,450,82.75435389867653,8076
5c776b43-2650-48f7-bcae-8a1edd7eccfd,Healthcare,0.3377801557387716,47,42,264,797,533,37.640466103402574,9692
63aaab67-bde1-406d-9cc6-9c90bcb217ed,Commercial,0.10490320288554367,47,12,163,680,517,87.84534730064165,7024
2241865b-cbb4-4f31-a47c-1ed033f866a7,Residental,0.6234676350433156,10,36,54,85,31,84.96845205240473,3700
27544392-fd6d-4cf4-9e44-d341efcba2c1,Healthcare,0.526210235319282,10,20,169,1096,927,80.10931041870079,8161
0631cf85-8287-4986-8afa-7ec81fbf162e,Healthcare,0.25750792495853325,41,38,18,239,221,45.98663101985705,2137
636e55c2-12e6-4907-a1c0-0b156cd997e4,Healthcare,0.21669636577278883,49,47,466,837,371,78.62604659167249,5605
83f5e53b-d865-4b8c-b55f-a222c167a3a9,Commercial,0.06271237619041237,50,11,470,853,383,38.19322799484265,1605
9669ac36-3705-4ef7-a33e-a66e8614206e,Healthcare,0.8009448775794428,24,15,106,1398,1292,28.89369104942934,8888
c7c9914a-e2ec-40ba-8231-70ca8a7a2342,Residental,0.20964721317724888,47,15,537,654,117,94.50894571887298,6268
f4879bda-8c06-48d9-92cf-f26e71754ca0,Commercial,0.7311942343992923,40,22,247,957,710,65.43778026522008,3897
dbd19b91-3184-4071-8026-fb94a3ce7a8f,Educational,0.5141210281770549,1,42,189,863,674,25.417715672761375,6479
7da83a93-5170-4236-812b-f93156219c07,Commercial,0.3493786465040801,47,36,532,741,209,58.928253369633936,1882
313da368-cc05-4fd8-9ccf-9b0a8e5333b5,Healthcare,0.9661201343173043,26,40,120,1150,1030,39.56926770483318,4718
4c194f73-7b67-4e27-9ea2-b125a8c14a41,Healthcare,0.07296300536256362,17,36,34,971,937,17.817692984524584,6259
04b1e4ca-b624-4458-8b07-7df1aa928b72,Educational,0.5475683040145116,31,45,690,792,102,42.07600829761302,4335
68811a28-5b0b-48ea-9240-90cdba6c3c04,Commercial,0.08840096834127409,2,31,518,664,146,75.81140432977652,5513
fc8d0bcb-4285-4435-8b59-991efb25adcc,Educational,0.3457183070657861,20,4,228,338,110,42.70856312993468,3423
06a2b967-f804-45b2-917e-7cc87fc62a2d,Commercial,0.6443945902473296,19,41,202,1095,893,73.77100289304084,6273
17d461d4-b1b0-4e1f-aa13-683c55033cfa,Healthcare,0.570234035802442,26,49,286,927,641,49.186164283228614,3335
6f367955-7f9d-4e80-9649-0ba8024146a9,Commercial,0.42850596117517303,43,1,410,498,88,49.11022706163558,1466
3fc1cdc5-18b3-4279-a95b-902ff4672134,Healthcare,0.4774956631747912,12,29,455,962,507,16.85228971622032,1581
c4595784-0e8a-4a9d-a9cd-8a1c1ad2569c,Educational,0.6201360183648438,31,33,659,1113,454,83.42920713231159,3199
53b45e91-57c9-4468-ad0c-f4cfb9e736f7,Educational,0.3335820227329185,42,43,109,836,727,94.38568065396046,4078
48e0703b-2f34-4569-b2f8-075d9862b116,Educational,0.286729247019628,2,4,520,522,2,90.0696747287284,2625
44d44cb2-0628-4bc9-a473-d1a42f13ee86,Residental,0.45420105316699544,5,13,342,650,308,12.587448632733844,8587
80cb2ef8-290d-4925-9e7d-6804fecdb307,Residental,0.7755263116365025,46,34,36,1113,1077,77.22335719562079,5949
7f81cae1-f574-4889-bdf7-0c1d807ba991,Educational,0.8535536974146755,49,19,484,530,46,19.99168506925597,8562
305405af-167b-49e4-9c91-da173bd6c76e,Residental,0.7135211595246029,40,29,56,583,527,38.06268499474321,7361
6c2c82d8-f836-44a3-9ecd-4b5ff6899b08,Healthcare,0.04069891144990567,47,32,437,1081,644,56.45406682533765,5115
022e2daa-7dfb-4266-a2b8-137613794522,Commercial,0.6989168195941391,33,5,239,1363,1124,11.777198230175905,5090
4b36cf44-0f4a-4cc4-ac5e-aa650fd8986b,Educational,0.7572775648770678,49,35,362,1123,761,74.95433233753779,7553
ff34b2bb-dac5-4b95-98a1-61c33d216c07,Healthcare,0.28986282862109447,47,32,706,1370,664,25.32547133637215,9875
f153c98b-7e1a-4157-bdcc-38e4afaa93f3,Commercial,0.192451442831319,26,44,198,1185,987,80.0376514942535,1905
64ef5df1-9e59-4590-9d5e-c83af069aeeb,Healthcare,0.3914811750081274,34,1,639,959,320,61.44199104060633,2042
fbd2b0e4-f5ab-4768-afa0-930d5170bb33,Educational,0.23678441136939055,1,45,393,1099,706,96.64001620345945,3051
bc660989-e760-487a-8970-b61e5859732e,Residental,0.6280842563562627,8,47,67,823,756,13.7479641045651,4578
1e3e0faa-255f-47cc-842b-53f9f3e4bb8e,Commercial,0.5991245378346748,5,26,94,885,791,84.21927640921007,4742
4d65234a-b0f9-44f8-8d7f-6931c056c68e,Residental,0.005760020442527769,49,29,509,684,175,44.44325552303213,1594
6a142d8e-c65d-4c7b-8ccf-e874cc5e0e92,Healthcare,0.5371400622237101,36,32,372,621,249,68.53768519844357,3533
35223982-7a96-4fdd-830e-d0a5a4e26632,Residental,0.3736133421464578,38,40,549,629,80,80.23682850256445,8010
97a120a4-4a20-400b-ab1f-11d5cb282791,Healthcare,0.8387492659319901,1,24,294,1178,884,66.40528692593455,6702
1579c606-d3a0-4ffe-87a6-363b9fa1281d,Healthcare,0.6822912357032148,9,40,260,276,16,92.62430545717389,5014
c14ce3dc-b9f8-4f17-bb3c-747e59d69d4f,Residental,0.7239183200666949,50,17,204,506,302,69.7190494638667,5526
df8d7a6a-865f-43fd-9b07-509bceb9ee03,Commercial,0.4848828143770494,41,30,203,674,471,39.862704751787035,6830
ab921e2f-4cea-4d3f-92c5-78c660b28bec,Residental,0.6478683101932907,40,42,456,993,537,39.257470624865675,9295
635c6f1e-1763-46ff-b248-92cd26770fe0,Healthcare,0.5080134302307211,40,35,121,1270,1149,36.4483911345105,5917
971f859c-ea6d-48f4-8e07-52454b26480e,Residental,0.6406448617747186,46,42,171,1072,901,18.642568178934912,8712
39782607-464f-480d-b4f9-2925ebf7e271,Educational,0.6917449015957743,1,12,580,1014,434,22.442139390275486,7700
853410d5-bb41-4a86-9021-d8495a61ec8b,Commercial,0.6554267603503885,7,12,649,945,296,67.38674745319821,2654
d1fd47ef-60c2-41fb-a8d2-ee53dd90bfa3,Educational,0.9164561883037767,50,16,716,791,75,77.96064397260724,9573
01454247-de41-41c4-bbb1-7cf12f8c173c,Healthcare,0.8345707424035582,40,15,640,709,69,16.672407649730186,4589
f25e1088-92d8-4351-b9f2-3a703accde49,Healthcare,0.031066076060770276,37,12,8,1030,1022,35.73067346737636,8041
bc1b7f16-8c4b-41a0-b59d-fa1390a97b14,Residental,0.15475167180069083,41,31,363,409,46,51.98931592800948,6115
994ebb0a-f1ea-4d00-ba6f-e7e3504bb865,Educational,0.30109373885149626,29,20,363,1385,1022,55.788942371861204,4227
5f1195de-a6cd-4708-81e3-7e3293a818e2,Educational,0.8957453707615148,10,33,669,754,85,81.70813251051531,9560
9774bb56-6d57-4f7d-945b-a15d70e40bd6,Educational,0.565217568917885,1,21,499,857,358,39.18147996249676,4218
e39d67e7-4dde-4e39-b5d4-21bf6b2ac607,Educational,0.7077565674459754,46,41,400,722,322,77.09851626784064,6236
2b44fdef-c398-4dcd-bfd0-4ba159fe089e,Residental,0.9850709051600804,6,13,403,1102,699,14.938719859494949,3976
ec6bf4a8-630d-47e2-b193-44980d26a86f,Healthcare,0.7296474591164235,38,6,162,1080,918,15.161094798516475,7158
3982aeb3-c44d-48cb-9304-06c525377229,Educational,0.20221824791786247,41,36,38,1010,972,95.55163802328259,8457
0a97022d-7981-44d2-afbc-0ce4a55f0ee3,Residental,0.7780820299015672,15,46,132,347,215,26.445706494863803,9088
4f491599-9dbd-48fd-a030-18eaf399024f,Residental,0.5884894545944436,27,24,68,1023,955,72.6438444638631,1783
526b8878-43d3-47aa-b16b-331b3440d5e7,Commercial,0.5959006148155565,49,41,480,930,450,79.15660273552518,5483
9d5e91fb-a6c8-4b24-ba7e-76bca1de9e84,Educational,0.044455841114804384,20,8,640,1300,660,85.82135282238505,4200
311bcb1e-1651-481f-b87b-eb0cf82614e4,Educational,0.3361631881941881,12,39,574,1028,454,53.48875056618645,3154
97786c3e-2b70-4de9-aacc-45edddeb16b5,Residental,0.8757491302948174,13,31,177,198,21,96.2850656264169,8722
922ae64e-eb37-418d-b4af-d93acef0f4f7,Healthcare,0.38740481240296076,14,22,192,886,694,38.316790048328485,7638
e2ed0537-3ea6-4c59-9516-b912dd305df5,Educational,0.9216254340953247,25,41,335,984,649,82.87504424885464,4305
4adbcb90-4312-4db4-99e7-493fa1abbeff,Residental,0.06011456553734151,20,41,70,82,12,12.7367671264917,2774
9ad31080-2352-4dee-8108-022c3e33d307,Commercial,0.9633866305429284,48,48,600,1242,642,85.79631758180079,7626
a7f1bfba-29c8-4c9b-b6c5-64f0e4b0c84a,Educational,0.485865466281019,48,24,579,697,118,79.15258579919157,7963
77837d3d-15be-4dce-b79e-96dd293fef9e,Residental,0.9409177136710386,5,7,18,214,196,28.091570675626258,2918
54dcadbb-1e11-4f1b-a417-cd70f4005ab4,Commercial,0.07207077820381735,19,33,485,1181,696,73.18530576883371,8501
38f82ab4-bdfd-4303-a73f-b9fb3c9eaa9a,Healthcare,0.9239696616357462,29,34,613,923,310,56.3985759761101,1989
d316bf0a-8da4-4aa7-9af3-4147ac8a6f18,Educational,0.5471513360908674,2,47,226,762,536,17.285970716887867,7465
3d564f7e-5f88-40b4-9d46-4dbaac748674,Commercial,0.9665097431644466,32,10,480,1056,576,56.05709934141234,5507
9f62b717-01a8-47e4-99ac-93bb65ec529a,Educational,0.615154574072243,6,32,579,1007,428,13.871167366610102,6588
f4ba67e2-11af-4380-a117-300b7ef52804,Educational,0.7788207717708482,47,37,334,692,358,98.5586992801447,3398
f1847da9-b8f2-4796-9bcf-bb36654a4e22,Commercial,0.6724515874270326,41,20,532,1319,787,26.63472112074188,3497
2aa48537-727c-4a4a-85d1-9d342cee2840,Educational,0.030609127257156254,38,44,303,661,358,35.23567720224193,6838
83a9006c-4611-4e30-aac9-ca85b4085655,Commercial,0.38248847916106743,19,10,93,284,191,32.88436970407176,8026
3fe0551d-b17b-4b15-8a9a-e265598e05b4,Healthcare,0.5798032041112476,40,5,471,676,205,31.15722550297012,4334
f9d580d5-71a6-4b67-ae8e-cbc66f7ff1a7,Residental,0.11793317074981446,31,22,710,1098,388,25.959839159067457,4264
a8c3d7b3-c5b5-4606-99ba-e567f6fc3726,Educational,0.9484900138520974,48,41,130,1234,1104,87.28155882830065,5411
140af04d-d673-41d9-bd71-42e859eeba12,Residental,0.09390804936673725,25,19,338,1041,703,56.094995918173844,5978
84f31a1f-d043-4b2d-964c-b30314c3803b,Healthcare,0.3600858304198712,10,7,42,1172,1130,82.21055016476377,4027
a2ca7a5a-0436-40d8-af93-7f530e9a6523,Residental,0.11234069708903227,49,7,694,848,154,36.96462640425197,6630
2a69aae2-bbb5-4f1c-979a-603a51da6b9a,Residental,0.30785640413318616,39,48,139,188,49,31.901052076448227,6785
4efb66d9-1b5c-4641-9ce5-56c8eb07c950,Healthcare,0.8391560222505685,21,24,447,1111,664,66.26804617324731,9857
fbc770d9-b4a7-421f-b6a1-18c2c26dc676,Healthcare,0.37844502339478114,26,29,434,1008,574,41.823811722601846,2182
cbe5dd1d-20aa-4a39-a965-e66b38367b1f,Residental,0.7653853263155012,24,10,92,240,148,99.2102863231967,9846
a38bcde3-e5d9-4a1f-ad41-904950709fa3,Residental,0.7370247158907014,41,31,43,1107,1064,69.16114015603301,3441
78415ecd-1867-4236-b9a7-09f117e37f45,Healthcare,0.6564035100581095,29,50,613,1236,623,74.28415413650644,1857
90e1f1c7-a867-4916-9e84-d65562863fe0,Residental,0.029079102155970094,43,46,626,735,109,85.17832787428246,6846
b463f9d1-bac0-4ffb-bd68-23d9c71ebf04,Residental,0.733826018557397,1,15,346,652,306,93.12559009927534,1360
85ae1a18-5753-4218-8445-6aa20df1ded0,Commercial,0.8419263062793855,38,23,662,839,177,95.03938003244377,2281
e9df5bc6-780e-42a5-8782-1a6144f95434,Healthcare,0.5718749351054621,43,35,254,1385,1131,16.331177448762222,9473
23658de9-bc80-469a-acb4-fd917ed9a0b4,Educational,0.49901789715650346,41,17,544,633,89,15.192347450155617,4541
150cba8c-58c6-4a36-be72-066ba55e9f3a,Residental,0.04966189378469654,48,12,19,1389,1370,69.74587225358817,4465
65f04cc3-cedf-47d6-b8a3-af93f726abd3,Residental,0.3888827453665714,39,6,422,484,62,98.89310129567355,2701
8c503c90-231c-447f-81e5-bf0ac5dbaef2,Commercial,0.4989797364930839,40,44,535,881,346,82.14705568724344,9879
4f2bde16-c1be-41ea-af25-b03ca657096e,Healthcare,0.20674903993550897,35,6,224,601,377,59.52586037691486,4021
66086add-71bb-476d-bfb3-61f6b1e1ba37,Residental,0.9935594573171034,36,45,653,1040,387,36.14349905293683,5132
48825c51-7c5e-450b-bf84-cb87dcc4adab,Healthcare,0.824705780462067,22,22,231,747,516,53.08516865053921,7613
d7dfc78a-9074-4bff-9f4f-6a748486d3cb,Educational,0.6935405259062957,46,41,496,570,74,56.393389238645355,9816
86bd3b68-b4a3-4951-9b4f-c81a0d9af801,Commercial,0.18930908932264046,45,42,710,783,73,58.55906163080594,9928
6ff171ff-e9a3-4ff1-ba56-93e59e838b7b,Educational,0.0633725961437478,11,46,66,694,628,50.19699086792849,9476
9dbce8d1-9eff-4caf-a2e0-40c12a73933d,Commercial,0.5735461731888687,23,20,165,972,807,97.01687359800238,4212
4fc794a7-ceb7-4967-ac14-a0589a354b06,Educational,0.7426108706644408,38,20,550,1229,679,26.68209269798731,5919
456485e5-1a00-4745-89bd-9f9c3609bed0,Educational,0.5788322503941943,2,3,436,833,397,74.55466938007444,5083
951bd76e-e4ba-4c68-a44d-a5f9f2047ad6,Healthcare,0.03144443510160455,15,34,54,381,327,43.185262685575616,4018
378d3055-4b6a-4a02-abc8-7586cabdd925,Healthcare,0.1943153209868178,37,36,235,889,654,74.93121802819084,4789
ff1351b8-8496-4a79-9949-383b01896006,Commercial,0.22050901609474627,12,40,509,879,370,15.115013656415925,9100
84f36e85-f0c1-4417-a4fe-08205e370e1f,Residental,0.5435311185540085,26,12,529,946,417,31.629536613609176,1907
70782617-a6f4-4f9c-a9dd-06d0038354f6,Healthcare,0.03439205530510259,29,35,357,1276,919,19.55605602882735,1401
d10fff52-b509-4f30-b647-bc76023e80fc,Commercial,0.3583569133158041,21,9,181,724,543,14.190501677553911,2127
138dc7bd-b6c0-447e-a0b0-92e8c488ca51,Educational,0.8818056843755102,20,13,586,1148,562,70.00101377724347,2699
4f668923-6be2-46e6-bebc-814070f75d01,Healthcare,0.1359390371400282,44,22,684,808,124,58.32654687898417,2382
fdeb643f-cdfa-43a2-a50c-ae64bb4ac36b,Commercial,0.8578371679737015,28,36,645,1003,358,41.09545238985271,7034
8435d263-7dcb-46cd-81c1-6101a37a1a2b,Educational,0.16686489349794853,37,25,52,525,473,46.853864778364354,5929
6c74377c-37fc-421b-96d1-bb4528916b8d,Commercial,0.3856304687767441,15,26,661,1315,654,53.7880288607817,8595
16985d4d-29f4-4374-b798-37b5b58cc472,Healthcare,0.3778041941708268,25,15,2,320,318,69.55666303394449,2081
bd3d98d6-9687-4825-ac9b-4d1931733dc1,Healthcare,0.21085010005246974,10,45,350,1147,797,71.39900551992143,8486
2b2f8b79-856f-4c16-9f48-ddf37244f387,Commercial,0.9919347740089882,25,19,322,836,514,37.801690437430906,1844
5309778a-4187-4db3-a73d-4c86681ab1b1,Residental,0.1346823153379828,14,15,311,332,21,95.43388993969644,7427
dc4dad43-4f8b-4129-9632-fe30971d4b3c,Healthcare,0.6195382085225646,12,33,243,1422,1179,83.45490465443834,2821
dc9a2eb8-a12d-406b-827c-290594f78bd2,Residental,0.7423442410470219,31,34,33,975,942,45.86543649679265,9955
e8bca646-a651-45f1-b8e8-5980f1acb555,Educational,0.6445677259524393,42,29,663,826,163,39.942270168768985,3781
0bc86df8-cf07-4f69-97b1-830b758e1948,Commercial,0.21016508846591475,24,16,334,1215,881,57.07226175523654,3936
9b1dea92-c62a-4b89-b16c-867610b54802,Residental,0.5170956435693481,26,33,144,806,662,93.00194974992982,5120
2944b563-9cec-4ad1-a1ec-0eb446b8a790,Healthcare,0.9678760179120142,22,6,114,901,787,48.01151085706389,6101
50a3b860-49aa-4c57-8fac-c352c70f11f9,Residental,0.4247972795522392,16,40,70,788,718,76.34165723213675,9108
3e0ae39e-2ce2-45fd-9e2a-dbe26ae2523d,Residental,0.2667641984757846,39,34,162,583,421,88.44597008141521,7994
921934c9-823a-4db0-b1af-c3e76f101ad4,Healthcare,0.09785369763057084,8,26,72,341,269,27.668018599318394,5802
ae5532a1-9097-4bba-b63d-28c313f45c00,Commercial,0.8453349434917315,24,11,397,744,347,86.35277097729463,7119
509a913a-9c63-48e0-915e-97adbad1f30a,Healthcare,0.07285893450841163,18,5,48,536,488,68.1945372925916,7981
ca9cb021-1f31-443e-8afd-5362bbd70270,Residental,0.03450154025367114,35,10,547,846,299,84.87137447238939,2453
5847b5f4-1b19-4e3d-bb48-fa7885879bbb,Residental,0.2514991506716505,46,37,681,807,126,24.403973807694456,2190
4e7af83e-7e59-4d05-bdf0-bfcd6f6bf8af,Residental,0.4226275257256352,39,48,429,1003,574,84.15307494439263,5700
29bf30a5-82d1-46fb-89a2-7fec9637f966,Commercial,0.206868475057555,42,28,48,365,317,35.28712288747765,3731
b4caf0bb-f414-46ad-87c3-250c2b777da9,Commercial,0.4345035333832661,32,45,484,1022,538,66.17404306628235,4839
af1ba5ac-f18d-4951-9cff-89617b5e54cf,Commercial,0.3143286171193562,36,45,461,549,88,85.0381889760026,9397
2c2fb9e0-70b0-49fa-bd25-c3c51720428d,Commercial,0.7992208782012233,6,40,615,1245,630,48.70367424196726,5180
3e09c3f0-a98f-494e-8ac3-a3c605260611,Commercial,0.842402644969809,6,25,61,1235,1174,10.201953785816844,6307
f3c8e224-6b86-4dea-814e-7c95f500b58d,Commercial,0.7713742169799634,14,28,529,988,459,99.39297390183482,4211
65ae93dd-3bef-42aa-824d-ea9740180f92,Commercial,0.6615346772942914,5,31,565,1291,726,95.82287574255815,5516
2b47e828-5f6f-4324-869a-e4c88d872459,Educational,0.7974071633364445,30,12,609,825,216,72.69357159689454,1997
ecd49cde-62dc-4ad1-861e-491c9bdf3fab,Healthcare,0.6251214902324074,26,18,275,283,8,13.435809340308982,9125
0de08a0d-2974-4eb6-8015-8617b39f5d4f,Healthcare,0.6729703569976474,7,29,287,1053,766,84.14527631863136,5200
27c02523-c92b-43b9-a459-0bde61917c81,Residental,0.2632992935067259,47,20,270,620,350,40.33961478770935,8449
fb246f79-df20-48f4-9acb-314ca8b6b852,Residental,0.42235772644991154,13,29,240,645,405,49.63228848082523,8021
caa3c1f3-e806-42ff-a29b-1dadf5afdec7,Commercial,0.7198316595410056,33,2,160,795,635,95.1964601991058,4781
bfc0d380-c7d0-4ec1-a8ea-277f18382a05,Commercial,0.32597275361965217,22,31,448,453,5,43.859074999309975,4639
50376ea6-4de4-4e88-b48f-da5ddec5e4d1,Residental,0.3496961143699515,11,9,459,904,445,87.97048343610919,5082
4a6e9f3e-580c-46e6-a793-bc5853665879,Residental,0.46169749909164104,26,20,390,1308,918,62.221898194741506,1667
99050aa1-9b48-415c-bcb8-ddafb16a2c12,Commercial,0.22714420365736265,22,13,688,688,0,95.62317564164519,3095
d67862d8-3c89-40da-9781-e3c996e06ab1,Commercial,0.6712119361926755,13,10,596,1193,597,41.56705195787559,7089
4e9412a7-83c7-45a1-903b-ed46122df3ab,Educational,0.3571751434415126,1,11,204,1438,1234,46.60990799063932,1717
4a493e33-bd21-4ea8-ba85-2b80f916eff3,Healthcare,0.4052399450639538,26,16,121,813,692,40.477373488255445,9429
0bfb8f33-b57a-4e7f-902f-acde16a60e08,Commercial,0.2543640426375108,29,49,424,1334,910,53.405204692633035,1201
dc4bf75b-cbbd-470a-af7a-d45c9f8b0968,Residental,0.18028614483596228,42,10,459,971,512,74.58913965946631,9846
114a89d3-f6a7-4d12-b09b-e7ce18ea59e8,Healthcare,0.589570356762467,8,4,317,814,497,72.86849509013925,3465
ebbbf34c-8400-4820-81f1-113b1edeab21,Commercial,0.20426707852593728,41,7,91,737,646,26.8174608429384,9591
3085e4cd-02e8-47f0-a663-60acc4a1e770,Commercial,0.5039056663998753,43,6,612,1425,813,12.795298712427039,9676
84d9ecc9-dee1-466a-8438-8a0b60aaa0ba,Healthcare,0.16246437607005226,32,25,456,1265,809,88.7345806679786,3471
804b3b59-99c7-411c-8b7b-332a723a93a7,Educational,0.6967263671238892,41,50,639,1063,424,39.894346708080775,9264
9eff23e9-7b9e-41b5-be7c-31e91fc47d23,Healthcare,0.12810558172849307,50,2,70,783,713,91.51198339785152,4972
11fb3b6a-5fb0-4f2b-ba6d-c6b3ea7a6768,Educational,0.6250981138581103,32,25,12,1110,1098,99.79065124835368,7348
4bcfb89a-0685-47a6-8df0-809b2ba4eb83,Commercial,0.4962278937725473,45,50,149,574,425,12.512398692234058,9321
f1443174-831c-4805-b761-156a120f17f5,Residental,0.2556051635558563,1,40,184,717,533,19.667061571077646,8476
5b7863de-b131-4f04-a50e-62b74e06d949,Commercial,0.5266242589094621,35,18,498,1278,780,53.67611641765492,5399
a0fa1f5d-a23c-4267-86e1-45f2cf3dd397,Educational,0.09201599927044857,47,32,261,266,5,56.34942109282987,5198
d907a4fc-af66-414e-8305-648c3711fde4,Residental,0.047171954921443215,45,41,638,1006,368,67.54648953513475,4436
69db7339-df70-4bac-bcf8-c75042761e13,Commercial,0.6931036025375993,47,19,592,723,131,63.716137715931445,3545
89d60c71-87be-42b8-baec-128495025e54,Educational,0.03133295004090808,6,26,665,1152,487,62.2817707691791,6303
ed55430a-4890-4369-8614-419fec9b0f6d,Healthcare,0.3556813078119182,23,27,121,1169,1048,11.69090957203567,8489
088de14e-8c15-4c40-a807-41ffee90e9d1,Healthcare,0.2713832667654622,17,45,442,1169,727,46.17347964452242,9089
dc2c5e57-5e7f-4c4a-b365-6e585e640c59,Educational,0.23889854103189745,40,44,479,980,501,95.69832874839423,8577
7c18a070-1590-4471-a555-466f55b70c09,Healthcare,0.43861569285652857,47,47,655,812,157,31.942272211642,4321
51f813ad-d57b-4a12-8404-b14da1da8dfb,Residental,0.5790571763129037,43,15,433,1386,953,56.984285532344565,1356
55678dfa-e11e-4031-aea7-69946dfa3db0,Commercial,0.6037478226902008,23,40,533,653,120,64.85394460736282,7257
aa884154-6af5-4754-aa39-156f943a83b4,Healthcare,0.3671312305640605,35,25,339,1270,931,78.0109307646176,8227
47149017-7442-4519-91d0-dc3ff5916a85,Educational,0.5653563472155417,7,41,308,805,497,70.81951772927118,4765
fa41a96e-17d4-4b69-a8a3-35a6aa578add,Healthcare,0.6002117925270045,29,42,463,565,102,38.61645755444026,6141
91ea7827-00e9-4063-81e8-9b144af6005d,Educational,0.4335102338201279,46,21,648,1110,462,86.72665820381326,9656
ba4a17cd-313a-49d7-9860-81dd26683ae2,Educational,0.6898207725389595,40,24,224,257,33,14.473758504882479,8457
453f7a62-dbed-444f-b033-75f94e12ff82,Residental,0.5297530149698274,40,25,472,1060,588,94.73066709839236,2998
da095c3f-eff3-48e6-84ed-deabb53b09b8,Residental,0.4021296283403919,47,19,389,1235,846,92.4566890113502,2360
e9920347-8d6e-4e97-abbf-909ec9945c3b,Educational,0.7630766977777917,45,46,131,678,547,59.07164615839415,1831
6857d9ec-caec-45fa-af84-47a909f2409e,Educational,0.846173624729913,27,7,43,710,667,58.41333373802788,5635
fc4fba0b-64d8-4bd6-a55a-37f83bb16f65,Commercial,0.40179534818833995,11,46,681,1057,376,19.36425122615904,5151
254521d2-a850-4988-b5ec-041ee9178073,Commercial,0.5825511014553013,3,15,715,1238,523,59.637374119969365,8963
ee2b9d60-0374-4198-a5be-fadc74880cd4,Commercial,0.6867734636082464,18,45,401,1305,904,96.4440534107184,5383
241c1ee4-a615-4ba0-bd10-25d17fb13f10,Commercial,0.6570564680810675,45,27,153,1276,1123,50.70317324867037,9700
e729c59f-10a1-43e9-8146-31464e3f511b,Residental,0.22270519067870753,30,26,297,626,329,15.425428943876557,1688
f67763be-1bb0-4cd6-ab7b-481365724207,Educational,0.649758732367096,35,24,357,846,489,15.17152841061241,8488
ec45bc28-e87f-4313-aa62-95ff6d100c9f,Healthcare,0.31078133083289183,29,19,544,926,382,39.652561166886585,3659
88499ead-a9a8-495f-9bc8-04fe17c03c83,Educational,0.1507011531656106,2,15,515,750,235,67.25688072202198,6406
71eb4167-c82d-440d-98d8-51be4ef26f1d,Commercial,0.943635748381872,34,10,495,1229,734,19.421127593575854,1805
9e6b2af5-47c8-4552-9140-6a30720b1212,Educational,0.6469748033175895,19,15,235,1203,968,49.1188178461067,9152
a1945806-601f-4a4a-9d03-e2bc809f7b60,Healthcare,0.9943348173081592,7,34,268,471,203,15.14608354859654,6439
ef23ded6-39cd-41e7-9c1b-efa3fabe6750,Residental,0.6224636146037161,41,45,256,1162,906,43.793502391309296,7465
6baff5e8-59da-4616-8d87-d3f052655cbe,Healthcare,0.9137722973145458,45,9,694,818,124,88.45831759629282,6437
b969cb0e-6557-4e04-a07c-28cc812216cb,Healthcare,0.8037337769378837,25,15,510,797,287,82.80518812639245,2254
c2c9adc5-ce17-44d8-89df-d2eead5cb4f2,Educational,0.5183862950769764,25,47,494,1097,603,69.8193794599758,7406
403af88a-659c-4ff6-bd58-0af314935d74,Educational,0.081439936884943,4,42,558,1288,730,99.4873830515312,5640
51836990-a449-4ff7-87e8-597573f058c9,Residental,0.8544574410633186,30,8,433,1398,965,74.11927768011387,9688
541052f6-7b02-4fde-830b-f5e1e1456055,Commercial,0.95699347775241,10,41,369,995,626,11.068740896495587,1369
d51f9e2e-e8d9-4d34-8ae9-fe096209c471,Residental,0.9144609395547265,26,26,416,1015,599,94.6369763675598,4214
57fb66cb-1865-4292-99d5-4504dc23bc3a,Residental,0.8896417747748249,22,30,1,1288,1287,53.93949662293733,1872
934625a6-60a4-4f83-abb5-805fca2f1fc0,Residental,0.937708786024301,7,31,564,1189,625,51.389630984795296,2423
e3942d3f-2267-4e76-817c-69b22a0e6a4f,Healthcare,0.8349554106408206,6,9,692,1294,602,33.86949392635911,5416
78c99612-29c6-4087-b3e4-ce13ff64663c,Commercial,0.50369796866495,37,2,528,1031,503,98.4836769623511,5750
21735e85-d7e7-4490-8125-72ae99cfa7db,Commercial,0.22451551924223723,13,11,720,1409,689,17.661229934742515,1260
19b6309e-94d9-4b11-b2ce-e52687ad3c2f,Educational,0.48254146564257194,44,23,429,1375,946,45.99428670560471,1460
f59bdcf1-d9c1-4628-8149-473524e4ac93,Healthcare,0.16062039452011867,30,31,635,1408,773,45.4755045247705,3447
8f8b918e-ee0c-4d92-8ecb-222df2a1ed61,Educational,0.32269630430035334,49,44,401,818,417,41.72601908059104,8540
037a9c99-bbcc-41e3-bff1-5a5a8dac5e6d,Residental,0.18692157395136466,41,24,274,490,216,97.48457959995365,3333
aa7320e0-b570-40d7-bd0a-669167c7141d,Healthcare,0.493752101353481,30,3,633,667,34,39.67856615753541,6577
4481ce24-3518-4407-9df5-942fc8d783fb,Educational,0.9859466050994228,2,11,399,629,230,75.4560117994047,9879
924ba391-3f88-4371-9b11-ec38862b31ed,Commercial,0.6885221237409812,38,39,624,1277,653,70.3077149640126,7938
8754bb62-dc93-4e78-a97e-286c0f0f8d15,Healthcare,0.8009968632329058,11,21,215,322,107,88.39134798470597,1412
17a18e0c-e7a5-41f5-96b1-0b049865f957,Educational,0.34530746320168015,36,49,112,732,620,67.69831898132665,6501
f3cafe90-10bd-4698-bb14-d5272df86d32,Healthcare,0.42250293958977336,7,37,566,1144,578,55.86819834969469,3003
4ecb1b0d-2f9e-4a99-a2bd-f9744759c340,Commercial,0.866572171132585,45,39,221,677,456,93.20478319610096,2447
95ee6fb0-7e18-4aa4-ac19-ad89a54aed61,Residental,0.0036019067520881576,42,8,408,1369,961,27.12816089580006,3805
5c16ef51-d8e0-4508-bbbe-e50bf59ebd44,Healthcare,0.5378906320546051,6,11,415,1316,901,24.580553887006214,7754
eecda850-e7f3-4736-9708-75ce9a189ec2,Educational,0.371120924697362,39,2,541,1234,693,43.593248730583234,6708
2130fde2-555b-4b60-b838-734b66fd9607,Residental,0.2988855782215214,26,38,562,1405,843,38.555186890374294,6315
79dafb38-c281-4c27-955a-9444d818122c,Commercial,0.6492054063817225,24,14,58,1379,1321,84.86121095536438,8974
a85819f4-a029-4b48-8442-2d5b28287ae7,Healthcare,0.46367747156374894,12,48,117,1281,1164,60.18560053711217,8842
57ada4e5-0e75-4477-9e22-1ade15895f39,Healthcare,0.3681876210702787,37,41,345,1325,980,71.05523480778588,5458
838174cf-ae5b-43a3-a33f-b0b8f911f66a,Residental,0.8656279646443202,1,34,365,1398,1033,63.68086745622481,2714
28ab0aa3-0d6c-4f6d-84aa-9d3b43e566da,Residental,0.4803926469361862,50,24,518,947,429,51.63182430112556,5591
71f6a430-f8fe-40a3-b584-1ad002c87f9e,Residental,0.07205455395447391,10,27,555,897,342,32.827931910195076,2498
3a3bda24-9698-4392-8a34-a79811360cec,Commercial,0.0685902467656817,15,35,464,1176,712,82.60733608796548,5179
112c5f5e-a770-44bd-b945-2d2fff5c298f,Healthcare,0.4449844242954142,1,43,368,776,408,62.07773047143562,9537
3d1c81c5-1aca-41ee-a404-10d7b35d3bc3,Healthcare,0.3752391817054387,37,10,629,993,364,32.70657695041352,7045
f3f372d9-53e1-4a9a-a12d-e4f329a05a3b,Residental,0.8040496199439062,47,4,214,1099,885,43.61980800403739,1501
2f7ffac1-32f8-4e98-b1d8-e8a3c55c8f20,Residental,0.8096386084109635,33,3,589,1351,762,12.637773209974448,7002
659ab5f5-3519-4f83-94a4-6f90598f6a06,Residental,0.7775194941343136,32,22,147,423,276,34.498083185264946,7900
b1fb42cb-5d2f-4bfa-909f-1831d595b981,Educational,0.3976468399998837,8,31,110,1095,985,80.84674447961123,4099
09fc5405-d378-43a4-b37f-b3c2b74a5263,Healthcare,0.79187540429868,49,20,38,417,379,57.38342974690034,7789
a167c02b-399e-4e98-b082-95bd5b5c5b26,Educational,0.6186985791467625,50,21,462,1393,931,10.865239603028519,9294
8e97b885-7c48-4f58-b870-f2d20f6d63c3,Educational,0.44358163911966064,7,43,63,1358,1295,12.051433944347643,7690
17022c5f-39c7-4163-8568-797253092088,Educational,0.5620098959957771,23,8,262,928,666,47.71467726010749,4650
8e7060eb-f252-437b-a0c8-1c2a046eeb45,Educational,0.2766808751628177,21,1,325,1101,776,81.13202599928135,4182
3620fe5d-e34e-4a0c-84f7-4e956b31bf43,Educational,0.6461183184870997,20,49,2,1020,1018,86.8800704833803,5101
6fceeedd-1f28-471b-8f5c-9ad24d83a271,Commercial,0.9127398152636302,45,20,708,760,52,43.781477186431225,4822
c99a11ba-ef73-4cdc-98ff-71695c6d835f,Commercial,0.6944767721918392,19,24,326,854,528,79.75965027420786,9517
77a538b6-450d-4a62-9fa1-417a01b3f82f,Healthcare,0.2775222573725784,26,38,393,1133,740,27.592961769802898,2403
52799bac-80c4-4b9f-8f90-f1b5502dc452,Commercial,0.5317787092466023,36,34,576,732,156,43.37788523268293,3840
bb4865b2-ae37-438e-88b4-6898d143aff2,Commercial,0.2718215799608439,34,30,354,1371,1017,73.29648332476961,3414
83c1366f-1c7c-4943-bd32-41f54581fdf1,Educational,0.4715760199520148,27,13,65,766,701,49.504292722449556,1076
07280169-3447-40f1-b0fa-b709ab502810,Healthcare,0.718417911558273,14,33,716,776,60,70.88054297531873,4476
e19e04d9-9b6b-4d48-84f9-05383ae9c7a8,Healthcare,0.614252788308526,32,24,517,583,66,64.10780228137833,4277
3ec65743-46b9-4703-8e2a-3dfcbf877692,Commercial,0.77189681062876,45,14,392,440,48,95.35817889382831,4308
14cdd1b3-93a5-48b8-9e1b-3ecde353a9a4,Commercial,0.5789827621515787,12,5,716,1319,603,23.58462285362397,9340
5a3a7285-01bc-4f58-b634-151fcceca72f,Healthcare,0.055733064763866746,17,25,186,477,291,71.08364515560297,1049
fd220817-8d66-4831-83fd-a49c7ec91406,Commercial,0.8671956751432403,47,18,222,966,744,13.318201471950836,7305
c6f1f6ee-0574-42a8-a144-0f7baa71bb59,Healthcare,0.5981474632197618,5,43,595,1306,711,48.703793670897426,2045
c68adaa2-3edf-4168-9223-ad0c1f0eaa9d,Residental,0.11323968083789082,35,9,29,1386,1357,81.87583262934983,6194
9bccc38c-cf12-4e12-81a2-c4d980452050,Healthcare,0.9363077076969573,21,1,718,888,170,47.18210625399217,6062
e1072079-bdd2-4b07-a4ec-9c71c8a66b37,Commercial,0.6979185305970946,39,34,5,928,923,58.14244229091849,2268
20c61a55-cdd0-4d72-a1f9-1a38f804fd9f,Commercial,0.04547076394533389,40,28,535,1350,815,54.88039514042594,6370
31d99401-70c7-4a03-bfbb-b03d27daeb88,Residental,0.3230128287400703,38,6,160,775,615,22.157615619036385,8840
1eb9e76e-c2a6-4f2d-a66f-b6f1bc690a35,Commercial,0.5405725912267625,18,24,631,1298,667,12.843328622694706,2389
91c9498d-a41f-46aa-aa41-2ce07ad923fe,Healthcare,0.5981571863177395,38,45,162,647,485,94.23910365134735,3885
62628f6d-b7b8-45c2-a824-27ec23657c58,Commercial,0.3405909216494136,10,27,26,376,350,22.482079793982038,9071
0591b8a4-5bb6-4b13-ac7f-f885ef83f1b8,Healthcare,0.8908917007869874,13,15,261,1415,1154,51.02032995990782,9933
54ba6e2b-6c19-436b-b092-53e8b975f9c0,Commercial,0.9597141833600041,23,4,324,910,586,24.95644820717409,9618
af4cf6ae-3ac3-4473-a3a6-72ad8b6aade3,Commercial,0.07392081831347874,5,1,244,387,143,96.70138629572581,8309
c9d1356f-170e-4328-a512-63e82f310646,Commercial,0.5518475440678116,30,31,210,1192,982,22.222112871713968,4240
8f67a66d-4a03-47f8-849e-42559c2245f3,Healthcare,0.7664952317523126,17,33,472,1044,572,22.489374879874745,6969
3d7f61f0-b012-4d44-baec-7cf63806f8a1,Commercial,0.17212592638140256,44,35,33,1188,1155,29.844415179887765,2091
774f405e-cdb7-4183-a4fc-da5c04ca890a,Commercial,0.9736963491124954,28,18,348,1429,1081,78.51376377001566,4629
e2689000-80e0-49ae-ae88-f0347d35e0bf,Educational,0.12653759274360332,2,10,146,1106,960,32.815273166455256,5817
8e3a668a-cd86-42fe-9b0f-6ba92eba1f13,Healthcare,0.38305665646508125,16,44,38,88,50,86.77626729894807,3121
cc8d175f-4024-4adf-b0fc-a0f45954f0c0,Healthcare,0.6005145308834299,20,31,514,708,194,94.49770805099008,4858
a0cc6d0c-f151-42cf-9100-dc31b590b576,Healthcare,0.2774256612814081,6,30,653,1224,571,21.178333370195237,1887
0132e848-4bc7-433b-8091-695be581b5b6,Educational,0.7829261549494763,24,47,546,1055,509,13.921856481798262,1000
de218813-238a-4130-bcd8-f90ffd6e47a9,Commercial,0.08312808441648678,1,5,719,963,244,93.77396519825987,1564
74d28317-04ef-4091-8224-728462cc8fe0,Educational,0.18175525180880303,46,21,353,1284,931,24.950331984008635,2870
1d1f881c-ba84-46a6-940e-5420120e6865,Residental,0.615357512897749,16,33,711,1344,633,46.74821117136746,4434
3c1be053-f864-4223-ac2f-b147469fdfac,Commercial,0.18758108722837952,13,30,451,982,531,47.578329794012,2143
69370d22-d4da-4ef7-8a8d-4052edb374a5,Healthcare,0.7307911242092772,34,18,347,850,503,54.8976116912228,8001
97481e4c-6c1c-4ceb-b0b4-5060077b863b,Commercial,0.7774789836940511,45,13,264,1027,763,73.05080871560942,8478
fe2083bb-e2b8-4d1d-8eb7-b8a2dabf55e8,Educational,0.5995075825782562,36,12,180,511,331,44.5835175507644,6470
321a482c-7e89-4dff-bbf4-80497f940266,Residental,0.7339509844370384,34,49,236,658,422,66.51131421599139,2342
03835547-89c4-4a66-9e2a-fd39512d2422,Commercial,0.26720696440905045,40,13,155,939,784,47.29509722063597,3770
d0fc2ef7-ccc6-4e3c-8b60-24fac169d5c5,Healthcare,0.30854148715743956,29,28,681,714,33,31.814729512292676,3556
a2f5c702-f50a-41b3-91cf-44b10fe3c9e0,Healthcare,0.7468594156306632,25,21,148,963,815,45.22116221893519,5645
2277f2b2-91ca-4003-9cda-dd8069f51f5a,Residental,0.1513721233988764,5,37,473,763,290,60.89447055228106,4294
c4368890-797b-40c6-a063-dfa73a90ce92,Commercial,0.46293017861234564,24,12,425,723,298,63.51164926253769,9051
cd8dc9b7-0a63-4335-b115-d0bd719490fd,Commercial,0.1600755579488543,10,49,500,594,94,50.35487939548964,4549
e159fba9-b0cb-4364-afd5-7f7fa900fc1b,Residental,0.44986172385644774,32,46,621,895,274,61.87950882154845,8421
18d3470a-2729-4549-828c-ca4a84d8f513,Educational,0.7928010150333723,50,19,202,352,150,49.097998903908746,1324
a38218df-c9a2-4c90-9a29-5bbd55b55d8f,Educational,0.7244935532301293,19,12,352,1052,700,56.25560043490548,1710
8b383e8a-bf53-4fa6-bcac-a7b614aea7a2,Commercial,0.9551865916060623,7,34,322,1093,771,20.80936454863088,4437
c5c76798-5639-4a20-a291-3372ca36ebeb,Residental,0.6615883638183225,36,15,252,408,156,16.287554919132514,4818
eaffd81a-2730-4ff6-8a05-8cface70d993,Healthcare,0.03567232375150564,13,46,610,1367,757,58.04440039994446,5696
e0ba4b3b-6add-4bde-a788-be1e2bbb82ec,Educational,0.6368056679180145,14,31,93,800,707,48.887053724933914,4202
23a6357c-52a2-42d6-b450-5a6d17f9d0f0,Residental,0.17614817655256843,22,48,98,599,501,88.99639183762321,4918
88225f25-4e87-46fa-a27c-0f25252d7cc5,Commercial,0.4092860708958723,12,9,540,1029,489,12.600304261943815,1394
0b4d80ce-5500-45c5-a70e-de628dee023b,Healthcare,0.10878997856458783,24,11,310,1178,868,78.4387176775997,9624
86996655-a2ac-412c-bc99-cbc5bce27faa,Healthcare,0.7557497375475498,50,36,462,1376,914,43.56337284337233,1471
564ecf53-e914-48aa-9ed2-a8bd8dcb0ae5,Residental,0.6189956228127299,22,11,660,1303,643,60.950182037650364,9375
13d1aa43-5b08-4a31-9ac3-6bf3a54ca2f7,Healthcare,0.899016526902814,44,28,702,718,16,74.15796360209943,3582
003f9b20-89be-4a88-bd8a-13acdd7708c6,Healthcare,0.5640023648733883,6,21,264,1036,772,68.60075021762745,7995
a32332a4-6d6d-407b-89da-db496d83966a,Commercial,0.09427809060011483,11,46,240,927,687,26.8829718224244,9899
35655c62-c131-4c98-bc31-5f7d70166d55,Educational,0.5680173357136755,50,43,57,1050,993,58.7380384298635,8711
5ac460a0-d5b2-49cd-9d98-32f8fb0b9da3,Healthcare,0.05560105058398723,29,16,700,1308,608,38.9848198043522,8147
51a00cf6-484c-4274-ae5b-5c7f849f8258,Commercial,0.02875808668258184,16,29,663,1140,477,16.551266633216628,1237
fa1d3950-5276-4beb-97b4-0147fd6baeef,Healthcare,0.09654666843458493,48,37,648,1285,637,66.02709772396244,6889
415d315a-3e05-4d0a-89bb-c84a1b0eb619,Healthcare,0.6929466818680861,11,11,639,804,165,31.92567427263041,5063
f01ddc8f-5636-47e9-a87a-0c2c5d762ca6,Residental,0.3938156256182028,41,12,701,1270,569,70.91950235197044,6332
d2567b81-ae50-46e2-98af-0d1552f0b18f,Commercial,0.45087393485955063,12,3,542,1271,729,11.746332504494456,4399
e25fed55-2768-41a0-8e61-d2b743d86a94,Residental,0.3555188602131326,20,14,201,719,518,53.32383443113809,2211
6e5397a6-9339-4c39-b8e9-faf123634db1,Residental,0.6410158350778258,14,13,345,882,537,93.81426081331604,7856
5b7b35b3-e945-4997-b0d5-92c709a3165d,Commercial,0.758442814430897,6,10,400,527,127,21.981402697840867,9634
ddaebbf0-d587-469f-af9d-fd8865846f6c,Healthcare,0.3013815708388572,29,12,633,1284,651,66.81825660138634,7644
30d7ad5f-258c-4f58-828e-a3602a435461,Residental,0.7412405057418342,31,7,282,1404,1122,10.442767327889836,1046
384e9056-5345-497b-a3e8-db7d42446d93,Educational,0.05992228369766839,23,47,695,825,130,53.824009694970755,5950
e0e14c36-6c2e-47fe-94be-486ff43f692e,Commercial,0.9190077448821226,42,23,632,1357,725,92.22018014188977,6644
5a7331c8-6a3f-49e1-8a66-4dfb1084a319,Educational,0.7156596957449803,4,28,573,1413,840,22.220284229836547,5265
11a68c96-de48-45b0-8279-17c5ecf2696a,Healthcare,0.31132572287847615,39,3,447,907,460,26.551477609309096,4932
ee45018a-7245-4741-86fa-f2de5e711167,Residental,0.5334184788933066,32,39,492,1340,848,84.43847183874807,2405
38344845-7d80-4870-83e9-8c388a144596,Educational,0.6881989341247379,36,9,200,258,58,44.878783397441524,8842
2c91ad0b-09ce-491a-84ea-255b8c8a8b9f,Residental,0.22065131606033406,9,26,132,617,485,76.4930249763916,2226
d0f4e0fc-8115-47b4-89e7-358348308e0c,Residental,0.17766461620504403,36,6,196,511,315,80.08649296693085,8630
2afb4959-fcbf-4d11-84ab-0f798a2e0556,Residental,0.3724305580615638,31,19,269,350,81,61.96003179555998,3427
3c76c0f6-2d63-4795-82ed-cc16de9b4172,Residental,0.09620524877393544,7,44,180,375,195,10.991987450588914,9060
76538278-1958-475a-846f-8f8897340883,Residental,0.2722818009212863,14,33,66,216,150,59.21604694733291,8077
b3799297-5f5f-48a4-be62-3f6ade5ac160,Commercial,0.30504783859324036,19,30,227,388,161,57.494986140403476,6059
a1286280-05ec-4184-a31a-83927bde4c54,Educational,0.9924045852116724,49,10,52,638,586,25.30904399024711,2110
4d3c7b50-441d-42ee-bc4f-eda931503c56,Educational,0.3776262023223875,7,42,567,949,382,83.81336825029007,4814
a32f47ab-91c4-429f-9df1-7a794992e35e,Residental,0.7104028043053932,11,20,640,772,132,22.415917652549506,6536
990125cb-8bc2-4de0-a729-3a88791b6cd3,Residental,0.23350584892617043,19,12,57,785,728,80.84229281764812,8828
9780a9b2-4ea7-4af4-9d88-846d65259201,Commercial,0.7041119609822394,48,44,650,1183,533,61.56533646820853,9476
503a1d63-2e75-4511-acad-5de57e333249,Educational,0.5423187210002419,41,12,181,958,777,92.06212825094701,9321
c6276eae-ccf5-48e5-bd1e-b847a3e1e8f6,Educational,0.2800722201372021,7,13,424,706,282,88.07746475250335,5422
785c79bd-2359-4770-904a-a7868930a3e5,Educational,0.9714967809029839,49,9,637,1231,594,52.89195020468755,2220
651827e8-52f2-4c3c-a1ed-104dd819f2c3,Healthcare,0.9998375454027475,27,21,203,214,11,46.64473103394441,2878
9ff20971-1b6e-407e-91d1-e6ad999917ff,Commercial,0.1709449416446207,34,39,21,496,475,67.72939481717185,5809
27d156dc-a615-4bba-b35e-f3fcd33a7b10,Residental,0.8919958432849596,7,10,208,1339,1131,11.642007166795363,6862
e5c11608-75e2-40a5-ab94-d7e1c1983f9b,Healthcare,0.4036146982593476,41,4,545,882,337,91.89641915029954,7004
f4a30169-8691-4168-85aa-432e0c97600e,Healthcare,0.12772571101291685,21,49,32,34,2,95.49245683611974,2401
3fd24006-53be-4b7f-aecd-115cad1e2140,Commercial,0.45890989982069463,6,34,490,930,440,92.82051411542132,9694
c265d9ae-d8a7-42d2-b3cf-d4bf5902bfea,Educational,0.8814010925043805,40,1,319,1104,785,11.354943846720237,9286
a846aad6-a051-407b-b5db-f5e90304e3f8,Healthcare,0.3332174394745908,23,21,203,762,559,87.41583107061065,5304
95faaed4-2b62-4e6e-9390-9e0feab8e3fe,Residental,0.49267728137360634,17,28,629,1176,547,34.75083614577617,1109
9e05c8bf-f0f5-42db-9740-9f3a09d1e14e,Commercial,0.9873942322067074,21,28,579,797,218,26.840169280981392,7261
e1ce6853-2cf1-4b88-87d7-6e3ebbce68c8,Educational,0.1655606799382654,20,48,29,1124,1095,34.275651518378595,4822
0d0142b4-f0c2-45b9-9715-21052df16401,Commercial,0.8940293027770503,6,41,76,787,711,51.769672794044034,8121
ea8b959a-0f8d-4ff1-8577-3f4089949be2,Commercial,0.6339474359347217,16,34,178,827,649,42.94070200699758,8359
b06b762e-ae72-4612-8202-fe03a422b056,Residental,0.15377932340488454,13,7,248,483,235,50.25484707334525,7133
1a5f3960-53fc-4d9b-8e10-22c33cbfe965,Educational,0.40982942546302603,43,49,16,1161,1145,85.57948738675823,2198
93727c22-60b0-4b61-a76f-3a328d31e0aa,Commercial,0.8957889997437092,4,40,378,480,102,86.45018154609666,7877
421dba47-f81a-4551-ab02-704787cd5a3d,Commercial,0.10416987251970222,12,15,22,330,308,32.68128888742507,7271
3d4c7f98-6a10-4713-96e6-57413158a664,Healthcare,0.17278761204633208,16,47,212,794,582,77.97279510590958,4517
0e0031d0-7365-4151-9eae-980c1fff5af7,Educational,0.7675581220548451,37,38,714,1056,342,70.61077746539402,7065
80a7c1ab-7442-42a2-b95c-1919bff98012,Healthcare,0.4327761939463167,2,43,303,1409,1106,12.515629411151947,5669
28251442-7fdb-4a76-8acc-f5784e10bfb4,Commercial,0.05736802096540383,48,11,337,444,107,48.31734894527312,8205
f3bcf4fc-a303-4032-8f60-5ea5caf94d04,Residental,0.48086072854792883,17,19,588,641,53,78.4195023759352,6849
cfecfbe8-03ef-4172-a65e-b56c5367104c,Commercial,0.147180187876794,47,4,688,1185,497,90.73766121202718,4118
ac95a157-2da1-4c36-844d-8822e6915b37,Healthcare,0.6053703752964056,40,29,526,1085,559,48.15526434206356,8254
512dd25b-8d2e-47d9-b9ad-6b214f0f4e75,Healthcare,0.8456325701437573,23,4,336,1390,1054,19.923240822909683,5942
00fa371c-8ad8-4d2d-8c11-9209f811201c,Healthcare,0.1934780424049204,11,3,88,778,690,16.18178470794403,4369
432ffc6e-bf4e-4c01-a4b5-ddf0adee930d,Educational,0.04151794101867157,44,33,376,1210,834,32.82193010916251,8576
2ac2a387-a74f-4d1d-93c7-96a4899e0ca7,Commercial,0.35899307958021165,12,49,168,967,799,73.55170260952788,6005
bd3a8d49-b8a0-41dc-a83f-b5f8b7dcb885,Healthcare,0.33716516276396524,21,46,666,1109,443,59.01565691514999,4033
aedd9525-dd6c-4c09-a05b-442af4551fcb,Healthcare,0.5529624400219382,37,8,650,835,185,84.12556087118132,9898
3b4cc78d-b3ba-4767-b4b0-adbbe0123ea0,Educational,0.30262787805738056,1,31,12,95,83,18.92810682677773,2370
e628abeb-54f0-45b8-a5f4-1249b24c42a8,Commercial,0.5913542575478835,4,7,691,954,263,97.00545227885323,5237
d69ee3f4-a121-4aa1-a568-722c600db97a,Commercial,0.8759335961354623,4,33,234,358,124,16.194659081329583,3993
4c66c505-227e-4ace-a448-60ee783d71cc,Residental,0.2124919250789009,35,3,112,1273,1161,44.03796368016744,6395
8080d6de-3ed2-4436-9b3c-a2864a2d660b,Commercial,0.8441454341514517,40,4,559,632,73,15.946118784861461,8322
8307b1d3-4966-4992-a5e0-27a9c9ec502d,Commercial,0.9317717623949991,34,5,100,536,436,93.04339141086265,3396
1d5aca4a-045d-45b8-9db5-f4c1f2c450ac,Residental,0.8200458984776194,32,9,691,1431,740,82.63493821274285,3401
275a638d-563d-4522-8277-59bbc0d5de7d,Healthcare,0.6058157363615805,38,27,485,707,222,62.517336668137986,7871
58aa5e34-5bd0-4fda-9c69-9930e368fa51,Commercial,0.38916083453611805,45,32,263,303,40,56.599137488861636,9507
69e15aab-16a3-4f47-9a56-fa56b011328f,Commercial,0.4486596359065317,18,3,650,1359,709,61.80229267414895,3877
bb67cc14-fcc0-4b11-9de2-548cb79ce1be,Educational,0.5793630678981211,16,23,710,1209,499,93.65675056405887,7651
033dffeb-657c-4c7d-95b5-a060c1616811,Educational,0.616678535530407,30,21,274,283,9,45.98447904288432,2083
33e8bf03-30e8-4cef-9532-64290bae4b66,Educational,0.8422087476493023,47,21,438,1348,910,18.06676681369943,8809
01b4cef5-5360-4f99-89ad-f504c8a977fa,Commercial,0.023074657731611437,39,1,274,457,183,47.56488904451009,4513
fb3345f5-7cb4-4091-a3a5-10de22f4c6d6,Commercial,0.02574122284430913,31,30,694,1112,418,78.79166065027302,7422
886e67d7-6af3-4cc1-82e5-224a976b7723,Commercial,0.35083063147277094,27,24,2,1401,1399,94.7319702726485,7090
114694d0-27aa-4ef0-9a2b-fcefebafd8d6,Residental,0.7369310630522755,9,28,524,640,116,22.255768696380436,1908
0cded2b9-da8c-4877-9744-a9efe89fb2ba,Residental,0.9988846363051587,40,5,341,505,164,37.69452309476506,2617
4ae5b5fa-f9a9-4bb3-9b4f-c996740e6a8f,Educational,0.13108430929449388,1,11,348,513,165,59.649773978134796,6024
cbf21426-77e0-4694-ae8a-4ef5cf570896,Healthcare,0.3984077588157394,37,24,278,1210,932,92.03215230236776,7022
b5117d79-8f32-4e24-a166-692b9c052ce9,Residental,0.6430882062070606,17,45,138,652,514,93.69763014751771,1034
aded66a8-93d9-41cb-8686-a5334b531411,Healthcare,0.027691546336070183,31,8,251,945,694,48.33813285078286,6951
7479620e-f657-436b-9902-e5facaef0a5e,Commercial,0.6857600379847494,15,49,253,1073,820,25.63519265971585,6505
1d54115c-68fd-4166-bab4-1f6b3d1e72f6,Residental,0.06943076497424061,18,17,271,1133,862,16.84527295295455,4806
93a30169-03e6-44b7-98d7-9a671e3efd5d,Healthcare,0.06685124198018799,18,30,369,637,268,62.04078242335156,2859
83c0247e-2cba-4d70-9b45-3345386c6ebb,Residental,0.05383101355358877,31,3,112,215,103,61.049482602318236,1266
029cb795-8a8f-43da-8074-7918ecca474d,Educational,0.9186348426135227,1,19,457,756,299,34.246125992858936,4247
5f04782a-45b1-4c4c-9d53-cde5f3a54162,Commercial,0.9397541221399768,26,47,79,642,563,13.905878301605838,7701
6177336a-4b60-46e7-bd77-9cc3c2e32c68,Educational,0.7039788371759241,49,31,561,1250,689,43.747692191155146,1151
a90435f2-e328-464f-95e8-5428bc05a0fe,Healthcare,0.5696486634635806,48,6,665,1056,391,10.646769374586636,8280
5933ebc7-c3c0-4fe0-bba2-df223254466e,Commercial,0.2770274394583283,20,17,368,1128,760,73.47143307401234,9813
98e6c80c-1afb-4ab5-b45d-906e157978f7,Educational,0.1140762765966643,3,6,655,1421,766,70.7531113364979,7759
0602b861-ee22-4158-bbd0-29f96459ef74,Healthcare,0.21924490631489857,38,9,17,472,455,23.63783909651524,9973
7019129e-9f99-4dfa-bdc4-0859e8657699,Healthcare,0.23335413777176672,4,1,217,1155,938,68.30950424272272,6693
7c0378e3-c36d-4cc2-a4b3-6c6f63297a22,Residental,0.34858329105026886,2,31,712,1301,589,46.30195829053477,4775
3bdb4cfa-1448-4298-ad48-e75af5a21df1,Healthcare,0.8198104416700103,27,26,132,1416,1284,62.80829625516954,5598
3d9b2f32-4c94-4241-9fba-37c97e87d246,Residental,0.9082361654736754,36,28,105,1266,1161,91.77956488459371,8645
5ea3cbc1-b5d9-4464-befa-915bd940a405,Commercial,0.8867729014831968,12,26,410,1049,639,13.188701063081549,7077
485d1f58-e692-4e68-a15a-fee251babdc5,Healthcare,0.3053178960248103,2,20,177,1315,1138,58.159398718418856,9592
0f7f0f5d-8aa5-489f-950a-155bc6efc4d9,Commercial,0.3761741095824249,35,38,449,1216,767,18.301963014043064,9951
8119a89c-5814-4d8b-92de-fb932fde5352,Healthcare,0.316126163751962,17,16,689,990,301,91.56044851736593,4498
bf50f051-f47b-43d3-aba3-a04274cbb8b3,Residental,0.4929236889139088,16,30,427,917,490,75.99395184561396,9585
f05d3195-1dec-448c-8671-28bb7b694a71,Healthcare,0.7071499517504856,39,17,425,742,317,33.55897685617677,7537
1514d905-2eed-4642-af87-131e58bdbd33,Educational,0.96319179060112,10,29,276,1023,747,52.04610408674488,2400
f2912dfc-cb07-4bf1-a3e6-b8be5d25edcc,Educational,0.435484400783566,26,5,647,1366,719,62.69055048559225,9045
09a8b0bc-71db-4a84-acfc-01deb29a877e,Healthcare,0.27900763677980633,17,9,605,1358,753,96.32641500838692,3389
77f50cab-41de-42cb-86ef-5fd9de65ad79,Residental,0.4590806515853354,50,27,478,1042,564,67.35276017377771,5552
b1615e8a-167b-4187-aedb-38d091866a4c,Residental,0.5885467200003468,48,26,54,1114,1060,99.42702120065317,9992
7d477778-b6a6-4028-85fa-77a69fa02d27,Commercial,0.2348030287474543,24,44,529,1174,645,73.17694650273084,3298
e76cb856-5ddc-4883-940a-c8c7513d220a,Educational,0.09780728426952723,11,19,310,580,270,38.119321178957165,4698
44eb7ef9-eca3-455d-a1e0-b0ffcbda4e79,Commercial,0.15205554366475038,28,30,6,920,914,52.55759389505656,1436
52122b8f-e1a4-4938-a868-a959a29365f4,Residental,0.18045457469029036,5,24,20,659,639,81.4508686157009,4861
956e7285-ec73-4434-8b57-7e25a393002a,Commercial,0.0351675002475369,36,34,454,1122,668,76.92426255092141,8259
6a065835-bb61-4104-acb1-bc4a6c6b3263,Healthcare,0.5106396653470326,20,47,672,1105,433,54.00491239761936,3961
862bcc71-36d8-4720-aad6-d4e412200857,Commercial,0.9219464996672315,32,13,532,1324,792,88.68491923954932,6066
78171125-22f3-43f4-96bd-cd7ebad0e077,Educational,0.07408181798477986,30,14,244,1397,1153,76.77908747519069,7152
2408d317-d7ab-451f-9a88-fd88768c1d18,Commercial,0.5506082224366039,6,35,238,1328,1090,72.80406541491797,3579
e7cef61f-dffc-41fd-a402-ca4a6c003577,Educational,0.8955256242541988,15,3,444,601,157,26.629027069054136,9747
14ab132e-0cae-4c79-bcde-d96ff2e4de52,Commercial,0.3900266732705834,2,48,673,691,18,28.315723850755855,3562
9d504563-39db-404e-85b5-c07961604690,Healthcare,0.05423981487392093,12,48,285,1261,976,97.40146713471697,8764
ec7b2d34-cf41-4b25-9e8c-cdc695d9c187,Commercial,0.7632040580856394,8,5,65,195,130,98.36637066745006,8313
cee3621e-a8b8-406a-898c-af88d2e226cb,Educational,0.8217259939323704,34,22,4,1225,1221,95.4651927927835,5663
8c3ea2c5-783e-4210-a598-82a792c6c9f6,Educational,0.8029990429418726,35,38,518,677,159,26.58035744374148,4046
e52086b8-c640-4e57-9cfd-79a4f570d4d2,Healthcare,0.2054814938768581,38,17,222,334,112,77.7518653777167,9098
483995c6-3b60-453a-9d2a-bbb523791ed7,Commercial,0.3398111699770773,36,8,386,431,45,14.54632290004372,7961
fe433a02-58f4-462a-bcff-2402bfe29be1,Healthcare,0.8594487427609815,37,2,518,1095,577,82.40794690446339,4160
4413670f-2e49-4bb7-90e5-ab7e4cfe9ee1,Commercial,0.12448791758605715,1,22,316,622,306,69.2696449383962,5798
65672d39-fb14-4b96-b06a-a38c236a388c,Educational,0.773663345166002,26,49,611,1037,426,15.671643273289957,3575
79c74c3a-383a-47cc-a415-1253ded0a7eb,Residental,0.13988127898030334,27,6,156,1298,1142,19.118423026994137,9314
1daea92b-8609-493c-a1d5-2f3c17eb17ce,Educational,0.6914739251514121,29,44,159,826,667,88.67045057179757,8380
3bf603b2-2f04-4ed7-90ff-54cf21b0091f,Educational,0.8868550746444527,13,8,19,757,738,25.04764054303004,6047
3e3748e9-fcad-41da-bb0c-e835d795164f,Educational,0.8109626617307912,31,27,155,186,31,87.53329561939795,9134
8fb0fb5a-ad24-4c43-a41d-d9b9207ddc43,Residental,0.033563121775055604,12,25,173,1017,844,35.17855009579839,1970
02f80f83-1cc1-40d7-800b-313f09a9f6dd,Educational,0.2067093219352102,20,8,646,896,250,82.117362915632,9577
dc19591f-ee5b-4e28-8314-0a2da0a2b00e,Educational,0.8766350936955762,35,17,34,1056,1022,88.77529953283644,6120
6314d1a7-d9be-42ca-8aa4-52d71a7243cb,Educational,0.7748271036491619,40,46,453,1068,615,80.13814247401875,6381
26646739-fe58-447d-bd03-d82fe5126d09,Commercial,0.8526248514965915,28,25,226,857,631,20.99111041219378,7279
3e6e71ce-dabc-4fee-ac73-34f4b06b455c,Residental,0.819249321554159,33,10,237,984,747,10.457963667800724,4930
c3d2c371-ebea-45bc-8379-d56b39b75877,Healthcare,0.22471705865888225,21,38,700,779,79,50.49797375958742,3277
e7575913-76c0-4725-9339-76d23c348340,Commercial,0.937932748861374,40,32,314,1296,982,49.173689999009596,3272
50228d01-e71b-4313-8178-51f9bc4fccb8,Residental,0.646012053618698,34,32,464,687,223,61.70552870578727,4011
87e7c624-c78f-4417-be21-7a459dca33e3,Residental,0.06476473347855682,9,24,472,885,413,16.46805697415747,2135
c613d45e-273c-4c0c-a594-789018158c9b,Healthcare,0.20037684631393515,26,18,353,1415,1062,62.81580349789007,7769
14521639-8c97-4c5a-96ea-6afe94f3cfbc,Healthcare,0.6381811831547672,35,45,585,1439,854,36.448685093612404,3992
44c246fc-a012-461f-ab02-867a455335c2,Healthcare,0.619300658482165,41,26,547,822,275,82.50507696306408,1309
62a492f5-f9c5-411f-bb7b-2deea1436471,Educational,0.7332613388555479,19,19,261,802,541,36.289462610196736,4329
11a5d5f3-d2cb-447a-bea0-77631a757bc2,Residental,0.568423553646366,15,46,308,743,435,13.336231243466827,3976
633e08b1-afe4-44e5-93c1-51d04aad8825,Commercial,0.6536280668933199,24,24,58,1358,1300,48.23858073246149,8196
8a3c4f21-2e14-4ed6-99e9-ceead8d500bf,Commercial,0.6779744380920945,33,13,197,647,450,65.2032325603352,8054
74cdd68a-cec6-4230-9bae-68647b942476,Healthcare,0.3210830862886994,42,48,695,1357,662,39.27045686132894,6308
d4dcd621-19dd-4146-bec6-a42b61a47af3,Residental,0.3402992554123532,3,50,204,815,611,45.791067512899254,1804
675a4a8e-5d87-488a-b2ce-29ff9a215947,Commercial,0.18078713600039975,43,12,592,1101,509,44.243528149884895,5690
ee1813c4-df7c-497d-a446-37548791e425,Healthcare,0.9484610984578178,13,13,711,1180,469,91.66126656846411,6351
1219ec4b-2174-4c39-9df2-a92e8d010651,Educational,0.18515058423503417,40,37,715,969,254,62.53928542558117,5326
26ec430b-3a5a-4497-be55-a713af5d77a5,Residental,0.5429041227161419,27,15,40,707,667,41.01566511515591,2953
68cf1531-d64f-44cb-bcb9-e91e08a02e0a,Residental,0.8355351516966822,14,32,329,936,607,10.435913524327336,2236
96df692a-4876-4af8-ab17-3e184211b01b,Commercial,0.21287815002986443,4,37,360,455,95,61.479561611404094,2708
e2c1e783-7235-4405-a919-05d98b1a0527,Commercial,0.10675232791155098,41,33,116,239,123,97.96556940909359,8777
99634f2b-9579-443f-b01b-4dd083132448,Residental,0.781418822796912,43,27,140,518,378,59.83521952592117,6616
212c015c-6094-4229-aebe-d5331fe7c1c8,Commercial,0.5644998623875721,13,21,133,330,197,38.67413662143521,5244
b26681ce-5d60-4a00-af6a-438094bd22b9,Educational,0.3001937468792186,29,50,635,1219,584,57.65327038516945,2949
d20ee4ea-4503-488b-a8e4-5ede795be206,Educational,0.16880535981606926,5,21,433,990,557,73.7422251667929,5982
f6ff24cb-d9fa-43c9-a8f7-862de06c8be9,Healthcare,0.8264784634083452,37,26,150,1212,1062,29.64566236919716,7296
81e67e27-815e-4d05-9580-402e342bb53c,Residental,0.10391349730121291,32,42,591,740,149,81.4320185499427,9293
9df4beec-0aa4-4641-9399-fa30b3c9f76a,Healthcare,0.09087881651247265,31,41,615,1004,389,86.90671160843833,8099
24457bde-21c5-4f11-9521-e5cd8ca5e3ba,Residental,0.1219869670000655,6,8,268,824,556,90.02963105437762,6150
19a479a4-25ad-476e-a2d7-3c286945fd9e,Educational,0.2740238852445447,45,24,403,1396,993,15.081141230577426,8209
11ee33af-24a9-44ed-97c2-4ee7c1b43326,Residental,0.48136211605096657,2,41,343,1128,785,37.22774487340136,9901
bdba7f03-d83a-4b5d-875f-67fc626754de,Educational,0.4828227437503809,37,10,206,1412,1206,33.7345654993177,6620
105abb57-8376-47ad-adeb-c2d409c190ef,Residental,0.21506072832127954,26,12,115,1390,1275,61.87354441984359,7802
8af8d378-7efd-4d71-af0d-41e8ec7f6923,Educational,0.9734487207334541,28,28,286,570,284,82.63871963535118,8542
03ab996c-6bf2-4f48-b97c-ea3603df1cf6,Commercial,0.18090633630303266,19,27,579,1265,686,12.73039105830204,2601
fc2a4315-2f70-4862-ad1a-305e55ea35d0,Educational,0.708011013780049,37,25,571,1282,711,37.978023009921515,1962
d1fb83e6-3952-4b1d-8e35-88fa562a8a52,Healthcare,0.17786573139924333,5,43,249,421,172,34.757452097013754,6616
a74cb152-0694-4326-996e-b94549d8c3e5,Healthcare,0.3255151467612438,33,5,438,1199,761,24.124524928429746,5175
12a4ea8c-b9d7-4906-8724-880740cbabed,Residental,0.8282270942866726,39,44,438,1117,679,62.362004063491035,4042
2cfea328-dca0-45d6-b43a-e5b0b605bd60,Commercial,0.11497453193490081,31,35,633,1267,634,59.692932769183884,1235
a63699d1-071d-482d-8bf6-2c47c1f06d1f,Residental,0.42630083889082604,48,22,283,946,663,54.581052673648855,2803
217899d1-5558-40cf-ad56-d2274af292e3,Residental,0.7618052288239539,30,44,79,1048,969,90.9299189439507,1308
95981491-73e2-4dab-90f4-8eb66ed3eafb,Healthcare,0.4284848689355163,27,25,175,407,232,21.70396157389196,9648
aa2d52d6-f5a9-45cd-a8d6-f13f882fd20d,Commercial,0.7992920340774244,15,49,497,1256,759,94.70320455505586,4756
26e64fc5-71ad-445d-901f-45c820c5cfd5,Residental,0.33154517565790365,49,18,316,543,227,16.392554877670342,9438
27d18ce3-014c-4493-a996-ab3966692fe4,Residental,0.6554240498068239,18,8,87,860,773,97.68804652884558,2190
a5561289-65ee-490c-80e4-c6ecf268b430,Commercial,0.479429409971479,8,50,55,627,572,59.30854909391739,8346
2d671923-284c-45cd-b7d9-120af6e2eb97,Commercial,0.42403756253689073,47,4,220,993,773,31.09331633706213,4847
9435fbb1-ed0e-4e36-b871-3c5132ce0da6,Healthcare,0.4353203642776884,26,1,242,1065,823,74.6346580681562,7517
fdeda071-8cc3-4517-b731-5ee811f1bebd,Residental,0.2889137677701459,43,42,44,632,588,16.58699142438202,5874
8b4a533f-78ac-4f67-83b4-a23b58630803,Healthcare,0.6223550751845425,34,43,550,1284,734,28.729956802885248,6741
0ed6fb96-3aef-46ff-b5d1-eb7b0965c825,Residental,0.28058464915441006,2,36,22,70,48,58.39014987222475,2427
54302fde-2d10-4a93-bddd-00ade53df8eb,Healthcare,0.9333924436707389,16,43,485,555,70,87.91363881768974,9975
71516e02-721f-40e8-a6a2-f6edb0fea420,Educational,0.16918280801411867,13,49,135,777,642,66.07471432553717,9552
813fdbf3-dda2-4076-aa34-0c1aad2b451d,Residental,0.9195746744279804,50,29,446,1033,587,84.40610643381345,6921
3ce60aac-211a-40d4-9de5-8dc39a74a110,Educational,0.39655586429055856,24,2,412,900,488,68.48370029222201,6474
11523a9c-9f6d-48f5-8fd5-429de2e9774b,Healthcare,0.96248160396284,50,35,528,897,369,29.53591086759373,5933
be0af456-c987-44ca-b236-e2061df1fe06,Healthcare,0.7840068274534159,41,34,75,442,367,85.50899251872328,4315
b81ade22-bb1d-4196-93b6-8a77bb58d373,Residental,0.14302155658901394,46,18,513,671,158,82.32497805570213,4376
a7c7481a-e92d-4189-9304-fd4cfa52acb2,Healthcare,0.34102331126365804,43,31,218,725,507,65.3137009184625,1605
db3b9838-76fe-409e-9f58-56c4fc15d50b,Commercial,0.46373633356477506,12,26,42,1218,1176,45.34087149059717,5291
01ce24a7-e1e2-4906-9096-c68851389030,Healthcare,0.8073700995160581,36,1,581,941,360,50.58484056328793,5681
780e39d2-3190-4712-b5e2-74ae2888b31c,Commercial,0.342153215857928,7,22,384,1401,1017,55.041955430462124,5606
479271c5-3afc-4574-84a9-42f0fdbeaea1,Educational,0.5959427061395582,46,11,185,194,9,48.28555009433685,6012
4e52be39-0eb2-488e-aeac-4178f5e865bc,Commercial,0.8466932368435138,35,8,572,1058,486,92.28818922144028,8376
9832e44e-e45d-4008-b82d-4d9a23d4ffc0,Healthcare,0.7801328893731588,12,19,356,1075,719,45.09330012657164,3922
33744d49-dd03-4663-8261-05b9642cc497,Residental,0.8121520813881876,38,32,352,988,636,95.33153280567309,9932
3c355f4c-f9a4-420a-b24b-4e0f79c428f9,Residental,0.2138282238854453,8,24,3,1208,1205,97.3235537060958,9013
49cc1fee-1d0c-447e-a2a0-35d8aaf83384,Educational,0.38796318932797025,29,8,312,582,270,64.34415797906757,4646
01e923a8-3d5a-4705-b6e8-6c75ed808282,Residental,0.8029081635020259,12,12,22,80,58,19.143729051899584,9568
d67ad38b-d2c5-4b0f-b840-ca21ace949ce,Commercial,0.9767272954107671,21,49,307,554,247,95.85994350975729,2902
ec7ea2ed-1b4f-4b1a-9ddc-8c66420347d7,Commercial,0.5708821374943208,15,17,117,807,690,29.337433460636817,9502
4fd019df-6391-437a-ad6b-0528708640bc,Healthcare,0.03885108937062065,11,2,282,537,255,58.986728009326605,9604
e2f4e47d-ee83-4619-ae5f-be0523e12c97,Residental,0.7820456488748505,44,50,552,980,428,73.70407322452354,5612
f9cb74bf-5480-43aa-8af4-c04d1fc5b2b8,Educational,0.9754152115733961,49,23,349,375,26,43.46566839845597,8269
26a8b2f6-4d7e-4bf8-b301-ff8df101f775,Residental,0.19260398893773756,7,25,434,1284,850,92.76575729700846,5482
11e9bfc8-03b0-4736-9c91-b599972ba636,Healthcare,0.9427704384068083,7,33,296,1259,963,22.38152056907507,7040
c4e351b0-7eaa-483e-b420-6fdeb408db82,Educational,0.43931866242611173,42,18,51,355,304,63.391130277040034,6817
02538482-ceb6-4da0-987b-50e636058f3a,Educational,0.8165540772417642,31,40,467,1093,626,24.81208021808381,9649
8709a5da-720f-48f6-ba19-1b2614b6fc3d,Educational,0.5588938363537893,48,36,270,899,629,13.546549798139214,9489
12514be0-37c1-46e5-abc6-18f801e4029b,Educational,0.14127823463882794,18,16,706,777,71,23.008756378571093,6219
707d1e1f-a0e7-4839-87fb-0a59b1eb9e11,Residental,0.7947710837941705,4,18,306,1321,1015,72.55548389577531,7203
1ed628d7-d04f-4800-b331-ea915ce83f86,Residental,0.23708998505044332,20,5,268,300,32,80.46827231865583,1357
7a94dc7e-8844-4188-bff8-a3b72f15846c,Residental,0.11755526476137257,6,23,129,238,109,73.590948827676,4032
1041cdbd-99fa-4035-bb0f-a7174ec23d4b,Commercial,0.1834733759845737,23,48,350,1147,797,88.88104175137249,3342
af54b9d2-ce52-4346-a288-134fa39d6471,Educational,0.29502775165746553,45,49,654,857,203,73.53185792074964,9367
162fd7e6-ac26-48d9-8bca-8270191b5a66,Healthcare,0.28893616225569163,32,7,302,853,551,27.363322622499027,6963
ea0a64ff-17f3-4294-bb93-20f3f3933963,Commercial,0.13451496146858255,22,21,65,438,373,18.38905890627413,4756
cfc89217-6aa9-4914-a462-04fa6710192f,Commercial,0.994095553065465,7,19,423,1018,595,27.563461622130863,2539
cdfcf1a5-1e7f-4a7d-b49f-0ae95c3188f8,Commercial,0.5282205764220321,44,46,209,310,101,68.00347599147533,8072
dc4bb525-08ac-43c0-98f2-a5b55d5d3d61,Educational,0.34999300165368363,34,15,157,1405,1248,32.45589063834859,5507
2197c894-3f6f-4a05-9435-c749c6d812d4,Healthcare,0.08223930642601152,15,32,15,740,725,56.45895830232718,2262
7840d095-679e-47ad-8859-220f05fd0153,Healthcare,0.5519616152061781,43,4,587,1435,848,51.68011849440495,9244
7fcefb3a-a592-4754-8108-9fad73b7d4cc,Commercial,0.08187171610959465,4,37,628,1111,483,55.62557873427667,4550
9042dc74-aa43-4d4e-ad59-cff4982b09df,Healthcare,0.10848673295715672,40,25,52,531,479,26.242148681209645,3478
74c448c3-2e45-4aae-ab03-4fa0ac97efd4,Commercial,0.6724974802655742,50,2,139,527,388,72.71664503064784,2997
54030c03-6bb7-4943-88ff-68cfaccfe231,Residental,0.8980286948132414,13,20,434,1294,860,38.13403655489524,1876
031dec1e-0b76-4fad-a406-debc6ed059af,Educational,0.14549133600695763,29,34,563,1330,767,26.984708199475847,5228
eb07cbfd-8b15-48da-97c5-25669b7b3d1b,Healthcare,0.4180063707724102,39,30,696,1332,636,49.298932114363296,5913
56209c16-72fd-48dd-96a2-3deb480fc203,Commercial,0.17477975318918826,14,40,639,1381,742,68.19891387357049,1318
749b7e8a-a4df-403c-ad96-cc694c01bd65,Healthcare,0.19062989477141556,33,37,531,830,299,36.038945493837005,9917
64cd31af-7d1f-4f94-9be4-9c797a71d708,Commercial,0.14899716792544304,14,27,552,697,145,83.51530934038453,6642
2d5e9227-5cec-45cf-83b3-2f6e51d8a6a4,Residental,0.215126558421327,5,13,211,1339,1128,16.582286628188307,1853
91bf29d3-b7e5-4c66-a70f-be9e774d94a8,Healthcare,0.5874449512693118,16,33,273,701,428,30.488680331362865,2977
6618e9db-1c28-4281-85a0-529672b51e1c,Educational,0.5017852782648227,23,27,661,1268,607,53.91906829149995,5918
672ade36-c013-41e3-9f83-d4874c1ddb5e,Residental,0.3659181421276334,41,31,629,1254,625,42.029555857811665,9542
cf6884e4-2d63-472e-8192-973addb18989,Commercial,0.3450030002778831,21,16,481,536,55,42.72690259552586,5291
12c83f82-3cad-4b96-8fcc-57bd74ab4b3a,Commercial,0.7866518381797817,4,45,198,1201,1003,45.15364407872057,5349
25948dbd-4e15-4820-944c-16c5a9524857,Commercial,0.39182792238321207,37,39,444,1248,804,58.96124338279338,3661
5fb37e10-5207-4e12-9458-2aeb8304a713,Commercial,0.6585627507685259,11,21,379,555,176,29.26988393521599,5995
fadd9240-af21-4a5f-aed5-b32e00c090a7,Residental,0.10640292177132249,46,7,590,1417,827,87.78343174881668,4591
132582ad-facb-42b7-9d31-a4f018be9a45,Educational,0.34904316845073724,33,33,104,1281,1177,89.88695397185427,6459
e929eb54-e42d-4f4f-9ca2-eb33f1320f6a,Healthcare,0.6536713621583331,45,39,446,519,73,86.91607100153578,2304
9a18d2e8-dd4d-42bd-aeb3-5457f9fc085b,Educational,0.15105176582451085,2,15,437,541,104,25.742818055956796,9924
73d151ef-eb4a-4729-be5a-19152c5b10a8,Healthcare,0.10445441172545722,46,6,310,1162,852,18.12083699186136,6649
a5b24673-c946-43f0-baeb-5578a9e4fab9,Educational,0.760975475287725,1,4,63,828,765,92.77652614895966,6759
fbe61289-1664-457e-b4d0-7fc4a631b69b,Healthcare,0.5220476056335439,50,23,627,1265,638,21.98441313266374,9358
d03afbe6-1999-48cd-a93b-ef58dcb22dd3,Educational,0.10454919302235233,6,5,293,809,516,75.48251382194353,9733
496d2936-13d8-425e-9e2a-38dd4341af01,Commercial,0.9139295932727183,45,48,142,398,256,99.85577348858136,9982
66fae552-4524-4170-beb0-b3bc0cd59963,Healthcare,0.8857428519117257,7,24,703,952,249,84.08661774086845,9701
5011db13-92a8-4600-bd1a-0cd00e4c8226,Residental,0.5826866658485693,23,27,533,597,64,20.980129199681166,4239
bd4c8d94-750a-45ea-a38c-01d217411528,Commercial,0.2611207069718148,19,29,463,801,338,44.35808806061888,9065
1dfc49b6-bc96-47ab-9516-3a31b3a4ac9f,Residental,0.3793125958573116,17,8,686,833,147,91.37942091554523,6955
73b22978-e7ec-4fce-8a0f-a43957807ab2,Residental,0.4866430650540492,19,5,227,912,685,85.16187078536923,9679
e0ffa91e-1b16-4e80-9202-6c81f9de50a3,Educational,0.31544995536204945,7,2,439,1200,761,60.4139944281816,1549
8be6ffb6-0c49-46b6-988e-8daab6824b22,Residental,0.6474235548216196,33,32,691,938,247,79.16853629607836,2455
35c4ea24-81c7-4b43-8464-9536f2f1d530,Educational,0.24947183040594145,30,10,156,626,470,40.98487426016506,3238
98c788dc-f20d-4a2d-a543-5dfd3a62c60f,Residental,0.4690410055299623,16,22,304,963,659,63.32431243957519,1836
fafccb5a-5f8b-4d9e-a035-53473ed6c0d3,Residental,0.9123040419961549,44,32,115,512,397,42.88324693326398,6884
167065f7-2f0e-4ed0-944b-e626d37f6ede,Healthcare,0.8858376487384894,3,7,314,1282,968,54.284516315923454,7901
ff3d7b78-bb3f-4b65-983b-4247d4701e76,Educational,0.9597111078573116,33,33,277,1097,820,57.65670369436066,5432
05674e99-3379-4e65-8f66-81ae57b01eb8,Educational,0.050219989173813984,15,18,525,1024,499,20.054849314117444,1066
6e82303e-86bf-43ac-99ce-61918c8a2d4f,Residental,0.9991777326658966,23,10,221,289,68,93.09933996065183,3509
a564ca8c-4da5-4f1d-9937-f57d295b8545,Commercial,0.7200403727554701,14,48,391,1193,802,96.17117830826302,1915
310807f7-1262-407c-b5ab-13c745c44603,Residental,0.16606725010077683,33,43,388,1369,981,30.696815537934206,4754
9939f174-d663-44c6-9823-29e415921f87,Residental,0.8073193283464646,18,41,713,1374,661,43.56724287569925,2366
bec457c3-1662-468e-bc08-3e96bc1af1df,Educational,0.7478397849138243,25,50,88,252,164,30.311485011757934,5295
ec5f69b0-58b5-43b6-bad2-ccb60d7cf8e1,Educational,0.08927872985245389,5,29,444,1076,632,31.49313857776534,6005
edb614b4-62e4-4cb4-90fe-04b652c55b3b,Commercial,0.1216956522711411,48,8,61,122,61,43.91968901574692,8287
f9c4cac3-2cf0-42f2-b5e7-abb9d3f386ec,Healthcare,0.9094984621781057,35,12,341,719,378,11.878511299487052,2191
c17730f7-2bff-4b9f-b102-4f4c8684dc2c,Residental,0.5200489181676412,12,1,54,1308,1254,93.67107466588521,7186
cd4c8f16-3757-4038-aa9e-a965dd5e361f,Residental,0.6403407248120225,41,7,228,615,387,39.03341560657191,5577
a23ab0ea-cb43-4c2b-ac70-3290949e19b1,Commercial,0.4950621590224349,18,49,7,398,391,52.47005230679608,4099
61b9f136-dad8-4b64-86eb-f40919add0ec,Educational,0.510650179606611,13,48,705,1354,649,88.36439812897395,4030
7f23b467-457b-4a85-9ad0-5af6924aad7d,Commercial,0.8348620317759617,7,24,140,370,230,79.8670118365913,9648
feb11a45-f802-4f1b-a33d-c516368d7e07,Residental,0.0887402672792319,21,45,633,1287,654,76.211147027336,6133
c6b64760-715f-4263-9eeb-257b13ab2858,Healthcare,0.2340424345660842,42,19,576,796,220,16.80878328118628,7508
7d666061-f0df-4bd7-95a6-1849f3ba0b26,Educational,0.34953256517766773,38,14,90,564,474,42.57502070385187,7846
8b6def61-08e8-4d01-a4c3-2425ae8d1134,Commercial,0.05022688709138656,30,12,426,769,343,30.437950556550177,1514
af2a6199-a1bc-489a-bbd9-492dcf48d39e,Residental,0.8001903874962761,10,39,554,1322,768,87.48653895304567,9714
85c96434-b503-4ea5-8711-aafc2b53dda8,Healthcare,0.9099183020036307,21,36,462,1001,539,41.845231906050884,3616
69a57e17-9e32-4339-9fd6-9afd91c785fa,Commercial,0.4038067588317005,27,14,716,802,86,99.15145515458761,2143
58753d67-8481-416c-8c59-1e22e32abfae,Commercial,0.731104651136287,12,46,73,819,746,59.85839686231511,6373
b2c8b7e2-e39b-47a7-8526-0b53b1ea483e,Commercial,0.4774550658093639,7,10,588,1122,534,80.12729359617471,5567
9f8feee8-40c3-429f-aff2-4f93396398bb,Residental,0.5708751170430839,33,22,601,630,29,48.20592957819139,5108
20c9a555-943d-4ed9-b5d6-e91397ab20b5,Commercial,0.13903484440404767,37,12,441,451,10,60.024551532854254,9236
9f2011aa-6509-4647-80d6-67ba25f8578c,Educational,0.0706057900692455,43,1,624,722,98,16.091741542231535,1694
00bf24d2-e5e9-48de-90a1-16528166d9be,Healthcare,0.1287430487580381,1,48,438,1254,816,32.72126857436649,5050
2a571737-463c-4bb9-8f08-6d641efa450a,Educational,0.44333670648181744,22,30,371,450,79,13.924042384277215,8908
d20a65b2-ea48-4fcc-82cf-15e81b3a8192,Residental,0.047076807531337805,5,32,380,1101,721,88.01438314446314,5337
79f093fa-55a1-4531-be24-8c0f4367638e,Healthcare,0.5254598916124584,21,50,315,1389,1074,76.86686277125307,1349
121071c9-22d2-4dab-9abf-95ccd803f748,Commercial,0.7470991539441938,19,30,536,972,436,48.88540449158115,3384
52183de9-66ca-4cd4-97eb-5f21cdccddd5,Educational,0.2829370601328395,24,20,280,953,673,53.76870536138952,2903
51ba12b5-7e0f-4c8c-b5a4-b30fcecc58e0,Educational,0.8073885151161466,24,30,679,961,282,72.42540704958557,2461
6a9455ee-40c5-46a7-9672-b6456208c843,Commercial,0.37454890962083975,25,25,653,932,279,37.78150138860529,1157
c70e0101-90b7-4e6d-8464-e2a2b828066d,Commercial,0.8563019075632288,15,4,532,1169,637,12.057544199590676,5839
9fafc93c-853a-4b45-a306-5fb14a5011de,Commercial,0.3682448791008136,15,40,260,662,402,16.07484165140941,8738
80d6d27d-94a7-4ea0-8be9-5175a38894eb,Residental,0.6915331002939262,45,16,349,429,80,57.160824807719166,5330
d67e2f6a-8b97-4bd7-8fd9-701759ca405c,Educational,0.6015294568487963,36,32,669,1414,745,95.53192167804869,9069
8f06e290-155d-4b53-b8a5-d08058813060,Residental,0.6523282258049798,24,41,259,831,572,66.72189974394155,8279
fff58064-436f-45c0-a691-036f07189b9d,Commercial,0.49672153814271014,30,34,416,1396,980,23.70209940614756,4045
071785df-308b-4145-90bb-e3cf540bb3d6,Residental,0.42316380186635805,38,29,179,1430,1251,64.86163597105994,1565
2fd18072-ec14-4b93-9405-8357df4640b8,Healthcare,0.33000497345971624,34,14,164,870,706,76.24075092526029,8663
85c66d45-c031-4103-817e-537a9045c0c9,Educational,0.6875342848740811,39,18,324,410,86,84.68967326004297,4486
159dceff-ce5a-4905-9c14-9bab3856a73a,Residental,0.2614062776670343,37,47,526,1340,814,72.33592626667779,5678
0d109f9c-c8a3-4ab3-9fe1-dea169d16d61,Commercial,0.9748376470531828,22,6,468,1186,718,46.22913096750224,7483
04f8c69c-49f7-4473-80d7-65116e16af3e,Residental,0.9302323198219966,41,42,421,1060,639,64.67387792370243,5158
ee0a2b9d-f0b8-4bde-b04c-01944b74997b,Healthcare,0.7008471267159752,15,26,36,850,814,33.2502734640514,4809
f0fda49e-e32a-4cca-96f4-bbb13230b07e,Healthcare,0.5584984730140939,18,43,701,716,15,90.29440422327008,1597
1e7364fb-4051-408b-8eb1-5b40b31bca83,Healthcare,0.1006635762244319,18,24,281,345,64,35.03602482843158,1504
7a3d4cd1-c065-4909-8ce9-f8f4c469d686,Healthcare,0.9752636607166153,30,2,653,884,231,67.52847447635187,1022
1ede9dfe-c380-4a62-bc18-017a2dd478f5,Healthcare,0.2815023302431968,10,31,495,726,231,62.449032460761266,8512
8996d448-9829-4bc2-a068-eb29bc2dfd01,Residental,0.7633756716768851,16,29,388,1272,884,82.90562206129245,2116
f63bbc55-f0f7-4c46-a8bc-94e2f64d9f3a,Healthcare,0.5627776077698254,13,23,143,658,515,25.714004931313355,2789
9b5afb09-acfe-4b0a-879d-8598659b97cd,Commercial,0.8435178209168314,49,15,530,633,103,40.010474894560794,3265
3986dfca-8baf-4c98-b5a5-1935e53d4f7c,Healthcare,0.7850611377033092,39,22,144,472,328,60.98926215984157,6999
9a2725e5-5b55-44fe-a4ff-787dd4f3fe0a,Commercial,0.2061754832904258,39,10,108,685,577,41.301202252240515,4289
3ba1c59a-0db2-49e3-ac92-f085726bbd1b,Educational,0.10313719435386726,20,8,519,985,466,79.96662786532478,4678
57b64fbc-4c3a-473c-8d21-b10d922ed1d3,Residental,0.056775160137731984,23,23,81,388,307,76.93790333710542,7557
72a9c053-498a-448a-9eaa-79bcf34a81dc,Commercial,0.42681749828569426,2,40,152,815,663,84.4826080119518,2312
9349e04e-411d-4250-b929-95e9a0e6ea1f,Educational,0.29442878692424657,2,38,400,1091,691,21.137463320235558,7154
2dd19d50-a66f-45d1-8800-e8e3dd93d3bc,Residental,0.45731886603571625,9,6,19,1147,1128,42.247772332917634,2526
5e4aa1bd-c0e0-467f-9db2-0f0b8b4400f1,Healthcare,0.3047451572745843,46,38,625,717,92,90.90763569970471,7105
2009a954-cc62-42c9-a54c-8728b8296c24,Healthcare,0.341381805624981,1,46,510,1415,905,58.94150679039291,3533
1f6aefc0-54fb-418b-bdb8-aec9b2e4f9df,Healthcare,0.7488353581694303,29,2,448,1117,669,91.53769599066476,5245
642fbaa7-ec21-4534-97c7-bb6529ba12fb,Healthcare,0.6911934632539499,14,42,414,1342,928,37.597823718887355,1785
3b388457-e13d-4c13-823b-926da1f51d80,Commercial,0.26726839889800413,12,47,702,1108,406,37.93862299254161,8408
fe0c4229-949f-4c08-b106-829d6c166561,Healthcare,0.6484247040543976,46,33,468,673,205,23.72430180365257,3265
d0a4eb7e-b3b8-423b-a3fa-09f6bd50496b,Educational,0.13987007318347855,12,20,590,1070,480,83.70482360913643,2284
6485e83d-f546-403f-b3b4-4dbc0178da50,Commercial,0.3999739656367287,4,26,118,1262,1144,73.64243725229672,7180
58d7dd46-7ebc-4cc3-a74d-c0236f66d1c1,Educational,0.3061254542003313,6,29,675,1068,393,67.72031734829142,4214
3e62b989-e2aa-41bc-a07d-88db4412f7e9,Residental,0.5510536145563413,10,24,431,577,146,81.7443474388828,9541
253c8a4f-96db-4f7a-adbd-bffdb4709ef5,Educational,0.9426662084012496,24,6,715,814,99,42.2837372864536,4987
9dbab9c9-772d-40a7-8ef3-06a63cfc7043,Residental,0.18215510834773263,23,37,548,1280,732,78.80612763560647,3487
a3be5ecd-71f1-4cdf-8797-e2d0459a9562,Educational,0.5002587976847399,17,36,206,841,635,24.010064532972073,1801
65c3090e-885b-4d1f-8866-76a5638719fc,Healthcare,0.12872548307256415,49,38,306,1166,860,19.83390217574398,4878
83fed3b3-c849-4d92-8801-94dacd2f5180,Commercial,0.5369235125774179,15,8,392,716,324,50.66355782612503,5175
c9babec3-1c19-4296-bce9-8054892ee377,Commercial,0.9645519703709003,40,50,27,179,152,15.519946131859474,1761
5ac85ef4-0568-4e86-9e3d-d69a876bbff2,Healthcare,0.9848432605592897,13,18,629,807,178,58.03482900872618,3288
d0a0b130-090d-41e7-80bd-ee9b53a339f7,Commercial,0.3019559575114277,39,14,611,1171,560,38.833067369306974,5351
e4a560d5-264b-4ffc-878a-ac2c91f1f82e,Healthcare,0.02246057864301143,30,13,242,1125,883,22.404101930653443,2548
a9bd8340-ad09-40e2-9d31-2573f99fd6af,Residental,0.6660836156173305,44,5,512,900,388,47.51947443144949,3687
3663ba75-5dab-487e-8b0e-14269acc1643,Educational,0.599546857728076,22,44,268,1218,950,68.50300730924334,9161
d2c00724-c041-4b57-8c07-9d29563e8102,Residental,0.16226968118091822,29,4,674,1429,755,96.29984728042928,6455
3abd2bde-0576-4e7f-8d1b-87f7e8ef2655,Healthcare,0.8307230092214659,3,17,483,778,295,41.26040065719673,1434
aa9a0985-5a3f-4f84-bfcf-c6b1643e3187,Residental,0.649660462534006,13,31,268,801,533,83.76181405632279,5967
765f95e0-114a-41c3-a7bb-cbc1f2b3e3f0,Commercial,0.4726339395373169,35,34,273,826,553,46.314651944475145,2906
a3996f3e-97ca-40cb-a4e7-0a8492100e6c,Commercial,0.8800219528472525,41,37,517,538,21,98.54832171274819,2924
240fc7c4-fb86-4671-9fb6-031bffeb541f,Residental,0.10479568001356787,26,7,476,963,487,53.440839525087,9259
cdaecab8-be5a-42a3-a281-06d279867cb8,Commercial,0.25433480315480994,16,34,132,759,627,33.00949057961812,7778
e6896575-de1c-48fd-9dc9-9c78a77f8b88,Healthcare,0.9949390119082051,38,42,128,1186,1058,34.591835999226014,3284
5867c599-897c-43cb-a398-4e94c1a257a6,Commercial,0.6475572157945908,7,32,233,464,231,88.23033569922207,4428
61f0dca7-4bf0-4958-b555-5d7575e34572,Commercial,0.7095583908931455,26,19,7,1130,1123,47.55135198601885,9335
38f92530-3c06-4315-8287-9865d414de77,Educational,0.265166467649981,39,40,638,1387,749,31.3991681912886,5563
ff9394cd-b8df-4b29-a7d1-71872ce8068f,Residental,0.15134142128621775,4,44,13,917,904,63.56829117829496,2996
f139d7be-060c-4ced-90bd-0e2c3eca8830,Residental,0.9758938245946712,27,34,151,706,555,28.507644253480326,7120
0d4a4eb9-05ab-46a1-9647-2adc4dbc0be1,Healthcare,0.9774037019984977,36,12,93,621,528,16.372784157904228,7653
7ba56e31-6cfb-4b77-a8ca-bbab209ebd43,Commercial,0.24581785138214984,21,27,207,1247,1040,59.126809224615556,7565
48600555-9057-4221-8147-87eb6cc1f599,Healthcare,0.11422063447348219,39,35,575,969,394,40.04790066638963,4714
3e034771-7dde-4a12-abf8-3a248b45ffe3,Commercial,0.9071446935223182,31,9,149,424,275,80.95192765007211,9184
600e7f97-76de-4b07-901c-3326a3892fd7,Residental,0.0879682092050037,48,50,252,301,49,55.86110095120791,8504
9a5218a5-52e8-46b9-b67c-804f0117d72d,Commercial,0.28182501864388865,7,9,593,1319,726,68.12433699500366,3726
3c5c847f-f68a-4a59-90f9-2d10320b3cf6,Residental,0.06795460883416948,39,16,379,491,112,19.689759125270072,6677
50d4acf0-422b-409b-ba70-688f4d19342f,Residental,0.3019600525815984,32,43,58,1258,1200,81.93873962636832,8827
10471893-f173-4c03-b8fb-0635aef259b2,Commercial,0.2086487737639865,47,50,505,1110,605,79.35472028923164,7767
cf7f753e-63ac-4a65-8c25-08b867e53249,Healthcare,0.4057429238020389,26,29,56,100,44,73.63317094195438,9189
39b7f9d7-b373-4127-a354-c4b48b3221d3,Commercial,0.6118234492805855,6,1,480,598,118,23.425483055076057,2355
c330d505-c95b-4032-be5c-fddc2ea8a7cf,Healthcare,0.10502165215339021,32,8,624,788,164,57.7042442332146,6068
457d9359-24aa-4db7-9822-db0f570a131e,Residental,0.027833685862450386,23,10,260,480,220,36.82333309305553,4244
d6289660-c372-4c6f-9fc2-f80b75ed55ef,Healthcare,0.7344864412029382,50,14,664,1109,445,33.01701740325956,6276
8266f90c-3120-4c6c-acf7-bda21cc159f7,Healthcare,0.9889472799953309,10,7,71,728,657,85.95177951584297,2528
96131550-6461-4314-ad36-d68896553bfa,Educational,0.6516820229670748,18,9,462,679,217,55.10840376310142,2538
c1aeed1b-24c9-430b-a765-a88ae01306f5,Healthcare,0.7455738731240801,12,9,699,1377,678,65.12502223710158,3535
31da5e22-85f1-432c-b336-2adee4318cb8,Commercial,0.5459597910090304,33,30,240,1278,1038,94.55573444186871,6822
957ae96e-548d-4e2e-8660-8c8caafa6e7d,Residental,0.327845607494472,2,44,135,512,377,94.33610308048138,8497
ed4fd3b3-5ac2-4426-b259-2e4f2e98053f,Educational,0.7118275670528752,20,31,529,1320,791,69.88187803592561,9175
46518795-8fe5-4629-8c0d-2340e1c8314b,Educational,0.11927641766702668,9,35,237,453,216,81.03410733752698,9702
c2023e74-db61-4674-a4c9-109694f3c78b,Educational,0.10935891641847606,30,20,692,853,161,45.4966249520689,8747
91355099-4080-49ee-8c8e-f4bdac4b9049,Residental,0.5899831920540907,10,44,575,1066,491,97.0315781932886,9265
59b4beb5-53b7-488c-aa46-e01a331b57d5,Commercial,0.6914265430048562,17,10,576,1437,861,59.626480314992776,2813
08959b99-fa55-4c1a-81c9-e3ff8817b689,Residental,0.2905784235417018,9,39,200,1156,956,60.84194497653351,4268
9fd3a35d-e81f-428f-ab3e-05455992c7ba,Commercial,0.8217945211548977,19,32,447,918,471,39.20830260200694,4422
316859fd-4105-4c4b-9b98-6e7935a6fef6,Healthcare,0.352332611339933,20,44,519,1011,492,68.25398708033524,2796
f0201cb9-fa4f-4abf-8379-89e2ab0b21af,Healthcare,0.6118969310409895,32,34,578,584,6,42.828360289179166,6616
f57558a7-8aee-43a5-8c3b-17b51553ee0a,Healthcare,0.3443559295347485,26,8,659,1228,569,96.63448696844324,5103
10572ed8-1704-460f-81ee-39c27a05c420,Commercial,0.8244345337987885,28,15,223,927,704,35.71149339357257,2113
3adbf156-76e4-424c-91dd-7d139102a387,Residental,0.996070807077072,27,35,494,1161,667,15.932376619560412,5825
1cd5c7c5-ddea-4caf-a742-ca35be044101,Healthcare,0.07224843027828931,28,15,234,667,433,44.10399277136659,7309
d925b9ad-8da2-4e39-be6a-5a6724e24d91,Educational,0.9986686339941673,43,34,571,1017,446,41.56466117070124,5400
9374f6ea-bf3b-49c3-aa14-64f75eea88b0,Educational,0.9829754641623496,7,28,441,1205,764,15.237423705056568,3250
aed3f8f8-2bf3-48ef-8368-1e5b7e617bd9,Educational,0.26951106286821047,25,47,261,586,325,96.26744496201745,8475
64d9a6bc-0d65-4c68-b6e4-8220e1813bf9,Commercial,0.5261845762943423,28,7,227,480,253,10.623838907634195,1203
dddeda66-eb92-4bbc-8de3-925a4ff8b777,Residental,0.09910114560527372,30,50,229,1170,941,33.0897951923172,9761
8bd2df0c-48b4-4a4d-9f28-c2394ab9f1ed,Educational,0.6177112334883536,16,10,159,884,725,12.407059118106972,1030
ddcc24fc-0878-4ae3-a782-7152f3873d0e,Commercial,0.021375984041676177,25,2,675,1070,395,89.4135784111102,6423
adf1d8bf-14a2-4ba0-9147-6b4d09b82043,Educational,0.6727928293246962,38,25,439,920,481,95.86301520548292,6892
0ef10af5-f7f0-4936-92c6-d61ac0a83c0b,Educational,0.08242223752880606,13,46,422,670,248,11.663143668317696,8048
8bbfdad0-ee1e-4e86-83e6-b945605c63e1,Commercial,0.801913285405355,35,49,190,635,445,50.903084124099344,3342
cc69b835-cfe3-4d11-b88d-937e1f8646d3,Healthcare,0.07764169446912184,2,19,465,1422,957,92.60893029009767,8214
0d3329b6-b7d8-4a16-90af-4ec475b9d7c3,Healthcare,0.6964540650583934,3,43,108,337,229,16.834189615951846,7955
f6d8e4c3-d1cc-469e-ac56-cdc75ef23ff7,Healthcare,0.40699501202822275,46,41,313,1268,955,63.292160259683676,2497
3622b3b5-fcfb-466e-bc47-a01091d72f55,Educational,0.4531502200157641,32,31,659,1092,433,92.93326667197772,9493
a5a49703-a34d-4684-8aaf-0e845217b052,Commercial,0.6336496052575025,31,14,691,1274,583,24.779957928056586,8923
baaef09c-05ec-4456-bf7d-1eb5d8d3445b,Healthcare,0.9674600228578207,40,8,663,995,332,87.5708073880598,2330
5a643a92-0908-471e-aef5-0804391f1048,Healthcare,0.1724609034884932,49,13,527,578,51,46.902309606274855,4051
8a0a0db0-308a-48b0-b147-171bcddc9710,Educational,0.9004326725405462,20,35,447,1080,633,31.29448436973816,7749
4004c38d-b4bf-4849-b3b4-d53b518226e7,Healthcare,0.05148890281337892,29,20,542,1329,787,30.710021067364586,4950
2e07bddc-6a68-4360-a958-cefe15280a82,Residental,0.09173134826612239,8,50,665,872,207,16.800228673991157,9410
08b7f7f4-3f9e-4ba9-8e05-00304313812c,Commercial,0.6225492908991336,21,48,7,551,544,27.399181610245638,6201
25de79dc-e6e5-4b24-869c-865fc9a80ee4,Residental,0.31649067202097014,33,8,661,1210,549,28.36905965441807,2060
d4d42fd6-4436-49ae-8811-72f26e7acbdc,Commercial,0.014426871336377767,25,30,14,1125,1111,48.54121959824984,7570
47fbbbc0-22fa-49a4-99e5-2df4b11f074c,Residental,0.937927978492237,26,32,447,829,382,22.42528135265149,3033
99174bfd-3640-4425-9ca5-911d371f8c69,Residental,0.16479236624917237,11,4,643,1252,609,40.399550922810576,8912
ee72d6c6-378b-4353-a5de-4502f985c7ae,Residental,0.2458921079623272,36,17,126,512,386,49.27109114294747,1423
68d4bef0-af6e-4c33-ad4e-29639775cd6c,Healthcare,0.33200915217926996,33,46,572,1329,757,48.38478745671128,4403
3407ca7d-f770-4715-81cb-6f2603efba41,Commercial,0.013720746545939577,44,49,561,1030,469,87.48849668670599,6439
dc32c5b3-9b9c-45e1-936a-430d4c6e0685,Healthcare,0.8684701387767294,38,8,23,968,945,45.52298296511086,4979
b42bb808-0be1-4cd7-809b-6af4ffe4f409,Healthcare,0.8483768846898854,12,36,287,1142,855,16.680587146953172,9230
e771ca6d-5445-4c96-86b2-5d2af5d5151a,Healthcare,0.1879059430946013,26,10,425,686,261,62.45888009576532,7610
0fb4ee3f-0a71-42f0-8fe9-091d51d18d03,Educational,0.17404960420190618,34,38,387,1320,933,45.33379254014683,4055
425ba905-5be3-4575-96d6-d5ae9642c8c4,Educational,0.5561236695862645,11,14,595,873,278,22.620084241563,8733
7d4fd7e4-10d9-4d51-8765-8d76da3d89df,Educational,0.5096490719600884,27,32,539,731,192,90.12261054643209,4823
1fc8dff4-d30b-46c2-8053-e978997b9988,Healthcare,0.15262271735596555,17,16,394,1242,848,26.700296287750998,5872
1947962f-a5a9-4ed7-8d2a-26334e6500c3,Commercial,0.257121716222801,38,42,232,638,406,20.859364872394885,4189
feedcc4e-4836-4202-bf3b-90cd0486c37f,Residental,0.11328383895351046,11,43,269,1006,737,25.20470921821268,1554
7a2a46cc-a182-457a-a3b2-1d942da29487,Educational,0.15717574337804485,40,16,310,410,100,65.32895238079278,5904
a049f7a7-3e64-4e90-92d8-9b3239529575,Commercial,0.41084361477287545,21,3,316,1030,714,89.1951720895907,7230
36da5365-eb77-4d1c-a25b-42cfdc6029e0,Commercial,0.885039421975088,14,19,637,1183,546,32.41904834343612,7407
9f70f346-3490-4d7d-a37d-dc77ce62b669,Commercial,0.5389864507298269,20,15,483,492,9,70.28043890749981,1684
ca9a26c8-3fd1-402b-a92e-3a1da4991ff3,Educational,0.21143152769231854,44,7,274,769,495,80.04993413605887,4572
65fa4d0b-2c6f-41f7-8f79-a33dffa0c6cf,Commercial,0.6448821362968968,20,38,28,1280,1252,62.291319837842174,8250
5e2efcc1-0059-4adc-86a0-e52f874b1c2d,Healthcare,0.8543338889544688,43,15,688,1395,707,59.85842781453516,1229
fc86e956-6417-4422-8d6d-d22f3f578bde,Commercial,0.8029204884200881,1,30,695,1111,416,60.68617628125648,1939
2105fc0d-631d-4eb2-85ee-b0c6307e5602,Educational,0.2864891840338297,44,37,521,740,219,89.22974645113285,6660
5a800d30-1fa6-43c8-bf74-a051610ae068,Educational,0.3149386590098491,38,9,529,733,204,43.2691909356051,7912
72fcecff-82a8-4ebb-9234-cd365c56b6bf,Commercial,0.6864741707230532,4,5,600,1396,796,21.425827348579823,8697
f186d09a-079a-44c7-8d40-366bae95f92d,Commercial,0.2946171972072106,38,44,521,679,158,41.40695047067577,2082
e76a4e00-dc37-45ae-b897-c20cc65acb64,Residental,0.30344815840234174,18,4,477,1232,755,57.88206833702908,9999
586b2518-f600-4a3f-92f6-3edbef0d3df1,Commercial,0.7016588263918122,5,20,710,1383,673,35.17422358829566,6079
4b225b5a-db03-4062-8f0c-c2aa7363c6a7,Residental,0.5608963628029766,49,39,311,315,4,62.18288643047233,3346
df97ddb5-1d30-48b3-9bcf-cc6c899401aa,Healthcare,0.3064650268265463,9,11,18,773,755,66.5859625962473,8631
4e0807eb-01f7-485e-978d-a4d1b1cef745,Residental,0.20205746131507674,32,39,9,182,173,98.33698432867202,7527
1aadf5d0-d949-4ec6-8a88-c6ee65c46e5c,Commercial,0.7128387838522595,28,39,623,1074,451,99.07199650481654,5042
8edbfa87-ec48-454b-b09c-c844fe5f855e,Commercial,0.6621568768393367,3,39,46,446,400,57.60246904915896,7699
eaab634f-4ca2-4279-90d5-ab4132f3a242,Residental,0.05624266598751693,22,22,235,1034,799,56.53355106783183,3747
39b2530d-aee7-41ef-9cef-b37d621783bd,Commercial,0.20324910329611934,7,16,23,1332,1309,24.678455473346844,9886
e277e2f4-7904-49f4-951c-d2280ca137cf,Residental,0.46518486744308507,45,14,71,611,540,47.73962400602396,8347
f4f16ace-3f64-4d8d-92c0-b5e569d9cdd1,Residental,0.12935720871867318,39,10,62,363,301,58.39502455239632,1012
7c96715f-bbe8-41f7-973a-40d5222a882f,Healthcare,0.0006244868674644133,22,32,415,1092,677,91.74696698194076,6339
6997c708-2f46-48d2-afa5-720b21045a99,Educational,0.23995857176359026,13,25,232,983,751,72.13316800033591,4262
73a71b70-073a-4ff6-bd85-591339f79745,Commercial,0.3435261388711571,15,23,575,1367,792,67.55219491449068,7373
09fc0c6e-5731-4bf4-a4c0-811739d5c9a3,Commercial,0.37222847591470043,31,44,14,377,363,53.47726519165386,6408
80075a85-d5a7-49c5-9772-f4cc2bb352b2,Educational,0.8527932841362175,40,4,115,427,312,39.78174034203182,2032
6c7fd2f8-7996-49cb-b77f-31594ffc6666,Residental,0.38236316493888756,39,44,667,1380,713,25.58150759076929,9289
e8fcac3e-810c-47ed-b38f-b4b55bc80cb8,Residental,0.034242427730324376,8,48,682,1122,440,84.47641968943603,8362
91dcb7df-2b4d-4975-8021-3dff1d92a79b,Residental,0.2530079590499079,18,37,379,1362,983,17.589842709611048,8106
2a62ee10-2a15-44d3-8641-95bd6cbdce25,Commercial,0.34856783848176776,42,16,216,521,305,86.08605657785209,9348
1ee73415-64bf-491c-a629-6ef89e4bdf22,Residental,0.6459845034435675,50,50,267,1278,1011,49.231842660058916,6272
1820eee3-f821-4bbd-8d61-c028db1f3a4c,Educational,0.6547982277250037,41,10,339,490,151,87.60405757906227,7376
6295264c-85b0-4bf0-9800-558396378250,Residental,0.5175087655769747,32,12,314,618,304,14.385597378611218,1725
a7b8c107-28e3-4c08-bb7b-fd2cba64a309,Residental,0.4192380079518213,43,7,216,648,432,62.31723925324665,1031
ceb1550e-497f-4510-83bc-9d4d53b644af,Educational,0.48305292081419593,43,31,432,829,397,40.949797427143395,9466
aca73c7d-99dd-4606-b4ff-ede1e52fd16e,Residental,0.8831578549913116,27,37,1,794,793,41.16128535109239,9582
87c30f95-7fcc-4911-b2fe-2cf9dfcbd01b,Educational,0.06886578982475267,33,40,21,1100,1079,99.85741043291237,4844
9f61dab3-7378-471f-b517-c3739e2990f0,Healthcare,0.1000624796210251,28,10,351,1008,657,71.40424006062203,5340
49433469-5135-4c91-a1f4-a21e92b38611,Residental,0.4192758567396726,19,49,297,778,481,60.55907276818998,6932
910f6082-32db-43b7-998e-04fd1c2f995e,Educational,0.8249485415024145,37,30,645,1085,440,83.7576616347799,4323
5052d761-aed5-4656-a007-48a438da0915,Educational,0.3157743778988288,13,31,537,1329,792,12.566796960650917,5265
14d4b86f-bffb-4131-b9d6-7c24008db6d6,Healthcare,0.02899364319354525,38,6,639,1017,378,98.35540153056579,6817
5fa1a036-2dfc-407a-8036-981ad5533f79,Healthcare,0.7268483337682187,44,43,219,1249,1030,67.8214604700157,1343
0f7bb743-9c2e-4c36-8f5a-2745f312cea3,Commercial,0.45343112815569775,17,26,572,1044,472,19.98594619321021,9011
047a8012-c00b-4b39-9325-2708495dd1c0,Healthcare,0.8140831798302475,49,43,38,187,149,66.47179915917522,7449
ab69ecfb-6cb6-4cde-b522-c009cb5124cd,Educational,0.2634279592008849,21,33,649,1198,549,85.09104924817235,3355
193f044a-0e0f-4263-bffa-5144dc6583c4,Healthcare,0.2031440449663643,39,26,211,696,485,30.924320857567793,4835
7930e44e-4c4e-4d50-a283-55f038e67dc6,Commercial,0.4949618918073949,8,23,311,864,553,39.64933839390017,4388
c31c0b05-c18d-42db-8e89-945d1493a3a3,Educational,0.3183610345906287,23,18,593,979,386,58.81703016037794,8900
b0a2c279-eab8-4d01-b3ec-5259ea3f392b,Residental,0.11763162196394561,48,37,242,1316,1074,35.330048588304045,3196
409e7a9a-31bb-4f15-84af-7d5ad0ba176a,Residental,0.4304517843296636,44,28,402,898,496,74.19174218813389,2792
1ef1916e-38b3-4aec-b3df-e0897994befe,Commercial,0.8277812270418595,42,1,33,641,608,28.523682571715614,8343
2631fe54-0ea4-4fcf-89cd-fb4043c6e089,Commercial,0.38126932490068166,32,11,472,1128,656,85.88466592912529,2292
da6eeac3-2416-475f-aa9b-7c8576fc7fa3,Commercial,0.3082674298682092,7,47,349,808,459,31.938548330784382,4966
6e7a45f9-ace4-4efe-af1a-3a654c37564a,Educational,0.2937156729004542,46,40,696,1052,356,64.72209105754254,8305
50fcf3ea-4fab-4df2-971b-d07dfdfc0cf3,Residental,0.9850157322463841,29,49,467,1109,642,39.22014036476539,6993
807d922b-0165-425f-a2ef-808f5cf8f648,Healthcare,0.6358449528445895,32,38,130,1160,1030,21.351339930082634,1193
e1ba0326-9202-447c-a45e-1dad473c05f0,Commercial,0.9183703110835552,43,33,431,532,101,55.0437108977511,2839
73ea6337-4289-47b0-9251-91a8facaed84,Healthcare,0.4025724747713003,20,11,671,758,87,93.07900811898689,4075
a31dce79-be94-40b4-8ab1-18b72209b12b,Commercial,0.13252653007151116,47,48,426,1111,685,30.994454561626167,9428
ae9e2f93-4438-492c-8dfa-1aecafb4ae69,Residental,0.8323937478657657,3,28,104,1179,1075,40.584054085273,7958
a65c396b-f10e-4ccf-be71-30e562567317,Educational,0.7443148455759104,13,19,139,1060,921,77.24024292933993,6699
c2c6169d-1464-461f-af3c-45c10a481c6c,Commercial,0.6152127149321319,48,41,304,570,266,23.808743973056984,6207
450a325c-1dec-4bb4-b175-378e2459f6fb,Commercial,0.09593025504520913,7,3,197,678,481,12.589077445620472,3141
ec935ca0-3b98-43f2-b978-fe9e23789111,Healthcare,0.4195682918123044,18,4,683,1052,369,76.51417859898262,5710
e055f47b-77c4-4ec7-a07b-ea43ce0288ae,Residental,0.7218588092064385,34,14,686,1157,471,92.11893698785128,4398
5bcf172d-d4c4-4893-ad17-7909bbc92c92,Educational,0.6517806068375996,49,46,167,1111,944,57.42368557338473,7709
320d2374-4afd-46a2-a06d-7a4bb6b13d0b,Educational,0.11728624888385597,23,2,496,927,431,60.734924312337846,4366
7a6d168a-b844-4fba-8ffd-f90cba63fa62,Commercial,0.9734444461372694,36,29,121,361,240,34.653851351567056,4606
c1c152c8-115f-4cee-9194-f1a93a433687,Commercial,0.6602350779610834,14,6,394,1076,682,18.67044009240639,5682
a3b403a3-f883-4716-a718-29a5381ac91f,Residental,0.7450000913530285,24,11,555,1329,774,51.38851240151567,3020
fac1673a-faac-4847-b42a-4e82679b69c0,Commercial,0.5234986022929488,15,15,293,681,388,97.62032237518241,6215
cc880a71-f4fa-4314-8299-58843452790e,Healthcare,0.07399541301309842,29,40,181,1055,874,87.88522205443772,2793
084a82a1-47b7-40fc-8fca-961ed7028db4,Educational,0.9266258591168467,13,28,389,673,284,14.62658843379543,5868
7d924837-590b-4a64-9c24-3a0e426eee47,Residental,0.4622750824643379,32,31,55,1323,1268,15.813050626396707,3507
67a37381-6bcd-4c7f-ba14-f0f6ddd95bc5,Residental,0.23173825307835538,17,50,131,460,329,29.32591514580259,7400
3afbdab4-49a0-4489-82ae-0a42326ea67b,Residental,0.8888581672152439,38,5,591,631,40,96.0643031664402,7567
10e12427-2f3d-4426-95dd-c95723cba746,Educational,0.39094451175698575,11,28,447,1364,917,59.36936554365436,5728
ff25288e-7808-4b3f-9b9c-ce259120d208,Residental,0.7636445263135313,15,36,81,1130,1049,55.71835674110446,9117
11a02b14-0437-4326-8937-603976ffd26a,Educational,0.6118197153116066,6,47,480,720,240,87.77310189838931,3254
988fbccd-50de-436d-aed9-36892780f59d,Healthcare,0.5112232417942528,42,44,438,1047,609,67.74015503009144,9084
722a71d4-3cab-4d1c-8243-3bcccef0744d,Healthcare,0.67146388090472,28,9,241,517,276,68.99095788231587,4871
473294eb-e880-48f1-9fb0-6f6a04180ade,Commercial,0.5750711679462907,43,32,223,741,518,93.99633392286844,7867
eaac4594-a2ae-4b16-b583-7d6a4625ce2c,Commercial,0.21789891994749688,14,41,454,1340,886,29.178525588594866,5872
486f6a7e-120d-4509-993c-2a61c333bcc3,Healthcare,0.15670130879507493,14,19,543,891,348,90.7713177952536,6183
c75318bc-5add-4dae-9b93-3f96eb19daae,Educational,0.571293649206368,41,42,163,948,785,10.636844404382437,9502
ae787c55-5607-464c-98f4-6690af104cd8,Educational,0.6762237690996039,31,18,705,889,184,53.75493762705126,4390
a4059326-f2b4-49d6-afb9-b83cd886b81b,Residental,0.6585182782834184,42,3,522,747,225,27.66744292844854,8673
15d1762f-6979-4fac-a99c-ea58eb308a59,Educational,0.587475738745443,37,35,637,1234,597,57.757003499975255,7017
7f023fb3-7bfd-4fa9-a322-ad250ef3a2f7,Commercial,0.8082202015160119,16,19,138,1073,935,98.65299397166814,8274
84d6ad60-77d1-4d7d-a75a-5109f0a1750f,Educational,0.5638708359891321,33,6,119,1399,1280,92.13601923244781,6982
e7c4359b-fb5a-4c69-83f6-9884a6acca17,Residental,0.7625827245839454,9,20,243,940,697,98.4997449025471,5621
67db531e-f358-4f8b-b758-bce68c61fa40,Educational,0.6028310193366132,20,43,368,890,522,49.750603649988754,1245
e03b0476-52d1-41c1-9e42-364b0fc08fc6,Residental,0.3210202859443869,20,25,243,1186,943,97.38526851952876,4847
8e16676c-4246-4226-9872-1462f62a93ce,Educational,0.8358927723841386,5,3,620,1292,672,24.964881465348544,4519
0cf3b4dc-08d0-4260-aa4b-56c05d85b887,Commercial,0.3154985133863911,21,8,546,773,227,71.1245795695612,9899
90c012ab-5af7-4f02-b56c-5beb84a0d296,Commercial,0.17028304606383882,44,4,154,866,712,83.21399554846349,6873
75ba1e43-9ffd-4455-a6c9-e3f0458010ab,Commercial,0.8828396724866425,49,44,166,1087,921,48.47040353014676,1590
6ceae962-e905-4f77-953e-da65feac12f7,Residental,0.28614228714609424,29,37,27,556,529,38.71085482462176,6657
9918691d-f2df-44ca-b0ed-93a7c09a70f7,Commercial,0.224601501354304,13,37,520,968,448,94.47749607961522,9492
17b85939-6355-4585-949a-65813e82af42,Residental,0.5481027048335094,33,20,397,1379,982,81.8962288216311,8868
964966f0-6126-4c39-ad3d-419873ea4bd6,Commercial,0.3643730315927065,34,26,355,640,285,41.16423237912111,9561
e2aeeb31-0444-4ba3-b002-885b65998dcb,Commercial,0.28410427283458095,45,19,100,193,93,95.48725688962182,1466
6cf15022-a6c8-4f35-a4fe-864102f0a0e6,Commercial,0.6007667917934841,7,35,251,419,168,34.696861454483916,7156
94e47bd1-f1c2-48c2-8ab2-2414cb451992,Educational,0.5098772738933655,18,4,403,1374,971,53.20943530461088,3771
5d47b3b2-f312-4010-9106-0eb0d4956a35,Educational,0.7327759754601124,9,16,191,460,269,53.532050416656816,5575
db9202d7-5079-4fa0-afbe-3341b0747335,Healthcare,0.5275596542574659,1,33,570,909,339,48.83049419825652,2000
13799284-3b20-4291-a916-d0b5af4c2eb8,Commercial,0.9093774973030155,17,42,646,837,191,26.720629428171826,8158
78f73d87-07cd-49d0-84ab-601c8d780eaf,Educational,0.7554539262046934,20,31,335,627,292,92.29150581131528,5098
46e61a2a-8051-439c-85c2-0a1f927e8e3b,Healthcare,0.23287230102324674,22,4,720,808,88,85.49245456453511,2969
0ff5df9d-0a4a-4728-bf6c-eb910058f9d8,Educational,0.23078887305653284,30,49,560,1269,709,69.5957290515079,7841
8d124b68-0165-4105-ba3a-6bf5cfdb74ae,Healthcare,0.9109724245464604,25,18,348,470,122,85.35470561020988,1843
29b596dc-b78e-4714-bbea-a064b5607c7d,Commercial,0.5797982514905953,6,23,264,880,616,95.27123724013728,4757
1e839a59-fc7f-4439-afc2-de053a06acbb,Residental,0.23505289020188258,41,4,112,1163,1051,29.562440993151014,9840
eb858e8d-667b-464a-9e43-fb458f2b881b,Educational,0.36525941335015244,10,40,175,241,66,61.423484113401905,6962
55c75957-58a3-4c8f-9d51-5acd21447c08,Educational,0.8919128037800462,24,3,5,557,552,65.54803747586772,2718
5fe7a506-cfb2-4e75-bc9b-6a8cf4a76fd6,Commercial,0.6537754856931598,41,11,641,953,312,94.86578214704475,1799
adc6cda4-495e-4c67-bf07-b3de76fa0387,Educational,0.7499410772800498,11,41,181,507,326,26.24619849291749,6268
766e04fb-4506-414c-a4bb-b7433ae4f0d7,Commercial,0.706162606541311,2,45,234,505,271,44.86140641724613,7480
b15a1613-4819-4ceb-970c-3b75dc98c91d,Healthcare,0.8348875501539473,29,19,551,1145,594,97.76258817340975,1498
e5d154ab-6825-4978-ba91-57a06547fbf4,Residental,0.22816394487898295,30,24,279,416,137,52.22013888502805,6450
3cbe2677-cfb6-4a21-8d61-efdedf676fa8,Educational,0.0646864750037528,14,24,623,1187,564,85.8154959027347,5495
79336d19-52bb-4915-91e2-caf3363f5e0e,Residental,0.3265651884158659,43,24,185,1209,1024,47.51172293295335,6437
d9b49133-a026-471b-a526-8e0d5abf57dd,Educational,0.8288508046510997,49,40,57,59,2,23.634575017191363,8280
a581e47f-907f-47e2-9902-b8fdb07a1794,Residental,0.9078982461845814,47,42,538,605,67,80.19815742150845,9083
f1930a2e-f3e4-40cc-82b9-0364524a1835,Commercial,0.2913073898665408,8,28,533,1255,722,64.06672991577801,4120
62a31141-f91d-4c4c-b7d7-d97b5e900152,Commercial,0.13511744088813915,49,18,610,1081,471,75.20808871819126,5543
0ff8e143-fdfd-4d31-a3fa-b11a30a646ff,Healthcare,0.1591775956250049,2,20,117,1092,975,83.03407162387252,1096
b8db2591-0716-4fdc-b251-067625913b3b,Educational,0.04022534685894219,14,39,104,916,812,47.811304375827305,1780
5cbe0c7a-10be-4463-a501-93574dd800ed,Healthcare,0.3884511278591689,9,8,452,906,454,21.865001960003234,4617
0a85fa72-b2a7-4149-87aa-3cfe1c7630b8,Healthcare,0.7510058974972128,28,37,41,1343,1302,91.58398587256232,7271
5474864d-da18-4e12-87e2-78c3281c5bce,Commercial,0.4291866199426976,17,29,238,1360,1122,20.912413218490258,2475
3bc7a754-5136-428c-a532-71c7ec6aee2b,Residental,0.6662653491011711,14,49,54,835,781,92.27680803031994,3888
62bda1d1-250a-46fb-a5be-d463a84bc3ad,Healthcare,0.6559728482129884,35,24,659,746,87,88.87517365423147,5147
98244af1-f2ae-4bf2-8a11-1830cc991b28,Commercial,0.5368443726635167,48,25,359,1032,673,88.44514441494543,1983
a9c4c6c6-a8bf-43c2-97ba-953e7268f728,Commercial,0.22740677735735837,28,49,359,457,98,38.28742792203836,6089
9db11b5d-4a1d-4a7b-800f-4514c21b5e5b,Commercial,0.43036603692180386,20,29,685,1226,541,21.669361325625836,9121
6afe49bc-1d75-4cca-8ac5-2156dd6863c3,Educational,0.7907325799182156,43,27,17,864,847,95.88422485134771,3869
578c8bb1-454b-4e93-b87a-675033bffc33,Educational,0.4430668959728097,11,39,48,149,101,17.57283882568381,6823
ada2b049-94a8-44f1-abe0-7a4744848ff8,Healthcare,0.8947615135460711,5,29,294,1075,781,15.67402417724238,6513
02d674ba-0d46-4d0d-aa58-390f57bbfcd3,Residental,0.7951674140264646,13,13,70,461,391,41.08749017705068,6298
b3f48053-4f6f-4d81-82c6-e9df9badaaf3,Educational,0.7376261109475134,12,21,269,1133,864,56.75970606355344,5486
22ae3489-a81e-44fa-a08e-841978ba45fd,Residental,0.9517675708784421,18,6,122,906,784,71.0660192065666,8908
e52b7ebb-ba5b-4b13-b6a6-f2673b7dbcd3,Residental,0.7235326366660197,46,38,482,991,509,93.49114405566294,1904
57661958-06dd-4e3e-8aec-9fc52f1f6921,Commercial,0.11781507834653204,38,23,673,1434,761,36.36359644234473,7882
a0854c94-c56a-41cc-8fca-0abf4d2dce80,Commercial,0.025442177171253078,42,29,506,546,40,56.50046667783727,2292
bf4971d0-fb7a-4856-a6f2-aeac636239a8,Healthcare,0.8550174485204249,31,26,365,1429,1064,60.70021813376949,8594
33f62680-33a6-4bd7-87f7-84dcebf14891,Healthcare,0.5382599660221028,31,27,539,837,298,73.0309890731753,1305
69471abc-a922-4407-8454-a1fe3ff6e87c,Residental,0.16609379254903112,41,25,287,772,485,47.44601356056863,3804
31c9c741-0044-4f81-998b-933b657bbad6,Residental,0.5671419787434414,21,48,612,1001,389,40.11037450996146,9309
f3d5372f-9af0-4da7-97e5-e5474e1fa8c2,Commercial,0.9378833623252689,34,37,686,1105,419,43.68793415278932,9387
0d8d7e8b-2f61-413a-ac41-870a31d720fd,Educational,0.45532571676630984,49,29,596,718,122,92.86609122359829,9189
6386d438-1389-4e8f-9080-178faf3d7713,Educational,0.5686083692790226,14,42,129,1291,1162,47.48169364594149,5466
669072e3-7b45-4cd4-82b3-92e51e2ee9ff,Residental,0.19095346666051127,18,4,434,896,462,26.618959713352332,3479
d2d39e7d-207d-4f64-9a10-5b7da427d17c,Residental,0.11875474200251213,26,48,599,788,189,42.34188335120698,6483
94755420-a2c3-456f-b8d8-e613679d5642,Residental,0.37884691219466293,12,30,595,1350,755,27.884686287225044,4748
4642c6e5-7c1f-4853-b489-34cf4583a66f,Commercial,0.7834097028338228,13,25,561,820,259,25.0477841899631,8781
29467ca9-f4cb-4174-9dbf-5b1dd1685de4,Educational,0.37367773533750415,38,25,661,1253,592,37.81161396006435,2408
f98a5e63-5406-4af5-9b2e-530a261b25e4,Residental,0.4397134592577271,6,1,668,764,96,68.09672353031145,2535
80ebc165-4da3-4218-b00e-12600a9ecaf5,Commercial,0.24042598943086868,43,48,675,943,268,16.859389419185,4161
45a43bad-de4f-425d-9fc1-a97eec0aad6c,Educational,0.7383714123164188,29,1,678,747,69,94.24297344237186,4538
6223567e-9cdc-45d3-b957-b16213216faf,Healthcare,0.18686852370080087,19,41,626,1222,596,15.969645570307236,2965
24a6814c-740c-41f0-9aa5-ab844b20c345,Healthcare,0.3976741152591813,28,12,91,833,742,72.53055698816097,4563
84d7cefa-b607-4b52-b34b-0b50341ebe6d,Educational,0.29049790367268913,31,41,683,996,313,51.74190095682087,7021
07098d6b-c21a-481b-802c-888444c6e119,Educational,0.46859328550094925,13,16,30,1102,1072,28.883937060092308,5909
3712ae16-e9e3-419b-982b-9f14f2ef2935,Healthcare,0.8679614620776591,46,44,425,1014,589,32.23041106425909,2627
88dc27af-d03f-46b3-8732-135757464610,Residental,0.9113010761614914,9,11,283,1109,826,46.086225804116964,6275
4858c80e-c89d-49bf-9371-891450947780,Healthcare,0.8390383280809911,47,14,51,597,546,79.05357102961523,9378
5b9f3a2a-e636-42ec-9842-882315361c67,Residental,0.8595421013995659,10,50,157,178,21,18.747109277945842,9869
cb81f89b-5f9f-4915-889e-73496c30a174,Commercial,0.9740962250192718,13,22,461,1011,550,98.85533037184372,8672
0c9bee78-f6d2-425b-a053-ab3c6bead8d7,Educational,0.962842003703891,48,49,144,1130,986,70.32243611010531,6486
16706453-5747-4e3c-a198-d7ded8bb1c76,Healthcare,0.3000184660866232,34,43,588,913,325,82.56778495008504,5005
abd5b47d-3d9c-4608-9e10-0f62cb87de81,Commercial,0.46491551670577713,24,11,216,225,9,79.96303555487451,7711
e1221fb2-defd-4f30-9cd7-153278e1ea7e,Educational,0.30966945830739145,37,33,342,1256,914,45.95220943710244,9639
16ba6a45-d04a-4d97-96e9-a8a53742379d,Educational,0.257545519978858,19,36,532,1232,700,73.66193098435217,6956
a648de64-f124-437a-bcc3-43ed9d0db3ae,Educational,0.2153159385234935,47,6,610,624,14,34.013719498005145,1035
47d1623d-acb3-4e71-bc8b-dc6bcfcd538f,Residental,0.8882016761931456,4,49,612,1262,650,86.95308052025267,4604
3e09d970-5b40-458a-968a-bdf386206fd8,Commercial,0.40746451960397756,7,29,623,1423,800,10.618288258041938,4668
83832f8d-c44f-4f78-b188-5cafe6102828,Educational,0.44405424004518323,21,15,446,964,518,67.9854784529469,1474
eecd15c8-8b14-416d-a146-fe7ed8c7c3b9,Educational,0.16766325579150176,30,37,46,1136,1090,34.265402852230835,7498
e84751ad-07d0-4227-8c31-f1344740733a,Commercial,0.6372353414382891,46,42,506,855,349,55.799977680193315,7677
87a8c9bf-43e4-4943-8088-5182ee8471e8,Residental,0.5508578986212883,32,40,103,545,442,93.28184094702524,8968
eefe6be9-8416-46a0-b1a6-d273262f5eb7,Residental,0.826892263842887,43,16,429,1416,987,59.414383409081374,2917
a7a4dc4b-dbad-4cb2-9a23-3e3acfe80260,Educational,0.20756078000350064,37,48,666,705,39,88.87240849270592,7922
0fc7e872-b57d-4a1a-a2da-a69a716f1a9e,Healthcare,0.027400146557504335,44,2,273,1266,993,89.35031122349552,8952
bf3c0cdf-c5ff-4602-b722-56052ab77151,Healthcare,0.38988585261308983,36,23,329,1371,1042,59.182297747349644,4817
37f792da-3be8-4a1a-9b67-c58510357d0b,Healthcare,0.44485626339013684,4,12,641,789,148,62.585248972118706,6310
6e738d7d-49f1-412c-a9ab-6360c0b0a719,Residental,0.669126893605043,35,4,307,552,245,72.84889163243727,4314
495295a1-afaf-422d-92d2-e8d858eb150d,Healthcare,0.1286049866087624,20,37,498,504,6,53.44004562983899,6774
0604ca8f-9d9b-40fa-a945-f6c368da8420,Educational,0.3389498997604229,18,4,500,632,132,64.44512063949739,5480
264e2f77-49e0-4430-8217-3cb1081d320c,Commercial,0.6727465238153698,45,14,394,852,458,63.635148749019464,9145
74c69382-e5fe-47c2-9f62-44b743608548,Educational,0.1785983238826222,33,37,51,284,233,14.11246043053319,3572
870d45d3-81ef-47b2-b2fe-be2ae4eabcf8,Educational,0.9485236289103655,45,20,497,1121,624,98.72040742800033,9244
e3739592-e769-46c5-ae86-d5a833919685,Healthcare,0.46552929907002316,24,30,31,1228,1197,94.66564946560895,3276
86f32209-5beb-45ea-b26e-cf01b0abef8f,Educational,0.7985797888718108,23,31,57,297,240,56.360361816335,8996
50c70d34-795d-407b-a9bf-4eadb3467ac2,Residental,0.5861370405639039,29,40,92,442,350,80.9146793804981,8577
c274d32b-4f1c-41d6-931b-fd319da9aacc,Residental,0.6454214945064098,44,20,165,269,104,99.77127833848427,8400
a2ec7065-2363-474c-ad6d-ef7100b96fd5,Healthcare,0.7239326279101458,46,11,438,1215,777,58.20716806191802,9867
b5a0aaf0-4bdf-4646-887b-c95990288982,Educational,0.769977415167991,7,46,636,995,359,78.61101111254285,3361
67d2f8cf-a348-4600-944c-6ebcce6e4e71,Commercial,0.4513945692380881,10,37,435,686,251,40.93558409799597,9007
d82d4cb3-0dfd-4d3d-9c5a-f95760326a8d,Residental,0.3408634606059501,41,19,149,196,47,44.41227398864659,6387
32576a78-6f64-4c31-895e-c667d059d7c8,Healthcare,0.29364153461361575,12,30,466,984,518,71.13604852639547,6906
284c0311-3f88-4a8f-a755-d811de82f07a,Healthcare,0.2551285978301091,36,29,458,676,218,52.90858461515904,6138
61d4f28c-c5fe-442f-b692-3316fe7e3f66,Educational,0.20443243947090595,21,5,365,780,415,93.42231068182441,8750
d06c4b6a-f1ed-423a-a7f3-9c54af7a9330,Healthcare,0.013479740484893199,10,14,358,1321,963,41.22545629067923,3778
c7ad69b1-ec3e-4635-87c8-bfeb4e9ec8a0,Healthcare,0.3097447210149721,14,29,262,373,111,92.60183763011175,3401
be8bba54-355e-4b8b-baca-2f5e117f5513,Residental,0.87395688398915,30,46,187,1341,1154,84.42122317214569,6184
83db73d3-8fe6-4580-8687-bc9b380c3adf,Commercial,0.8207370919950204,39,21,115,1297,1182,24.702966790763558,2688
ac1b6f73-993b-4ef0-915e-ea4e581a232e,Residental,0.045651967813128524,31,3,47,657,610,79.77813665929156,8748
bebf51fc-191e-49fa-ba09-6e1d836c88c9,Commercial,0.8210074964367002,34,50,680,1358,678,15.91039880239021,2087
13a4dcc9-5946-465e-a330-0866fada8203,Healthcare,0.8748870087621363,24,25,576,1414,838,79.75091423761835,7404
2797d0fd-46d9-47be-b8b7-50b053286b0d,Healthcare,0.39277393536484184,2,29,435,506,71,65.46232030072294,6352
5761b6cb-7d5e-44ed-a546-5a3257c954b0,Healthcare,0.6778715238642898,16,45,178,1015,837,86.01970939361115,6339
0d2a56d7-5f6a-41ad-8c03-4e212480a2aa,Healthcare,0.050494490137851566,1,40,244,986,742,49.10748760713457,2621
80e490d0-d388-49b6-8200-6df7e24db0da,Commercial,0.30501612607829554,23,23,504,970,466,12.754934557059087,2885
00fe21d0-130c-40a3-aba8-17beac2fec5b,Educational,0.16633682812145023,28,26,378,501,123,92.50253442630104,2741
03609c95-42e8-4d5e-b696-6a824c25d251,Residental,0.7540384900836118,33,14,631,1404,773,35.57335901066617,7237
f3ad4eae-62e1-40f3-8e31-d03b9fe03abd,Educational,0.0009534015278238606,16,21,222,895,673,68.5466925863987,4004
79a26a5b-26e0-4428-9b9f-ae965f2bd0fb,Residental,0.6663448036965319,7,37,367,552,185,75.57831459559875,6273
9af81b4f-bf41-4a3a-bfe3-8b096bb3c16b,Commercial,0.2837129228335752,37,37,707,1430,723,41.60861397893539,8883
cd280856-93bb-43f4-9c13-fe6d08bda0c5,Commercial,0.9074732968305255,39,12,148,785,637,77.95102849110756,5010
74bb3a2f-97ff-4594-bd4f-beac482e91cc,Residental,0.5324526036441924,37,9,179,577,398,58.46068628873473,5657
f5b5811e-08f5-4a3e-9ece-b2c61052c240,Residental,0.37744277055705033,23,35,317,453,136,29.774142559554857,6697
7a4ddd68-89c1-4f24-a358-c4f592d6c080,Educational,0.9398719644982948,18,35,155,1262,1107,48.53193775323268,9756
51f360b0-1113-474f-b120-5f56052b7093,Residental,0.327587105161953,11,48,20,1270,1250,48.84682231412341,6711
a697553e-d56c-47dc-8fb6-4bb122a000f1,Residental,0.9212149908447831,6,30,380,657,277,95.40047775639847,5347
8bb0c733-4e75-4b35-a894-7187a43bb993,Commercial,0.3903888758777877,22,15,232,478,246,26.329010306284157,5030
d42a964e-fee9-4767-9baf-1533db69a2fa,Commercial,0.14207677896427762,45,4,153,1206,1053,81.9517755767325,6800
8524d84d-133a-4e85-a7fa-6956d7a0d2b0,Commercial,0.06605607281914294,34,32,21,1026,1005,71.81167222225903,7188
8ce5d4fe-5d9d-45a2-a070-ce7780ba65e1,Educational,0.8781298180602283,33,15,323,1284,961,68.99641139553967,4810
9b8078a8-d650-42c9-af8e-a0bce251a0e1,Commercial,0.4215875373533914,27,36,640,903,263,51.948061038624566,7351
b1c702ed-ae47-4296-a777-b2482ccb0fdb,Educational,0.49853260780999387,2,43,414,798,384,47.42341663037943,4301
d1e1a680-3e81-4646-9988-b5f81511eb07,Healthcare,0.664467633365448,30,47,100,1327,1227,58.85681294135909,7102
5b63c8ba-6c57-46f3-8a1b-6176ad76061f,Commercial,0.5403116357001942,12,22,387,813,426,45.38226047814966,9566
465fc237-5de7-4a41-9cd4-9543d3bee24d,Residental,0.3227744681695811,38,15,339,1058,719,86.6585573611175,7831
f080d048-075a-4a1d-bf69-2a05e0307de5,Residental,0.20704832065522516,30,26,170,899,729,52.79866970355447,2547
ec0c2545-84b4-4b24-92ae-440541253a42,Commercial,0.9732837687188336,50,20,24,783,759,50.626703737167084,2634
6a3a8010-90aa-4ff7-a9d8-86a0602764ce,Commercial,0.4554289286002775,22,27,703,1070,367,22.829893084389024,4462
f43ff74f-d110-41e7-b30f-a5a9e64a1a10,Healthcare,0.5390594284087709,20,16,249,817,568,14.388925527826409,9253
d0a4f5c6-df0c-489f-9847-d97d7a576d3f,Healthcare,0.4423591546872475,47,41,683,944,261,39.633119724752945,1625
e4756376-7be2-4dc5-9ffc-5e8c6e16458c,Healthcare,0.831708164860055,47,37,362,1221,859,65.03022142540031,8531
161c6232-5b05-4c16-a09d-5151e2ec3ad9,Educational,0.32220416300614907,34,4,169,320,151,86.94644766166505,3534
cb94a328-b762-4ba6-b38a-9e8a6b7fddd1,Healthcare,0.3777460317327066,13,6,178,601,423,76.32003189991514,1756
561a3d7b-1633-4d9b-9663-e3e52140c064,Commercial,0.15354556538497832,28,49,681,1341,660,52.792744670189315,8568
643fab8d-96b1-4baa-8f41-e6d62003fae7,Commercial,0.027351884948212057,48,26,13,800,787,21.16632628084748,4145
3284fe91-120f-4cc9-bf09-2c9a4610570a,Healthcare,0.8147617769769887,10,6,453,1326,873,54.37701220992606,4212
8ad89d4d-da2c-4530-bffd-52d6eeefb52b,Educational,0.6629922124743709,15,25,640,677,37,96.13808652750626,5846
6d1cd25d-b32b-4eaf-a5bc-dadd54f799ce,Educational,0.09355578737529247,42,40,53,708,655,93.88865868736362,1285
81104dae-7799-4301-91ab-4d0a192ac0e6,Residental,0.10536035687506451,35,2,137,1201,1064,40.34160903361114,5506
aada4ea7-e621-4b02-953a-4dd798fedc2e,Commercial,0.7860148315979806,15,49,81,1070,989,39.36851981313071,1394
23321b36-541a-4f5a-869e-7c6555cc6144,Residental,0.984173723421721,9,12,31,142,111,64.16800521797515,7035
8a3991e5-f6c8-46c4-bae5-599d3f8ca81e,Healthcare,0.8318294085725675,10,21,517,1251,734,55.16827448044486,6441
79880b12-5cb4-4c63-bb72-1508e168ea0e,Commercial,0.4239380623730098,41,42,379,1315,936,90.15568470724638,1701
424631d8-a729-4ffb-aa90-5f93eebe4d82,Educational,0.9781369579723149,22,42,221,862,641,15.932548254967898,6101
b8a9cff7-3180-4f6c-b3bf-a965db659165,Residental,0.3060988735354432,19,34,296,458,162,96.3931141555862,8905
b8af30f0-62c0-4606-8446-ff287b73ba9d,Healthcare,0.5477602807384824,46,43,213,267,54,67.07390211974842,4930
fc0d043d-0b69-47b5-8a1d-03ae9cf15957,Educational,0.634402983581535,25,47,551,1118,567,69.4945294124471,3868
afc6ca6e-633f-4431-bab7-c6e1826aae30,Residental,0.8343316247977848,23,30,479,1343,864,43.59550923830775,3528
bc104209-158e-476c-bd40-6c290780b6a2,Educational,0.7671054360072288,17,34,478,1372,894,48.323009752357294,1648
da2e50dc-a7fb-48ba-ac0f-1999d7f93e2d,Healthcare,0.4164695706602326,14,6,557,802,245,23.763129241617126,3773
5a0651fe-5dbc-4ecc-81bf-07c7f392d156,Residental,0.6884623237443549,39,4,515,1428,913,12.175884666228335,8205
caface27-9e29-4ade-9f7a-04302221ddba,Residental,0.24892683726653975,31,12,568,1225,657,37.438306969287055,1826
92bd7bdd-7037-47e6-b202-6584523c800c,Residental,0.8357608086112417,24,39,415,708,293,40.35330369468339,8187
65ba91e4-f65e-4e65-a771-f0e7c299936e,Educational,0.188775751445886,31,29,684,1334,650,99.69024481084772,6221
1babe867-13eb-4c93-93ae-077dc0120675,Residental,0.07193230331275458,41,45,315,1211,896,98.54268109623044,8622
c0152227-dfb7-4ee6-a7cf-8a50ca0324ee,Residental,0.5493036196066426,8,22,504,1056,552,82.34902254725593,5218
6a07b2f4-09eb-43e4-99e9-33dd747469b0,Commercial,0.8786468447704124,4,33,624,962,338,58.35834636230666,3114
7b7f7b58-1fac-4002-890f-41f28c8f64d3,Healthcare,0.06914731738117819,35,6,83,1005,922,78.98126554613764,8949
63639827-181c-4df9-817b-b7eac2c0f8dd,Commercial,0.5938943235744606,25,36,287,745,458,12.944515697345599,6900
908e0161-0fdd-4960-a121-3ca0e06fe151,Educational,0.8682968346664872,49,37,148,149,1,51.89391868880059,7621
a9a92524-90aa-492e-b386-83990c38f035,Residental,0.8264701748671947,40,10,413,1045,632,69.9900133711107,2120
4c56d9fa-bfa0-4337-b5e3-c16a1027e225,Educational,0.024669447466105554,50,10,139,383,244,99.65658865508199,4116
7bff62ec-5245-4d9f-9839-a9dbbec34a3c,Commercial,0.08583511087869233,13,16,421,998,577,70.67793085520847,9282
54824664-7ced-4df4-99d1-0ac79ba905f2,Educational,0.7877483066978301,37,23,26,1381,1355,50.95957257272129,6481
135c7d7c-3f75-453d-8cfd-a576392208c6,Healthcare,0.8319055181640964,49,12,590,956,366,47.54776474626355,1568
6fc6138b-470d-43ad-8762-169411d4ff00,Residental,0.9948897200387163,9,49,202,693,491,34.721752096895564,7697
f98459df-dd3e-4723-9d28-ff1a50986947,Educational,0.21988706440324046,7,42,532,1004,472,45.75968766720582,8102
00a3f506-3155-4217-a852-3eecc17762dd,Residental,0.47894993265304686,23,50,503,1390,887,23.206693081056002,4097
e7e97145-5d66-4b18-83a2-72787da6d16d,Residental,0.9865216758097676,49,44,24,783,759,35.85105897788506,6815
c8a1013d-4b12-4dd2-bfe9-945864f00272,Residental,0.05982210364667184,47,21,343,1402,1059,54.54065297199224,5715
94071d41-a641-417e-9e23-8024d969cf9c,Healthcare,0.07332782347931288,36,40,524,1275,751,79.85602503465987,7253
7da8673b-62e6-4ad2-8612-666dc35cfbb5,Healthcare,0.30673499578327634,20,37,341,1192,851,42.05306227235969,7291
c6c81586-8bfe-4a95-b51e-4c933fe2fca3,Healthcare,0.7133917164491872,15,47,47,795,748,34.27026785293092,6675
bad3558d-8416-496c-95ee-45435fa83be2,Residental,0.5290261302618904,38,11,86,688,602,59.58117204403745,4906
8a67db6a-e75d-4a96-a427-d2038d29c8cf,Healthcare,0.6875135162886897,34,16,85,888,803,89.65486106126458,2775
edb16403-2337-4024-8f2f-00d490902c1f,Healthcare,0.09173186296410141,36,35,298,1327,1029,24.62128606771258,8969
4e19cfbf-8767-432f-987c-ec40bcbb3cf6,Educational,0.06236539042982747,24,38,260,1139,879,36.460208662510354,6961
7661e80d-33a8-47eb-a3e2-133baaadcfec,Healthcare,0.581204639758622,14,32,335,725,390,89.25740476800368,4329
11098449-9698-4d49-8cbb-bb12a5c76c5c,Commercial,0.14248564783208728,27,31,466,1273,807,96.52435425044183,7870
4d25b544-d87c-407a-b9a0-7d92e74de027,Healthcare,0.7561408106282784,24,42,379,791,412,37.48565539486323,7536
950984b4-6725-4fee-9c40-b28110e0a9f3,Educational,0.03517014409345898,2,15,245,1376,1131,31.298454258897916,9685
b428833d-1d50-445d-b377-d95e257ba65b,Healthcare,0.2639909543257387,9,33,475,881,406,67.87141125174828,2621
59149a76-2bef-4b59-8757-1992c958fb08,Residental,0.8977111611532615,14,15,596,851,255,47.755566624780606,6773
48689525-4af0-4426-8fed-e330dd5219fc,Residental,0.2897244630445377,6,3,548,800,252,20.725093946852176,3096
193dbfc8-87fc-4679-8eb3-91f9c296d2c7,Healthcare,0.971118022295608,27,14,215,948,733,40.61361970153075,6629
2209b6a4-1a3b-4424-add2-7b7dd7a5a171,Commercial,0.6548812421388708,7,23,254,264,10,72.22038857132505,5709
0dfefeb1-6d79-4727-8b4f-e2968beff6a9,Educational,0.7650104350692076,46,33,500,619,119,38.23608514248247,8854
679d9f64-0b12-4c0e-a16d-4ad3c09743b5,Healthcare,0.7059828549296469,37,40,464,917,453,19.023632911355364,9548
ce56d4b1-ec00-407f-93a7-8f523a1cc6d9,Commercial,0.47806106974238327,50,8,194,1121,927,64.58839890121345,3624
46af62c6-c3b7-4c76-b16e-4b3fe708c16c,Educational,0.1292235503856466,8,41,234,744,510,98.42176085325279,9183
c3f6c394-46ed-4d3b-af43-f165566a2255,Residental,0.01964046181316914,34,50,57,1291,1234,73.31591709754889,8870
0a2de9db-b2f2-4c14-b5dc-06b0f839ad2a,Healthcare,0.4379477612707372,16,30,595,1350,755,27.75346921056154,4277
c0dbd506-d1a0-40bc-9db2-0036aa541e5f,Educational,0.1974296711768685,46,7,334,1134,800,77.97442047767663,6968
3e6f42bf-ae10-4204-b02b-c0b7dd74fedb,Educational,0.16553988262076225,28,13,449,828,379,72.31519404552282,2978
7ea2e688-2214-488b-bbd5-87e5429ed4f4,Commercial,0.17399550994551072,16,19,255,1023,768,65.21306603393842,3139
74447fd4-005b-4a4e-9853-3c7f5c6860b7,Healthcare,0.5879075404903046,1,2,621,1334,713,62.91215789512645,3068
5616ecf8-3af9-4fc1-b18e-a5107426dd3e,Residental,0.32907900003538804,45,12,229,1337,1108,45.7282803648813,2021
6f59502f-68f2-4366-99e4-934ab17027c7,Educational,0.6367102862378,27,1,474,595,121,11.083455992281024,2605
55f325aa-7ecb-4118-89d0-5d72779b2291,Healthcare,0.4592848919771588,33,43,711,1327,616,43.857262302340956,8229
584c3312-5776-4017-9f83-718ed9861443,Residental,0.2522677893934636,37,13,621,660,39,59.28290762861864,1518
5ae569d2-9c44-45d9-975b-559b77a0a854,Commercial,0.847800012150854,20,34,108,1036,928,54.3333900698685,4223
ee0f2742-9992-4e68-b38f-8add7afbff84,Educational,0.5882561773059352,30,43,531,1001,470,61.33262399295542,5824
79093aae-223c-4de3-99f3-e1a837e61668,Healthcare,0.1668439207336161,21,8,27,952,925,68.48935235282556,5253
72d9b6c6-2276-41e9-a6c8-eea701f90143,Commercial,0.7154587396259909,44,48,171,1271,1100,39.19886440479604,5755
c4af0cae-8262-4221-a154-b44b6db9f718,Educational,0.9300837866030728,5,21,385,1291,906,37.31585498973205,4902
6fd6e662-dab5-4383-9c6f-f1c90846289a,Residental,0.1449394133610048,28,13,128,1057,929,78.01070881987391,4121
46027f27-7c34-4e74-8ad1-522eb2e6fba4,Commercial,0.7097732686403071,18,38,375,1143,768,81.99675058013528,6904
fb2427de-3ac4-49d8-b021-934b1ba608ba,Healthcare,0.6997493153368561,4,42,622,1004,382,17.033948403839585,7520
02bee6c5-f27d-4961-b483-36355773868b,Commercial,0.5753943994355699,3,50,165,874,709,68.69293792451207,7235
7faa293e-6a23-4a89-966f-14535b620111,Residental,0.34505183648594406,37,35,305,1070,765,41.83821380930337,3135
1dcd4b5a-3124-4628-9748-cabd0a62a945,Healthcare,0.7636780249981269,31,15,194,962,768,37.03200874256689,8722
d7dd1a05-2a5c-406b-ace5-0dcefcb754cc,Educational,0.5690838880531806,39,2,423,978,555,15.766020696545052,1754
9324fa78-8cea-4665-a81d-fca2a7828c98,Healthcare,0.7045467904554484,11,40,194,253,59,30.182179756079773,1443
3156bdc4-2526-4e87-8f6f-a749841a1e8e,Healthcare,0.802074244130247,23,1,57,611,554,69.23100133141159,6288
f9bc8786-9ab7-4e01-86a9-32545c26f816,Residental,0.39650549798534585,24,22,382,1415,1033,43.59638193799814,7646
24828375-e806-4193-9557-a4de8365a6f0,Residental,0.5380579683007288,37,42,378,513,135,40.405131251387985,5001
5cdbff5a-d433-46c7-9c82-bd13b1411840,Residental,0.5266001483074452,48,23,135,618,483,80.9318374285248,7372
30738516-7923-4dad-80a5-08f7324de7a3,Healthcare,0.6067772175560743,11,11,194,836,642,23.563553097416982,7778
0881e1f8-cd33-4d35-ba2a-fee9d0923b5d,Healthcare,0.3354841802199079,17,25,307,559,252,58.2639462216783,6934
fc00136f-37ce-4bc4-b42e-0bafee235832,Educational,0.3188359388062503,9,17,605,1120,515,69.20162778890145,8467
b3a8f675-2ce0-4e7a-b8a6-1ddc62b0dffa,Educational,0.609427423926444,7,43,628,1178,550,81.93612125924939,7986
69cdb13f-008e-474e-b791-ca7f88f87314,Commercial,0.36479338211370316,15,32,656,1374,718,85.37403327574401,6143
66e26e15-60f4-462f-bed7-b3d20e5b8262,Commercial,0.7036807257058735,14,21,310,1180,870,36.128339930998926,1255
48e9ca87-6436-4c57-8620-34bb086be778,Healthcare,0.23638856128171082,32,47,538,1382,844,76.58171411695172,8164
235d1864-2022-44f9-b352-9317f6850b8f,Commercial,0.41700138054390945,9,5,100,266,166,30.259163226223755,3263
f28470dd-8253-4d52-a28a-1ea556f346e9,Residental,0.7835783777568355,15,9,337,1249,912,27.074553595715106,9930
64be3b44-5b72-415c-80cd-20e4cca463d7,Residental,0.799789660151017,33,34,406,1169,763,75.43773459284105,4165
c7229eaf-c2e1-4844-a767-db7f1ce876ff,Healthcare,0.06801360851057703,2,27,583,734,151,28.25885986035047,7262
af339aee-7829-45eb-a320-a0964d314268,Residental,0.43129040048288325,6,1,514,607,93,35.3453505305977,4256
cbe5dd01-922b-4791-947e-01f9481f5b0e,Educational,0.96715908029184,48,21,435,1176,741,19.87319430443572,6606
7dbf9535-4af4-40f9-ac1d-a1a0721cdfc7,Healthcare,0.3079255896737969,37,19,185,203,18,22.72333438068429,9504
f4e8abc1-c44d-4272-addd-1f98142aa2a2,Educational,0.9381593315856229,41,21,387,475,88,57.716186067404145,9210
f9b90099-23e5-4958-a0a5-733a6dc139c3,Commercial,0.37159628993257343,34,20,383,415,32,80.06656678424856,2970
5d5ceaf7-b60a-426c-ab20-53b7af4edbdc,Commercial,0.10910848490723457,31,32,203,466,263,98.78478376826129,5384
e3e96a85-3734-4d82-ab03-7c51b0b7ac04,Educational,0.784465205831165,8,22,412,808,396,92.50544514231899,2340
2543374d-89cc-4b2f-94b0-7843d9b87995,Healthcare,0.5441538625878662,16,30,439,559,120,40.18567424698761,8208
965020d9-4345-469f-9e3e-f439a285cfcd,Commercial,0.6338584830106342,23,19,12,144,132,44.05095767808942,1522
37987863-65a8-4ae9-807e-2918de5f79be,Residental,0.49471065643636336,11,46,50,142,92,73.34445534814206,8115
0d2a04f0-8bdc-42c6-928f-56d283e165a8,Educational,0.008428241726765928,2,30,620,1118,498,51.933550948412176,5673
feef0705-e9fd-46f7-ad12-6cfa78a562bc,Commercial,0.4207192988680424,3,18,192,203,11,55.79395593052208,2582
625b73ef-c679-4cd0-9b69-71158fb75cbf,Healthcare,0.7540878331997651,28,39,44,289,245,13.271347455369822,8326
8ca8f028-edc7-4550-9b34-d737c1306963,Healthcare,0.38082446186337937,44,30,669,998,329,21.935924129509196,6822
70ae2c48-bd11-4975-bc85-3f5c21c47e3d,Healthcare,0.6901065980447508,16,48,537,615,78,76.71176663044486,9683
ead8be1d-351f-4024-8784-f24ca63fdd17,Educational,0.27013620687736817,18,18,114,1167,1053,11.265442396717324,5615
bf42c5b4-bff8-4c0a-8483-0873816f0908,Residental,0.15321868170803676,37,35,508,1158,650,99.69429560990275,9716
e9158066-38b9-46fa-89df-f5824845854b,Healthcare,0.4399279814004222,27,12,89,249,160,50.539664131561736,3417
d1db4d32-4d07-4f79-8d34-eabaa89ca25a,Educational,0.06599112942926377,33,45,275,1291,1016,84.14357945001886,4966
a1a5c495-4fc3-4baf-8e43-b5b1ab946a36,Commercial,0.8409639714503905,44,38,705,1105,400,81.53106935937082,2860
0ab95fef-4832-47ca-bf18-1c232653a699,Healthcare,0.9410902903647619,14,10,554,1247,693,84.34584837003143,2839
e4e0aec1-a914-422b-9fa9-b42bcae6f7a8,Residental,0.6461298239020709,8,34,316,1426,1110,21.342408171848525,7787
2aa4386f-1f55-406d-9ba3-1bb9c5d37b1a,Educational,0.35262788282845303,9,35,609,1253,644,89.92013638291928,2896
508d6efe-6e96-4dc0-9ccf-0e17b8740464,Healthcare,0.1144509115326573,39,44,529,945,416,89.80981696065204,5135
41cc6bfe-e8d2-45ee-b860-d348f1a5da5c,Educational,0.3381994896401822,46,26,620,1437,817,75.66989929963414,1809
b4f1017a-6b3c-4f0a-8255-edbefa0c3d8c,Educational,0.63652336336135,26,47,683,1355,672,78.12258583849004,3527
d716615a-cf83-452b-8065-6d7a6b77e95b,Residental,0.6866844139404495,20,31,136,1297,1161,71.74325236348923,2311
7f0731d1-e0f2-46e6-a9b9-6b8ba61200fb,Healthcare,0.44572679004731863,13,45,608,1396,788,12.978476746827631,8404
995cb91f-eb72-4200-9093-31390481bb22,Educational,0.6484189778368868,7,44,239,329,90,51.12774361742914,3834
ce56ae9a-e6bb-4986-a85b-538629e1de0c,Healthcare,0.2295587152014973,32,32,537,976,439,75.02109544950562,5560
81fcfbd5-72fb-462c-97f6-5e3ce392f9aa,Educational,0.2782829597710349,10,26,561,1099,538,22.706948778951258,5177
b1641da9-b1f3-4b16-816b-271196856f5c,Healthcare,0.059115179488052116,42,44,437,1271,834,63.36675870256162,3828
a0367d36-fd77-4a63-9b2b-31dd5c47723c,Commercial,0.4639564854498751,22,39,19,190,171,40.540528254476534,7397
0845ea9b-ab73-4682-b20d-47dd8cf84e3d,Healthcare,0.2768389756898798,9,14,122,212,90,36.071324949509446,2520
8af4d8d9-dd95-46c6-a53f-8b2767be83b1,Commercial,0.011595598736079404,20,32,77,1339,1262,73.46628536091663,5693
43faf504-741d-46bd-9ec1-073dd03a985b,Educational,0.06188549714518354,12,8,242,1438,1196,73.88551891141084,6485
d684b832-a256-418d-b172-b6a5f262b938,Educational,0.6919535476965882,38,30,552,765,213,51.31355867749232,3929
63150577-acc4-40b7-9f4f-d4a779b6f2d7,Educational,0.16814741926807275,15,15,664,778,114,68.5396627380492,5482
32ec69c7-825b-4a95-8a16-ad4821c73363,Healthcare,0.3384019795448132,45,25,15,112,97,98.06558439379589,6317
e3da8cfb-c4a3-43b3-9278-ff84d23f5246,Healthcare,0.9279284195296501,27,13,102,108,6,58.94935483081973,9874
3608c5e6-7655-49ee-b65d-73687018d4e8,Educational,0.0765716102922307,36,40,36,1158,1122,61.93332413603158,4152
fe005e88-70a5-4e25-a4ff-3b83a51761c8,Healthcare,0.7271219006836287,26,13,635,1209,574,90.38621695971237,5700
fbe16ca5-f74b-4fbf-8fb7-787b1e2b6f87,Residental,0.5018368983364635,46,28,646,1149,503,15.187407186380332,1801
00300c47-4d39-47d0-b156-8ac4ec58aea5,Residental,0.3153503580454322,5,9,692,797,105,93.81872362765833,9985
ecf6e1e0-818a-4a9a-af10-c2f576a2f924,Residental,0.6378721188130634,24,26,517,731,214,27.25143201724834,5383
2678632f-59a8-411f-83e4-6a263bd04631,Healthcare,0.5336743386594409,5,20,334,723,389,32.016858979137695,8897
b7c5dfc9-330b-4b17-9e0d-1c372163fe13,Residental,0.3773857877361567,21,36,150,1284,1134,64.73782413934636,9592
71fa8a22-1d52-4373-ad8d-a62974ad9fc0,Healthcare,0.0754047445985907,19,11,653,987,334,81.69983761989138,1820
a3ce535b-4d71-4d4d-9176-e461e3e7c551,Commercial,0.2592890637625097,12,7,394,1314,920,20.11368675143205,3443
8f4049d9-f775-46f3-b16f-7e9867f07013,Healthcare,0.9309086294786365,27,26,138,161,23,56.57758013662068,8124
f4004b01-e1f8-46c2-8fcd-79689d39d19f,Educational,0.8893388226881755,39,42,356,407,51,54.40506833679078,1983
8d0bb3bd-6ea6-4e85-823a-de6f5a8ed22b,Residental,0.8781437576709374,8,9,539,1189,650,56.37625543843605,3898
ce1fa46e-ceb3-49e5-b9e3-861e16362755,Residental,0.8262759292518788,21,19,134,1120,986,75.60320129676775,1679
a6f46436-d7ae-4461-988d-9c39ef56c052,Residental,0.8545186155508203,3,3,573,1307,734,36.32530793149256,7378
93966328-b0d2-4f70-b734-c2189124a10b,Residental,0.7366924690810454,49,39,521,632,111,39.62033055197298,8309
043d141b-808e-45a5-898f-a2c28420d0b5,Commercial,0.12050772797136022,41,34,304,1253,949,50.93361052676789,4704
a4e88650-4704-441f-9f5e-d3a9bca1b4b3,Healthcare,0.6553925726883225,43,21,488,1249,761,98.9132791883252,9084
42ecf9af-f05c-4c36-8441-c0e11bdbb848,Residental,0.6460348876524505,2,16,361,1054,693,74.4407159912536,4333
e6126a9f-9ef6-46f1-86b0-c359be8cad90,Healthcare,0.95552761744162,5,29,364,562,198,31.54521967401057,4845
101bfd95-a486-445a-bd7d-e30045142d55,Commercial,0.044764836523350726,10,34,177,1186,1009,16.25956661688202,3148
068fa8cd-d02e-42e7-94e1-cf3364e57861,Residental,0.22313952189848207,41,38,616,795,179,41.55226137386937,5690
89caf1b3-050a-4700-85cc-aa166c8e46a7,Healthcare,0.04908176233361927,4,15,146,1036,890,17.093820341434117,7363
09ab7eeb-85dd-4858-8754-d995cf65bfd3,Healthcare,0.9815000185111039,13,36,145,1087,942,80.1955163702702,9237
f8472d3b-afcc-4e01-89ed-72a0f5b974ea,Commercial,0.8238720798766179,26,19,390,526,136,77.941346962209,7347
80827641-862e-4248-93e5-a184a831a96b,Healthcare,0.15719994895978484,33,20,581,1257,676,87.02160038584324,2504
60982405-2b1d-4fd4-bce0-b177b77b9d46,Educational,0.04522646940201058,9,23,124,781,657,99.65301949740325,9051
cc4b3297-564e-46ef-bfef-a94b235ab589,Commercial,0.2389579407648479,12,21,211,1055,844,52.512888485693786,8466
c50bcc3d-abb7-47fb-9527-b0ad1a65b7aa,Healthcare,0.012364176749706024,8,10,203,1096,893,65.71186672647833,1140
24deb024-9f17-4f8a-a4e8-a19207096171,Residental,0.31703483093535245,29,36,112,738,626,77.8297586695923,8695
5cc7dadb-91b6-40ab-86ab-811773a0e0e5,Residental,0.2156301501229405,6,42,509,1341,832,77.82020024575027,8501
85a7053a-9cdc-4944-a03d-c22c91da2fe5,Commercial,0.457455808565708,36,10,21,1354,1333,42.18284598092838,8722
fd35a222-ce12-40de-8a84-2fec7da84095,Healthcare,0.9399901066134976,11,7,456,1141,685,21.214266361206306,1379
78886fb3-7f65-4ff4-b8e5-e18dd9c26318,Commercial,0.6484717972582227,31,32,116,596,480,46.220598432031764,5578
b9ec3ded-34d8-4b64-a2e3-f2641be12ac9,Commercial,0.8253110821186027,44,10,31,229,198,94.19793804714531,2006
a6846eb4-c9e9-45ba-96e5-f317db3c299b,Educational,0.7624521699996881,26,48,162,439,277,22.878612475256915,2364
e2cede74-7bbd-4ce4-a4dc-4995f5616078,Commercial,0.6202588214253846,31,39,281,328,47,24.722255006852258,9519
cddb9b8f-31ab-4ef1-a702-b847a76545d5,Healthcare,0.7416180843802617,30,49,706,1382,676,59.00758474132112,4661
868d2316-fb0e-42a2-916a-da2f56b33f39,Healthcare,0.7511549283100463,25,15,171,663,492,39.533808409974625,5009
1ad2bf3d-f537-49f6-866b-ed4ea1ae72b4,Educational,0.4704840047872684,31,8,501,1254,753,13.401693616495898,9214
2053d4ee-ff1e-4216-b0d9-773b181cc80a,Educational,0.6099191687096054,49,8,42,1032,990,91.39059275607744,7520
126a5d80-deff-4f01-ab28-7ba3a25846b9,Commercial,0.4185240630804238,25,34,512,1121,609,30.575995952530995,5860
89b00dc5-cd22-41df-b516-2e825a46b065,Educational,0.7601019679371241,7,32,219,868,649,12.616574920378095,7862
78b5f88d-b77c-4544-8679-bfc8e467a842,Healthcare,0.022872278169207116,2,28,415,1440,1025,83.20019148200036,2751
878ba4af-763f-462e-8d7a-69ad8bcd5be1,Commercial,0.7560024706468177,28,17,648,1169,521,60.91957780124235,7063
a452ffa1-2e26-461c-bc44-9d9f29a82ae8,Healthcare,0.6064727227971898,33,5,535,1353,818,91.91380839815997,5422
e7c42282-e23d-4ff9-a627-f88d98c4aa3d,Residental,0.1908095435906123,47,33,210,1145,935,25.00281018181321,4232
2119db12-eb58-4b41-9a64-74a6b1fdda6e,Residental,0.11244189992628362,37,7,528,1248,720,81.46419911128312,9622
fe650ba6-a77a-49b3-b00f-6e6df33ac4cb,Commercial,0.3454807253664829,32,28,515,893,378,46.67093744609911,1534
fa50da30-7c88-4d59-87ba-2a7423fcdb33,Commercial,0.7076137268755925,17,21,140,525,385,41.02928236651228,2865
5342e6be-92d5-422c-b814-d7a6758c0eb8,Residental,0.41131176744104325,29,39,135,1356,1221,41.48616010206364,9467
5f3513e8-ac88-4506-b74a-b6831a59800c,Commercial,0.8758902661615654,21,42,79,735,656,14.620406859503609,6395
18650085-7c2b-44e4-bb73-88ce4a7a1125,Educational,0.8563820700354782,34,3,201,466,265,18.50062548020579,7641
7f4ae7fd-b372-47e1-b452-770a1546e9f0,Residental,0.17134005590721402,17,18,158,667,509,89.23384765725325,5310
5fddd4af-e59d-4007-8aff-3ddc58f20b68,Educational,0.9592759274808415,48,28,134,693,559,93.48576694421862,5551
17b4571a-f149-43bd-9e3c-87879b086b29,Healthcare,0.8030943285623512,30,44,394,508,114,10.47720968624985,6773
6bbe1c73-da0d-4e7d-b4c1-42ece6a03b19,Educational,0.5762836642454864,17,22,565,1399,834,10.697806253206737,6347
26f7eae0-4cbd-4f45-936c-7908bf628571,Residental,0.7028147579488502,33,42,297,1331,1034,88.97680707828253,7154
632e49cc-2421-4fbb-82f6-4f957472c713,Healthcare,0.44975941905154915,25,48,151,420,269,23.074872408644396,9328
95fd4b7a-324b-4df7-8b4d-9631e339e35b,Healthcare,0.5984275480600396,48,31,631,969,338,90.5583306489096,3791
e94eb325-8e80-43f7-998c-498b92865aa0,Healthcare,0.8094141313825172,31,40,359,794,435,68.52227333557136,2891
954f6eba-879b-42a6-b31b-b8f4b9133d53,Educational,0.6845402766846598,10,23,557,1055,498,57.729244778135424,5742
f64815bb-1fb6-4db9-826b-87c331c1e48f,Commercial,0.8640086512360864,39,20,408,558,150,32.63370754380503,5583
57b0652a-bd9e-4d7c-bddc-70503f82d33d,Healthcare,0.17498140144676666,30,37,293,763,470,92.79483995110162,5369
f723e6ef-2e8a-4387-a513-0faf845500b7,Healthcare,0.5300957521453991,21,18,622,714,92,25.71389259643231,3416
fcf6a8d0-6780-4875-b681-df6c67b534b4,Residental,0.9550330012760605,47,22,352,1016,664,95.58688658593145,6609
aac85b2d-2e8c-4221-a3b9-e554bf7a32b1,Educational,0.3154754521295524,17,13,54,1427,1373,61.88719621496414,4532
914e1f35-a4ae-44fd-abd0-9ecc7bc95315,Healthcare,0.45018707261091895,30,21,646,709,63,91.31962441459763,1530
c35287bb-93df-4ea8-b043-fb13a96e3f3b,Commercial,0.6992976296892742,3,26,113,973,860,36.72450526093283,8652
6464c010-c18d-4842-ab55-43d924dc224c,Educational,0.9906556587643082,48,39,130,1348,1218,82.03040932494791,6956
be5dadad-b340-4edf-aecd-b752046ce832,Educational,0.4192711480416115,16,11,136,1120,984,98.00200790413452,8429
0ce64c25-964c-404f-ba8b-2679a1901329,Healthcare,0.9844609100375815,49,14,550,1389,839,27.004143565783718,8974
b860f3a1-7468-4453-8486-e52f94e8ac0d,Healthcare,0.010392688795444305,41,48,574,733,159,24.406467800715127,8703
4f5db294-2212-445b-b301-285e8b3d901a,Commercial,0.4044135406205295,28,48,389,776,387,47.79777191573963,7114
b1eed02e-3a0a-4893-9787-841f81737acd,Commercial,0.9352928942400993,8,19,262,298,36,62.5028304835321,9197
dedd12a9-368b-4500-b79f-693e0658332c,Residental,0.0667801763649718,38,27,457,910,453,76.72811784681878,6282
59688a01-a98b-41c0-99de-479d414c5252,Residental,0.26986527609056143,36,49,47,578,531,96.97021643267068,1119
73135bbb-e417-416a-89c6-ca13836592d4,Commercial,0.7026804763852919,45,40,230,397,167,15.312281043886971,8612
bc89211a-50ea-4611-a66f-4a0444d96eee,Commercial,0.05697974359030411,19,22,154,1008,854,18.786531905142468,2992
d203f4bd-dc00-4129-9a16-b48f7a9cdd0a,Residental,0.2528478394059205,41,22,695,998,303,34.918650110787624,9513
c2f2dad3-1a6b-47eb-8b34-04e33d8e0554,Healthcare,0.3290558276853712,19,13,227,1428,1201,68.00887311383747,5089
bdc2956c-a934-4d0c-8676-924178b43463,Healthcare,0.2681523928074585,41,14,507,702,195,89.41828780241295,5499
35fa57f2-289b-4b0a-89c7-1fc9bd886559,Commercial,0.49781213709078287,4,17,630,1268,638,38.089437761248135,8730
2e577401-d80d-4cca-8a9c-37997c40bddf,Residental,0.6141453170162774,18,32,606,1163,557,18.48684833257077,4369
7b2f2e00-64a9-462f-bf2b-245183b41d8c,Educational,0.09947445713545777,9,7,465,1192,727,87.91513243258369,4085
d8cb4044-618d-4570-9deb-98029371d375,Residental,0.527177671534104,31,35,261,844,583,92.5028764488676,7211
0aadb2a7-87e6-480f-9391-454bf8438521,Commercial,0.047674408024666715,3,10,197,839,642,69.37060965634764,6383
83b5560b-8b0c-4be8-95d4-18d35ad5bbe7,Residental,0.10359411150702624,29,2,109,814,705,27.312369535890433,8786
d838b13d-e13e-4115-a5cf-44478e3d4cfe,Educational,0.5024557703695837,14,40,294,850,556,11.22637237441663,9238
d51e3f96-ad73-4679-a8c9-8b36841bb056,Educational,0.7928848712969893,36,48,379,1243,864,29.967218584308895,6279
abbb0689-3643-4ee4-a82a-c89fb1bd67a8,Educational,0.9175891431317016,40,30,650,846,196,35.73507199119109,4809
a6687b1b-3453-4e4f-ab05-61e31c2eed7e,Commercial,0.014896087507765943,7,26,678,842,164,57.122663435643965,8144
b0b4e7a1-4bc3-4dc0-8cbe-053329fb0d24,Residental,0.9395282780526474,8,38,406,1211,805,43.922928389845936,2219
d90a36b8-ebbe-4239-b3b6-8faa0f6380c5,Educational,0.42876514438622937,23,1,361,525,164,46.92587550716644,1389
c0d1e92c-3234-4735-8cb7-6d735df400a5,Residental,0.5483126409977905,41,21,297,893,596,60.30078826267764,7006
d782d706-fdf1-4b3f-8345-b33c281aaf0a,Educational,0.21824868592565316,39,38,284,1087,803,97.54895716724778,4515
c97d2d26-83d3-49db-8ef2-16c5a506d3f4,Residental,0.9971122127726118,50,15,641,1085,444,88.00678905114027,8156
a2f4ba2b-24a5-4754-ba2b-101c76da15a4,Educational,0.31146721932311994,3,43,207,1282,1075,54.89078606022691,9644
eb5a750e-a80d-4def-a19d-f6a89ec04cfb,Commercial,0.3848184854821787,36,15,492,1105,613,98.02962439280012,7787
a165be78-0fb8-4aee-b7e7-87b916bccd2b,Residental,0.04071255806034679,2,48,609,678,69,27.19416059097818,3201
a76c01da-ecb0-4762-965f-94c34993ad08,Commercial,0.5045122046800253,13,33,56,1327,1271,35.27101643921239,9200
df8d1295-fa04-4753-94f8-74d49572d225,Residental,0.27115483655870576,1,44,403,639,236,87.19664198497627,5203
116fc303-841b-4c26-8f40-8d74d891647d,Healthcare,0.3261746188640833,25,44,659,989,330,73.53765523311588,5204
4aac0402-ee9e-4214-8a9b-c34af3d80e71,Healthcare,0.39113227995390387,28,13,463,648,185,51.54796445700416,2731
d33207a5-4b63-448b-ba2a-de5526b18e52,Educational,0.9832042050306294,35,22,642,663,21,59.795297770325924,8192
307b3279-7c64-4537-86c4-5d9ee3c77bd1,Healthcare,0.06957528494253562,44,27,711,1413,702,35.68607919449228,6110
2562c00a-0bf2-4bce-8c0c-9b05726247d5,Residental,0.772140342159084,31,22,198,1154,956,76.61497371006251,2809
865980a3-91c1-4382-9b35-d4c696678a4e,Residental,0.00782917615837253,33,43,247,863,616,81.74037375374886,7199
d5f11d4d-4b14-4823-b5e1-bb02b5b62df3,Commercial,0.10682178371205397,38,5,405,528,123,29.97951359877511,2463
0bfe0775-0537-41f6-b9c0-22c4a28e0c51,Commercial,0.48189545932945643,36,1,667,1007,340,45.39260655273129,4546
af82e4e9-f35b-46b5-9901-20aec27c353d,Residental,0.9139759270946849,42,5,400,958,558,18.61178902161592,9934
dd6d2488-4cb1-49dc-9b77-e720d25dc3de,Educational,0.5620639675900418,41,34,441,552,111,50.850315248378195,7930
a5d933da-bb86-418b-ae05-ca2b25032206,Commercial,0.2823593443434478,14,25,221,1388,1167,87.16192395888018,9268
a0ae5e5b-c3c8-44bf-834a-304e86c55bc6,Healthcare,0.09371656912727833,45,23,502,1224,722,10.308488052288812,9347
4d2324da-c6f2-43e2-b2d5-226bc823de9c,Residental,0.710835603611717,2,22,636,755,119,10.634071318218208,9999
2e62f0db-548f-4f83-a965-8c28b0ca53d7,Commercial,0.5542293852614103,27,3,36,344,308,68.30022614077677,8814
28078b4a-4093-4a23-9d22-ff5d52410e67,Residental,0.43434843443029414,1,11,490,856,366,30.711711804718128,2221
2860c82f-823a-4b4a-af4f-c8d61bd6ff73,Commercial,0.7858321751002015,39,36,511,968,457,83.0970722886055,5571
91c4a12e-a1f6-4284-8a41-93e5b90cb475,Commercial,0.6385936822430687,35,9,2,889,887,26.083510837318563,9959
98b9d0a4-5cdc-42b8-8ca0-d966f8b787f3,Educational,0.7800101993858356,43,27,530,581,51,55.2210442604569,6451
f18744b4-8235-453d-8295-91ee9633e38f,Healthcare,0.04926081109856861,49,50,149,1344,1195,88.90606481987682,5908
8443dbf0-fa80-43c5-86c2-573d5f874b0c,Residental,0.562293846436218,21,31,590,927,337,58.84386915364559,7066
894c7634-6048-4f37-aa8d-5493ea2c9edd,Residental,0.2997788651649679,45,9,43,955,912,57.517155385380015,5975
dd5d176f-4204-4075-af99-c7ccfaebc385,Residental,0.015539989224667483,20,20,629,1101,472,11.607886245543389,8578
07c0e372-ab5c-40b3-80b1-f150fd8ae343,Healthcare,0.11697859869372684,45,10,371,461,90,34.49577823865198,3839
75a39713-e915-47c8-a54e-a988176ac4fa,Commercial,0.5230256030134635,38,36,53,516,463,23.285555932963447,1937
614788e9-08b8-495d-93e8-0ff7c4e717a7,Educational,0.5017068143413839,33,40,263,746,483,71.7345733689296,3799
f74f6eda-f5e8-4661-9142-f109e798d053,Educational,0.5209943929349028,42,13,602,1253,651,15.672056518641055,5190
444031ce-2260-4bbb-9ba6-13904dc20e0a,Residental,0.23705648587787065,17,46,297,786,489,10.687242716158735,6463
c08f7721-f4be-426a-b8f7-687e41b668df,Commercial,0.07773038644218977,22,33,390,956,566,41.49614912921798,1944
a58900ac-7092-428f-9a18-6926a3ff0506,Residental,0.6533367320096939,29,25,516,1106,590,70.90694110939005,2305
21b31dde-7e39-4823-b0e2-c84198194a3a,Commercial,0.99979601305774,24,50,626,745,119,77.08093764063769,1108
3a55a28f-23be-4cf5-a608-c9e93659387d,Residental,0.49079017362550814,5,18,287,373,86,89.9147493426701,1217
82d154ef-4e13-4e43-962d-5dfd95889b71,Healthcare,0.0330510186269255,38,3,539,803,264,49.88658107338595,3108
0aa17f69-ccdd-459c-a5a8-33562a33d6e9,Educational,0.35246564494872745,17,44,253,1241,988,90.5179573858256,4736
ad3c9326-48e1-4796-b48f-9c72a4423825,Commercial,0.23379473919238558,41,16,619,1098,479,46.84730505602843,2090
3d8d3740-f081-4c7b-964c-275b49dc9481,Commercial,0.6102407467738907,6,21,305,999,694,54.04183441280337,2873
91d8f00e-d884-49b4-9725-a3116dca11d4,Commercial,0.6948900001064693,45,25,128,579,451,98.5289764506386,6918
8eb9e1c3-4024-4d32-9772-f92ad5737eb4,Residental,0.8883996310675518,50,4,318,980,662,48.57606459051265,8443
5f1973a2-9291-4b84-b765-a4be0f138cc1,Residental,0.7530057286550175,21,36,404,1414,1010,58.222889780502385,6370
078d1e6d-20eb-4180-9b14-e3c53b54014b,Residental,0.2903643548417729,10,13,562,1294,732,54.393698733307495,6163
112b3a83-1865-4da0-81b9-90a130bd7204,Healthcare,0.053940434278696436,36,36,512,1326,814,77.13356382190076,6154
ae3c56ec-60ee-4657-a877-8dc8317d6c97,Educational,0.056062852724434786,33,47,76,379,303,62.933871779811085,9701
d32ed7b3-6e16-446a-b555-cfa5e9636f10,Residental,0.5650978029502556,17,20,602,1066,464,78.4490048794883,5612
19e8dcb7-c1ef-492e-b650-b3fc45ad10f8,Healthcare,0.440037380909566,11,34,424,670,246,99.77935905190782,2554
32e4f15a-040f-45c0-9674-90b5a522a273,Residental,0.5924556991051996,43,43,283,865,582,76.21483274062726,4907
cf45b226-7aad-4d5a-b368-44112a85b433,Residental,0.4719707872540536,42,38,585,1146,561,12.064893129170454,7971
a3f63798-b23b-4304-a229-31f768c63b01,Educational,0.006980505727346431,5,20,445,1224,779,73.87595335671367,7402
48f5ae1f-82e0-4836-8c71-8d9497b9a1a9,Educational,0.20521415335968518,34,29,302,1414,1112,18.903629293095175,9563
5d15a567-d86b-4feb-ab16-5389945a73cd,Healthcare,0.21029119281457564,44,30,416,509,93,11.380991808528654,5486
9d32fec1-02e9-43b4-8921-a66ee073b842,Educational,0.9759951299796524,31,25,182,1021,839,64.42447644482755,1201
d2fda6d7-e2a7-40ce-b14b-6ce61545af70,Educational,0.7709379053916889,5,6,675,872,197,29.313894725624433,3778
e2ae02d5-dde6-40d1-add3-7b0d6cb9a445,Educational,0.443019923068218,6,5,719,906,187,39.99223634938437,4537
a5442942-dc4b-4f02-ba8f-01c59f27291e,Educational,0.8593956365969697,2,48,231,426,195,32.61464497608251,4905
9ccc22b1-1037-4ee4-a342-7d7304000120,Educational,0.07023549866478984,11,10,175,263,88,65.82221688114888,3210
410db68d-9924-47e6-9bdb-66ad9421c7bf,Healthcare,0.7287199186839061,39,34,55,1321,1266,49.2865959116009,6067
5374508f-986b-44fc-aa26-718b1a58c668,Commercial,0.26164305289224676,11,33,556,976,420,76.7517588197943,9282
3521604e-dd2c-4236-8f6b-dedb11b012d5,Healthcare,0.84322861380139,4,23,459,1154,695,31.613201535193,8924
c4c3e19c-bc71-4c07-96fe-c7e2f57b92ea,Healthcare,0.821073273225238,12,15,388,1366,978,73.05120554517978,1984
9a8d2468-143b-4867-858d-ce363e48502d,Residental,0.22837714258705955,20,29,561,1178,617,43.35533333498666,9016
17ba63e0-8a70-4cd3-a728-1d3737745e90,Healthcare,0.8815481873890002,39,24,490,1000,510,92.86842122489394,8789
f5fd9d44-f8c4-4f81-9272-9dcb476d7b04,Commercial,0.8230905207406859,2,7,265,1006,741,57.96122180149435,8878
eda887ff-3296-443d-970e-f84be5ebd16e,Commercial,0.9194686591550901,5,35,448,1328,880,40.224983722377786,2181
ca227fca-fab1-44e3-8961-920e67c542ca,Commercial,0.0033649127522499267,20,45,186,472,286,19.241591852887296,5622
560cc11a-dc0a-4c5b-8a36-b83de9c093b5,Residental,0.6695987741710894,49,8,235,1340,1105,61.832360824673806,3345
90fe0950-e9e5-42c8-b684-cf0054b55645,Commercial,0.8824888129740185,9,44,656,1193,537,97.67573074243654,5140
e70a1896-b3ad-41d4-8251-fd930ba2cee7,Residental,0.5247121335835097,37,15,641,859,218,36.40268564964192,5060
375d3775-2258-428e-a88c-d19aca5c0c12,Educational,0.3738720523136203,5,11,235,612,377,52.21517220187472,7931
a59fd72e-c9f4-4712-952d-012f4a609376,Commercial,0.7664703776673477,19,5,307,982,675,56.12636838830947,5123
ba7424ef-423a-42b4-aabb-7b84bb5230de,Healthcare,0.9185829661802134,29,6,276,747,471,19.805931645642517,9298
a3250c13-460c-4994-8a4d-9fb55f97904e,Commercial,0.40242438673957404,15,3,607,1093,486,63.05828349615445,7360
7ce5b912-7a0a-4cf4-b584-dddac4394cee,Commercial,0.9927585781997407,9,22,163,595,432,67.22103761965131,7386
0fad45e9-8c35-41aa-8364-96b1eac0ab98,Healthcare,0.3013531316773077,16,1,94,749,655,73.51081757486344,5623
6637dd7c-d5d3-403c-8a27-41fd59b09a0f,Commercial,0.31608603334498564,35,9,172,1019,847,70.67152380923591,1718
566c2405-1918-436d-bffb-ec1fa2e857c6,Residental,0.6196977358965349,15,14,73,239,166,19.058575519133537,6963
ec30f998-ddbf-4805-8f82-2f8697ca8d68,Residental,0.34782119189445615,49,26,437,1413,976,21.311272588346213,3802
e95a2b9e-b2b3-487b-ac76-d9189837f9ee,Residental,0.321685629316136,45,1,373,1177,804,16.729016331494094,5504
cedb5630-b1b8-4348-b2af-e97c036e9811,Commercial,0.5081523461066799,45,34,230,857,627,75.97364647579379,8043
6b64dd3e-7c3f-4766-adb6-9a847fe004f2,Healthcare,0.0034535538268490873,8,39,455,916,461,66.91755305968653,7781
01036bfe-b8f0-4314-b1e5-94b3ee53dd9a,Commercial,0.10237245733224232,49,4,287,374,87,43.7336681215537,9551
92012d1b-acd4-49c7-80a6-107ec5d9c8c1,Residental,0.1627298898360886,1,30,76,635,559,68.52085298870398,6555
57846bf6-5c89-4ac4-a913-04f4e6279a96,Residental,0.9839912678300619,1,25,202,1002,800,68.24492422214816,2882
7705046a-4101-4903-ba28-0e294c7a4b10,Educational,0.7016725423250191,50,18,578,651,73,86.53654038757081,5959
44ad183f-575c-47b7-a137-a2be526ad077,Residental,0.21844886940431163,9,17,584,1244,660,91.17135914629904,6870
d8f61712-4541-4771-9adf-77246a40f064,Commercial,0.9536846215755843,27,16,247,1084,837,50.61609158641308,6881
dd9d03e5-bc36-4039-9ab8-54c65bb6223d,Educational,0.37428095016879215,10,36,576,1155,579,54.353361107017676,9535
e8af50a1-10fb-4ba4-977d-ceeda5f466ca,Healthcare,0.3026268428088482,36,34,403,958,555,13.753537458022304,4275
dc85e3ff-87a3-4cca-aef9-e80a2869163b,Educational,0.9831423883126132,40,20,162,993,831,29.955786074113465,9422
65fa2120-8d41-4fc3-ae89-eb10a8fc77ab,Healthcare,0.3364209801407404,25,44,357,537,180,99.30435743719944,5714
94d6e895-8ee5-4ca9-bc75-aa7b99ec1ed9,Commercial,0.038139393135082744,17,3,117,1377,1260,39.67598665719747,9372
4ac5c21a-962f-4d0d-96d7-fa3b5f603582,Residental,0.12491005162100832,33,11,14,457,443,57.42106784668818,2482
fa2b25fe-1d94-4dc4-8ccc-9834b8b23d88,Educational,0.4860123805325053,37,47,56,446,390,12.609070995103082,8311
cc07a773-9170-4860-a570-ff052b3d2875,Residental,0.11467789975421316,3,26,643,1053,410,56.837267499215805,7873
a8acd569-26e1-486c-bf0d-a200020ec827,Healthcare,0.5794597178219297,1,44,524,527,3,89.84577857557308,2386
9a7a82b8-95d6-4fb7-92cf-f74043e01430,Commercial,0.7581904123487141,32,2,294,1185,891,38.401156856105544,9280
7a3be200-dbe0-439e-a369-8e88c9f33ea5,Residental,0.19092990843550117,23,5,467,506,39,54.473297792063875,6305
13fab522-9f51-4b26-8d94-d245ecc7406e,Residental,0.008039386758903033,47,25,169,256,87,86.1248752175024,8107
effbabb0-bba7-47fb-a961-efec5141d3ed,Educational,0.3569740609601455,24,33,393,1046,653,93.87916042711102,5657
36657094-8d50-4ffb-ab78-b2e9a3cfde11,Educational,0.7006835531336957,26,14,443,695,252,56.73907142137725,2254
81dd02ee-06cf-4169-b4ff-e00fa085a13b,Educational,0.7237664419421277,4,31,417,701,284,58.471815098862564,7240
81701ab5-e723-490f-b351-a4b7c28b0e8d,Residental,0.5402262989846246,35,19,34,1299,1265,60.86755306334537,2228
d31564a1-ddd8-4abc-a179-a6d907720527,Residental,0.4106525787706511,44,6,696,1376,680,59.767820232530994,7921
307519cb-3a69-4704-8464-4e872848de66,Educational,0.8511434889892457,21,20,584,723,139,32.83869939418997,8853
af7dd14c-87df-4898-bbda-88835678b4ec,Commercial,0.2391687007933282,11,31,210,383,173,41.9004689122597,4341
083eb3bc-a14f-47ff-8c05-a3e3b31132ca,Healthcare,0.13085321793771976,23,26,418,713,295,89.39979701237654,9035
2a80a573-d094-406a-8c97-1d18f7007a03,Commercial,0.7334635967863985,19,28,559,1177,618,77.99515945428423,6929
4e87e585-da98-44e1-bf4b-f97a7d24b4f3,Educational,0.542998911175501,12,46,164,1439,1275,20.30824553554853,4756
9effc5e1-2168-44bb-9541-31f4b473d36b,Commercial,0.7115165324958947,7,1,500,1132,632,10.785319369721885,3027
6f01964d-2c2c-4d9b-b011-2cbee1b3d272,Residental,0.7133519756841805,27,20,553,660,107,43.6307559987469,3941
af26f62e-9700-451b-808e-f15dc281bb05,Residental,0.9920094033634645,41,21,354,1417,1063,32.40671774575899,3912
7ad15d59-c28d-4c7c-9f7f-41595a35ee52,Educational,0.8380499831400822,38,42,610,661,51,79.6157074444357,3901
5b2b8731-f50c-457e-96e2-98e7c9d1e45e,Healthcare,0.03523756733562178,46,25,689,1168,479,68.1314084715723,6316
079ab088-478e-4489-aaf1-9e439bf2369e,Residental,0.44960567993056233,14,48,130,931,801,83.3466987524633,4585
fbf6f340-df37-4843-818a-6886fb482631,Educational,0.39910118133752437,19,9,154,1147,993,23.09437395409477,3134
d711e321-b9b1-42e2-893a-f57404f576cc,Educational,0.6468651585958325,49,18,702,715,13,46.32840626294723,1384
85986994-074f-4a99-a1af-5b73d305686a,Educational,0.8827993639122113,18,47,325,815,490,67.78886910986546,8684
3c5431c3-0a92-468b-81f3-3075ba2c9e48,Educational,0.648254899379982,39,42,369,939,570,72.55020874628705,4805
9596effb-ba81-440a-abf2-1539833d6dd4,Commercial,0.009775270231166977,31,49,305,1021,716,39.45154203941042,4369
f75d4595-f281-482f-9869-30fa0680c789,Healthcare,0.9733642135924655,35,34,543,1337,794,86.52746608033974,6044
66ad811c-fdb1-4cd4-ab13-3d58378dc9ac,Commercial,0.2415152168721415,45,12,538,637,99,89.32505149542486,2334
7aaad90d-1f02-4f8d-a325-a055c468b344,Educational,0.31609090293216446,4,32,384,1131,747,89.55629915792066,9109
cddee79a-7730-4369-9cef-65043f25a0cd,Residental,0.418361956370505,50,12,624,1205,581,36.38097636687351,7778
ba4fc5c3-d030-4db9-b816-6a8a0df24afd,Educational,0.6876390716640889,3,48,601,1025,424,65.77570997773373,9239
9a19a40c-b82d-428b-b9c8-4dc42fe5402c,Educational,0.8805307547270627,5,36,184,1376,1192,95.56676451172578,9082
d7c2ec7f-5136-45a2-a114-ecb26bf1c303,Commercial,0.1822087574229495,44,18,591,1044,453,10.034592424508332,9038
3f8e0594-7c48-4590-abc8-f3573fc681c1,Educational,0.06706504640722932,42,21,320,1078,758,76.60823212909746,4932
e36c2c25-e1b9-4f2a-affd-aab1a4bd5856,Educational,0.41394981680525034,7,7,233,1210,977,25.036259616291076,3389
451cd921-c96d-4e99-88e4-b1784cfcee10,Residental,0.6646013479752251,35,22,360,1142,782,96.83047602539185,9272
7ead7d2d-cdc6-44c0-8a1e-031648d8d4b7,Healthcare,0.33775419584510114,15,38,76,875,799,63.31981766602432,4661
d908edde-d19e-49c1-93e4-0475e8fceae0,Healthcare,0.17051595468411562,38,34,149,1078,929,32.23307368163585,5151
132830a7-e962-47bc-a47c-dd1488f8129e,Healthcare,0.1960883487965127,40,4,290,1430,1140,84.46022462275818,7247
e3bae71a-7dfa-42b6-a251-3de32990a4b1,Educational,0.772987566930029,10,13,393,537,144,95.77734872782963,6808
f11098c1-0d29-4834-a41a-414a44b6ee35,Educational,0.3106696960082209,19,2,137,539,402,22.92533642438663,3645
734c4d6d-98b9-459f-87a8-86d7876e7fb2,Commercial,0.8251387423528171,7,12,630,988,358,82.43094650133838,4914
22b5a35d-b059-4e08-a021-8920342af4f5,Healthcare,0.06847974214986852,16,21,192,554,362,71.58883472960568,9456
e7c8ff84-f331-4db2-927f-89cca292d894,Residental,0.30770559912828555,4,18,433,871,438,14.082198316801934,4942
0adfb66c-606d-498f-9c39-1b27f73d52b1,Educational,0.5937849513178256,32,29,403,1082,679,27.830579350298148,3233
ff012ce9-b08e-4da8-9c5b-14ebc0a7de38,Healthcare,0.31625398909342084,33,18,232,440,208,45.90936815712239,7980
532692f8-8aa5-4aa3-bc5e-7afffa21b551,Healthcare,0.7645899865641705,8,7,134,860,726,27.19693315742309,6943
6d1917cd-f5d9-4672-8210-bf2bb25c51c2,Educational,0.9246397893707486,49,44,586,635,49,44.03985722857697,3908
1f6b1311-f19b-4a1a-aa27-f5c3386e2735,Educational,0.8087595434005337,35,44,681,681,0,33.75575395671285,8550
353ffbf9-6c67-4d90-9295-f2ba99fa6ac9,Commercial,0.3585219239758335,9,18,502,581,79,17.558552906359708,6830
e6c43e8b-7638-499e-b29f-cf9f1b778bb6,Educational,0.8274850371404803,37,30,446,850,404,24.885911271717987,4213
78631177-1a15-4818-a9fe-0545017153a6,Commercial,0.47918675348365103,48,8,651,870,219,49.895887454800544,7749
9dc94de3-f86b-430e-9272-fa7f6d92aef1,Healthcare,0.3635301231451211,22,6,202,1006,804,64.54934124685383,2807
a8b436b2-6643-4122-a60c-8aa6d88e74cc,Educational,0.32885011345670356,4,3,398,971,573,55.74606376613664,5229
1ee6024e-6a4b-4582-a22d-049080adc2e7,Commercial,0.37688956741956714,17,29,105,302,197,88.58081738891303,4706
90487248-30a9-479a-8f83-07cc5ca39d5e,Residental,0.5325646483151764,33,8,472,876,404,60.614191847359606,1271
962dfe70-e07d-4be2-aa15-f226b9d5cb19,Commercial,0.10556385025371162,20,8,193,475,282,57.483586516412124,2144
ad508cf9-54e6-40ef-adf5-9a30099fc962,Healthcare,0.36075880141956196,8,49,581,1095,514,58.05115310765261,3036
9c641944-00b7-48cc-8f8a-a3000ce6ee8f,Healthcare,0.6622119156185341,11,25,127,533,406,30.433169217835953,9677
8f991984-3301-41da-b957-e8b9a4b4865e,Residental,0.17688465042051726,20,22,630,1264,634,75.57743729737751,4445
914dc09b-13b7-401c-bbf5-3b0f10dea96f,Commercial,0.7754902333670752,20,46,12,980,968,27.973292992021193,7216
dd2930f2-f73a-4607-aa7e-5f9f26e28f5b,Commercial,0.3257234921831119,34,45,435,725,290,35.120518507255994,7916
e335a2a9-2f18-4f5d-953d-f508ec4bee1b,Residental,0.05438176499627767,45,9,608,958,350,75.2386830084507,2682
5482f904-f191-4cb6-b1d9-f59cffa4d40e,Commercial,0.6798881525806754,26,10,447,836,389,82.94106852196886,1134
eda52859-11e7-4a64-827a-002a4a2f3199,Educational,0.1603854785920591,50,49,708,1235,527,80.73063080127656,6993
2e607f8e-dca5-411a-b68c-2b0c6e86da82,Commercial,0.6854146440586447,39,12,495,1296,801,27.266416237398523,7697
3c80c763-bf8c-4a76-90eb-56d669f11b40,Commercial,0.7085383081054047,16,1,147,748,601,18.57104167339593,3312
4f140628-ff58-4823-bd39-49f50792e8f7,Commercial,0.16221505114245338,10,24,470,681,211,28.27240442164702,5852
a03d52bf-2e7f-4e99-9ce4-1174d021fe3e,Healthcare,0.21064943735551633,38,36,462,676,214,49.70335126541208,4131
73335003-b2c3-4adf-a94b-912855779cd4,Commercial,0.32263213860703077,5,19,149,804,655,44.86434644257076,3509
708c62c8-18b1-466b-8eea-f7f7beb8f873,Residental,0.05607305808331631,22,13,313,864,551,60.36716823583627,4783
efd7e54d-1c9d-4fda-a25a-b6f71783f257,Residental,0.351427286511628,1,11,483,1322,839,32.89387845243128,9341
37c4f4df-0f77-45d4-b843-140ce5340e0b,Commercial,0.15147569429654428,42,42,199,427,228,24.064691531820316,5691
cde325c4-ac00-4287-9593-61424f49d157,Healthcare,0.9182699373625962,16,15,422,695,273,41.947293094449705,1078
53f04c4f-bfd8-4469-9ae4-c532f1282fed,Residental,0.7132410529276417,48,26,129,735,606,57.12039049213679,7044
96c7e753-a900-4e5a-9f87-6fd74f21eaba,Residental,0.7228870899846762,20,9,714,1437,723,64.37408207502972,2907
0228d7ec-c85d-4b84-87ee-d27875a14673,Educational,0.9038355523010846,49,43,60,1210,1150,23.759989171821076,6053
e3ac48bb-8d99-4581-989c-87a2f2c9b77c,Educational,0.4641894748155444,46,10,335,945,610,55.56887747544144,7326
8f2c2bc0-2695-4e42-b8c5-241ebf7797bc,Residental,0.5217920790719236,35,38,56,523,467,46.22449850671043,3673
60113aee-7aaa-4247-814e-9cc4de626f54,Healthcare,0.38817682725061997,18,39,2,928,926,86.4754151910565,8910
265656f1-80e1-4145-adcc-81fb11879774,Educational,0.7703826312735493,43,36,240,1143,903,52.608693964788664,4278
b939bd84-e312-45a0-9fbe-a75e61b316f9,Healthcare,0.7036900245605531,10,27,7,43,36,87.70944874845783,2595
aaf666b9-ea0c-4408-ba81-9de42e15a5ab,Commercial,0.9074806942619584,42,28,76,127,51,88.39368042567851,1256
91b0a207-a476-4eb5-9282-a06a6f2f04d7,Educational,0.17539380753122635,4,27,682,877,195,86.65356259522794,1923
e75baf1b-0ee4-40a2-8f4c-ab35ced777f8,Residental,0.1700861266451179,26,26,517,1177,660,23.807287322138396,7254
a2a6f7f9-9928-4fc9-b98c-b0bab133de16,Residental,0.5464736322999824,28,18,308,1420,1112,27.450846550768606,8502
2b88cc00-3020-4829-b6fb-e502043ae98a,Healthcare,0.8463899987474448,11,36,235,1362,1127,87.8952178246423,2245
c64bebad-d478-4884-b50a-941b787d4ba5,Educational,0.9473215630764175,36,14,687,1343,656,33.703064973517726,7196
0d77e585-7f4f-4b80-af46-cd4b44e736ef,Commercial,0.7413134885004754,29,15,121,710,589,69.75622785387398,8069
c5569d07-43de-4dd1-b9cb-d07a10b8903f,Residental,0.6636242039869026,45,23,410,700,290,81.32220258287578,9559
eb521de7-d99d-445f-a4a5-0f21e5139e22,Residental,0.03583067803792517,38,10,239,1155,916,60.25552104703613,9340
0a626682-5cf5-45a9-ae56-0ac9ecac17ea,Residental,0.9956915604724486,20,15,86,351,265,64.10208900751303,4094
4772a1f9-9b0a-4cc4-9377-8f4edff912cc,Healthcare,0.9143266771335544,47,29,8,10,2,66.42915946172272,3368
39d30a5b-b78f-435e-8e19-b58f71e4ff3b,Commercial,0.5481612455877923,8,40,680,681,1,93.33614774128428,5208
b57674ef-d26c-4ecc-aa6d-e425edf27ab7,Commercial,0.5554877846465098,45,5,542,1382,840,66.7319917235739,8506
f19f5a87-a4e4-4bd7-9d5d-9a4a6a89b2bd,Healthcare,0.03445459067923895,35,9,566,768,202,88.61184509888346,5884
418770ef-8f3a-4f95-9f78-528d98c50001,Healthcare,0.05320621778652734,17,48,13,823,810,59.58495114928111,3413
76a2786d-baf1-41c9-adfd-c79dacfa3b1f,Educational,0.7159332872512514,5,37,678,1304,626,48.63220073699431,8937
fce9bb40-40cd-4b74-98ef-1217b1d08fc3,Educational,0.17438874144378091,18,9,532,1105,573,92.85476471135796,8990
867b9c10-6578-4f81-ba85-47779c49b807,Commercial,0.8124214770946144,20,50,5,707,702,17.41293413709905,4399
d9fccce5-c86f-40f1-b93d-f1a8ea491cc7,Healthcare,0.43886815027663106,34,10,336,775,439,87.41335889334324,8725
1b1ce72d-5325-45e7-8f08-30843fe3c2d3,Commercial,0.43070391848972556,29,12,115,173,58,90.18580444227429,2180
9eced054-c92f-4d67-aec4-e8c6a6040fcc,Healthcare,0.15329631792324394,25,34,463,1121,658,48.88224094979185,9943
018d9b48-9764-4931-8087-268c63a95462,Healthcare,0.8095642185449378,35,50,292,1221,929,17.725611255407337,5997
b0d7673a-73a6-40a8-8c0f-f05e6b5adee2,Healthcare,0.5843539817230082,38,10,516,614,98,57.180502352120534,3006
44989347-9bdf-4d0b-8828-44c6420a1659,Healthcare,0.5042957297330655,43,50,106,215,109,59.597199888863784,2129
999fe7c3-f61b-4411-bf21-da1ff4bfb41b,Residental,0.23347657700449187,2,5,381,874,493,18.45017445384771,8550
83a3f866-269c-4813-a34e-c660e8f91bb2,Residental,0.03804658735700084,38,8,513,1384,871,70.0788454374898,5811
276d43fd-dc45-42b6-aea9-99b883f8c069,Residental,0.7103412717277333,21,40,183,1201,1018,88.13533375522273,6779
1a879f14-c898-45fc-8536-0848cea9ce6e,Healthcare,0.9624794475621941,18,21,501,618,117,19.983463891013855,8963
abc6af90-99f6-4310-9d3e-04ab337cc9cc,Residental,0.9004731208290376,44,47,156,1318,1162,28.49330596516648,1474
33caf2bf-f6d4-4515-9cdf-57e6e3d7df2b,Residental,0.5360201389335644,29,30,424,1017,593,14.809056644416806,1725
acfcb82b-84e6-47bb-950f-c3e35a351eb3,Commercial,0.9935491393264585,3,34,700,968,268,95.91841104194634,1921
7f35da5c-0234-4711-9f31-d28c348261e4,Educational,0.5430366343504065,31,1,621,1190,569,53.69607757602126,7298
ae00912b-949e-4c05-a32d-4b5f2f1e97dc,Healthcare,0.28430620744022506,47,47,239,246,7,45.076697271017366,2801
9531095b-a7c3-4b43-aab5-62d71c8496c6,Healthcare,0.9632560907378984,13,40,351,781,430,89.30143104316191,3366
d194c217-4b80-4400-9c55-70be30718870,Healthcare,0.6074105522837371,19,45,688,719,31,42.79259127532055,7965
cb234ee5-0b15-4d4f-9b91-afd4cf84bf06,Healthcare,0.6863474836172687,26,16,204,452,248,95.8413252700067,4883
7a0f9dd1-ac1e-484e-a3f1-482680f429c0,Educational,0.15685110073145325,10,14,233,242,9,53.618213989800296,2243
53db4628-899d-42a4-ba98-1a7d82224e00,Healthcare,0.3079673576980597,15,47,284,1013,729,10.703541463010888,9263
46bc3b16-1b25-474b-bb17-f470976ff121,Residental,0.253409948848504,9,41,23,1190,1167,40.94707664310542,5722
a9ecf594-fd18-4c6c-94de-14d0bc620360,Commercial,0.7279041169768666,14,21,504,558,54,94.64416102048266,8780
192e1899-0329-4d24-bdd5-31530c712e39,Healthcare,0.6891084146322601,12,49,631,1225,594,15.24719744396645,3119
a1b42b89-4bad-4849-a6a4-bd5382563a77,Healthcare,0.5776173211126535,42,26,643,1004,361,75.97006460564504,4522
9069b6ff-9290-4cbe-a515-4f5bf27fc4d0,Residental,0.047090342907209704,38,46,570,903,333,26.992911495634228,5704
41eb19e2-0f9b-4cf8-8909-71ca1551f647,Residental,0.2588649917109467,32,2,174,646,472,97.0914512736217,5274
28cdc1cc-9313-4bbc-bc2f-1cf60994ba17,Healthcare,0.9335120830137522,37,3,181,829,648,10.934624356712504,3915
e703c1ba-4b7e-4a0b-8b08-c3bd4739d4f6,Healthcare,0.6933442718106265,31,43,537,794,257,42.69377749831928,8953
5fd745f3-1b24-4e56-bed9-560f3aa23693,Healthcare,0.2366460629233743,8,16,4,493,489,52.58823052370604,4296
c3c3c82d-b306-43fd-943b-4f8f79a7546d,Residental,0.7243513716621504,33,33,580,916,336,71.99834181713388,3081
29912024-251d-43b9-9ba2-a25564aefe62,Residental,0.09974212904783086,30,9,675,704,29,54.52631693408701,7996
726f92e7-4008-4923-b062-7c50fc9ef892,Healthcare,0.1253156729820677,1,20,108,695,587,23.25741234905369,2369
45fad85a-835e-4052-8792-f65037780252,Healthcare,0.4726298845168089,20,13,684,1167,483,38.37542329747964,7516
f97f27b6-8ce0-4e80-a3c1-c4d2799107bc,Commercial,0.649060922650499,15,29,21,309,288,37.906370261546215,5054
a48a5b00-4d31-4023-a327-1678b94c85dc,Healthcare,0.6209138594355418,31,30,501,953,452,52.86504901133868,1929
56e396ea-5ac8-4909-a8e4-1fbc659bc515,Residental,0.05588938648553432,26,17,594,1024,430,81.64668852097817,4997
24366126-6f93-48ab-9c02-2c668fdcc51a,Residental,0.05057654621693719,28,21,54,976,922,83.37170614709333,2729
38a6e7d5-5a17-4f80-a7e6-99aebfc52670,Residental,0.9633096889190775,34,16,273,969,696,15.170135935222765,3496
f87f0187-cb8c-451a-b156-be3923aef39d,Healthcare,0.4712497932034979,40,1,678,855,177,27.236771414551395,5552
b0ce8719-08af-432d-8c2d-a506cb7e6ea1,Healthcare,0.5994025377378618,25,44,406,427,21,78.33597840410324,6983
a57e2930-9958-4377-afc1-54fa616588ea,Healthcare,0.06794733081491722,44,15,418,550,132,43.00505850718688,7434
4cfac9df-1f56-4898-9cc8-90751da3315e,Healthcare,0.10572961718929774,37,1,481,833,352,50.91824008605907,7172
97c1570c-cc9c-440e-989a-f428a26c2ca3,Educational,0.610122866481028,4,17,483,944,461,38.55620791920469,4849
efb30406-5b63-4bf7-aef6-90305d3b978e,Healthcare,0.9546067960226712,16,2,222,531,309,23.563147121404043,1453
015f6f10-8c30-4b07-bd27-92a6c58b4794,Healthcare,0.0359519339910801,30,21,277,1088,811,28.627137425501825,3087
f5405143-3b6a-419b-a2f2-cbb35e341a18,Educational,0.19968809428358603,22,21,375,480,105,40.097195777242426,2061
2fac146c-a1de-4c70-9bdd-b2a6ed0cf367,Residental,0.9032058012525155,11,44,579,1360,781,25.08320966515165,2411
607f6d49-5188-4341-8e83-7d69c833cb44,Residental,0.2194337172879547,7,32,368,1313,945,63.60036627917104,3111
6cca45e0-7ad5-4ce1-843b-62de1792f802,Healthcare,0.10400170390944441,19,43,546,1278,732,11.212725658108559,1095
79982f96-a8c8-4e25-8d4c-6166340898c5,Residental,0.2236971662732823,25,33,556,891,335,74.78222166697044,3602
4033c966-53d3-49a3-803a-40eb7bd2947a,Healthcare,0.9254733637556867,50,5,600,1383,783,98.0397187544518,9527
98545168-12f4-4f9d-9e29-dc0659dfa3b1,Educational,0.7653465451695641,48,49,390,547,157,40.16256896724961,2791
3e9ce613-2743-4e14-aa5c-64fb36efe5da,Healthcare,0.50812441057587,6,30,640,652,12,65.7993928630404,9359
c7beeff1-3fe9-41fd-94f9-b4930d0bf4cd,Commercial,0.6663586992745374,30,11,375,1359,984,15.010387098765161,8888
2ca828bc-80df-4e38-a3dc-623f9e2b3b46,Commercial,0.045547922562919285,21,32,593,1132,539,53.603031621992194,8139
07a04153-1416-42ef-a487-1df1d0fc4357,Commercial,0.01659928972766289,3,44,636,912,276,10.717870960283015,3247
3f90c4e2-7aca-4d45-b6f1-8964d77504b2,Educational,0.5562178178772107,14,7,459,596,137,73.34955206767643,9599
8d7ec609-1d5e-46d5-973b-f0a116d36da3,Healthcare,0.7321611366227229,41,19,660,663,3,11.634465714782822,5932
e78331a4-49ea-413a-853b-d0a82f373026,Healthcare,0.5510199272833306,49,45,719,929,210,33.606064063256184,7067
0e81a320-a24b-4e26-bc0a-fbff9a8b29d1,Healthcare,0.7900898944780044,2,5,178,627,449,13.39409983182338,7012
3df84142-d293-4b24-80c1-0f8fa418aa1c,Healthcare,0.7011788790239883,31,45,677,1001,324,73.44639550257827,2028
2f9ac55c-f6f0-4b92-9784-56a81919e3c2,Healthcare,0.9573201946264436,11,13,338,787,449,26.514253549153075,7460
e86257fd-cfda-469b-8eec-6d60a8c39f18,Healthcare,0.723798145265864,15,22,241,1089,848,39.311323350997796,4215
47c72f42-199a-47cd-86f3-eb9b1e1bdfc7,Residental,0.7214937753562524,46,19,28,318,290,26.465969328680103,3121
9da24a89-3818-4b65-92ee-dad9458d5e88,Residental,0.12252207016914429,7,7,580,906,326,79.38380933370368,8649
96c50d6b-0450-4632-ad07-b04626e9a16e,Educational,0.036674251382753265,19,39,682,931,249,36.220387121158765,5004
9da87539-4197-44c3-b4d6-504abfb502c5,Healthcare,0.6230670591355278,20,46,198,1292,1094,60.70986762161857,8193
09609afb-27e7-4ff7-b430-bf0e42b08ad9,Educational,0.7550929464167542,48,24,543,825,282,69.75300223191047,7574
14378765-6b07-401f-ac14-6d476892b725,Commercial,0.06689474330715539,37,36,244,334,90,38.004643401190165,2666
7f906169-53c7-4a36-8e6a-34e4a66a535d,Commercial,0.5547958118536166,7,26,229,673,444,61.67958901387967,9707
de4adf6a-df0b-4622-bd59-07e72b5b96a2,Residental,0.3532532899988763,28,27,321,809,488,67.84702704904893,4037
5eabda5f-dfdb-40e3-b219-f457c6cfaa62,Educational,0.259122460128297,35,43,693,865,172,28.751678202343413,8731
77a6f107-7f1e-4fc5-8f18-1ec2209a81ec,Residental,0.9151441579370829,16,12,375,839,464,86.61760884539113,4009
f6bf79a8-e356-48d9-a11a-7b9cd69d0af1,Healthcare,0.25090640281940313,28,13,220,1320,1100,60.31613529776241,7608
1ac613a8-dc72-413f-ae92-61c798fcce8b,Healthcare,0.608209245196251,22,38,451,1178,727,15.296633263159723,7282
5d128526-213c-4061-98eb-42c678505976,Educational,0.40533909359110054,46,28,677,811,134,98.3872790235429,8224
fa221d53-4e28-45e6-bcfd-d4b1af5d03a8,Commercial,0.8251158057692919,30,9,601,690,89,11.360218964575438,8009
419aa136-6d23-47c6-b7dd-f4a57c9efdc7,Educational,0.5490429801559116,31,13,504,762,258,69.88375180221132,9808
5cace826-e4e9-43e3-83a9-659905376e2d,Educational,0.9661111805051739,47,37,707,1407,700,10.555197764027863,7598
6c49e2ff-57ad-4002-837e-f94cf9b63cbb,Residental,0.4539819308224736,14,31,43,1374,1331,85.5682412998505,7815
0efea17f-5032-48da-a8b0-9586528a64b0,Commercial,0.671502593817713,48,43,140,519,379,93.22004894563385,8672
03e2a296-c2db-4c5d-a036-9514bdb148c2,Commercial,0.2705373132377903,44,35,569,718,149,84.46375315299524,5971
19a6fb71-cf67-402a-ad51-b897d1f9bc38,Residental,0.15763497727531717,12,31,180,1021,841,62.408275105107315,1826
049c49f7-545a-4081-a60b-2829b382e598,Residental,0.7090315058449357,46,20,625,942,317,76.28582264946174,4077
46efb619-ed10-4c62-9581-5fb6713c3f74,Residental,0.28238712146075773,44,5,328,498,170,56.831613444338025,2114
f72dcdd5-19c4-49b5-aabe-cc448ca8f008,Healthcare,0.04358167207153818,40,49,369,951,582,52.725378999024656,6241
ad6ef594-f7ab-43c6-8c55-694354a05069,Healthcare,0.8616370914768132,34,49,407,1352,945,93.56326512415765,6491
a21231c2-7638-476b-adcb-3eef9f727fd1,Educational,0.4208996424158086,24,40,136,255,119,54.21865862661713,8025
c2c97902-19b0-466f-b724-e849182553bf,Commercial,0.2274190054387074,40,35,136,410,274,41.10142394590362,2412
1f88161c-6b8e-4d0f-b7d5-5767c10c431b,Educational,0.6477852531430993,12,39,361,1207,846,40.054606522997844,4885
4d4d683b-59fe-49ad-a1c1-27e2bca8f85e,Healthcare,0.07096194902830699,11,38,8,1372,1364,70.21322305306369,5964
476fc945-3fc3-495a-b395-e19fcb91898b,Residental,0.7451498006760937,33,7,320,1320,1000,48.61657089589469,7943
d34baa7e-9f9c-4f6c-ad9b-3eabf7823204,Educational,0.7758112366432384,32,25,448,991,543,39.49850501197072,8775
6deb6f9e-739a-4ea4-bd72-b647b3d5c792,Commercial,0.40281016428974725,34,45,369,1257,888,59.24773886743533,7053
ce4ddd3f-46b7-47ed-811b-cb1417a8ab49,Educational,0.18219554942878324,11,27,693,1188,495,84.43184346028374,6031
003d532c-438b-419a-ac08-9e91851ca245,Commercial,0.6365737077349143,29,40,142,957,815,53.22253888202045,5355
a5cde22f-fe43-451f-bf9c-1789f79110fc,Commercial,0.48475252618945963,18,13,60,993,933,84.53282299894222,3273
cd6f1725-bd13-47f2-bc36-3008432f43d3,Healthcare,0.5609137113491707,1,23,597,1252,655,96.89930256763913,1220
229b8920-960b-4715-a94f-106c8b5fc62b,Commercial,0.08442032326289406,41,41,508,1061,553,17.118373659331596,8019
fc498301-e090-48ce-9d09-0f56f6084819,Residental,0.24389362668808312,28,15,163,925,762,13.112215384133343,7614
24bde7f8-0742-4177-9335-0d3a1a8a0eef,Commercial,0.1409364045030781,22,32,489,1137,648,54.47730382307269,4994
467e2019-997b-49aa-8973-9c8ebefea4ce,Educational,0.5054956956309897,48,33,380,459,79,65.51189782573942,7449
08ee227d-5cb8-4b1d-a50d-d29e100d48e9,Healthcare,0.2548908410219888,18,16,226,1334,1108,40.23817939965406,6494
970d2609-f3c6-4aee-b305-e3a7a5ec9492,Residental,0.6910119393652019,10,7,478,1280,802,83.55781076559056,3054
3ec85eca-1b29-44cd-9cf2-a3b7188c4cbe,Residental,0.13653551206306103,18,22,535,996,461,67.4443707508706,7098
6686c810-77f5-4df9-95b9-48e847e63da9,Residental,0.17494466118014096,37,27,574,795,221,77.56854253381223,6128
ca0e1dbf-d9e7-45c2-ac63-0c63fd2ade12,Healthcare,0.6338302442678864,25,3,230,1326,1096,79.45527617578793,7282
42b823be-2bf0-4778-bc44-0177069e23d7,Residental,0.17816733013541042,10,3,326,747,421,92.4161861561459,4325
a6db2215-8b1c-4894-b17d-a9d917b189c1,Educational,0.7964334191395788,3,21,400,1000,600,50.517352683848245,7366
f98bc249-21ef-459a-b4ce-4e5a058075c1,Commercial,0.44099872064170853,19,11,289,1087,798,76.19711579671853,8295
0d01d964-42d6-4f31-8e39-528228247473,Educational,0.8307278157681086,26,23,198,365,167,78.82646052749853,9684
4c90c84d-0222-4bf5-a652-ac3b37be17c2,Healthcare,0.1368893601926635,31,27,400,1375,975,58.47704597689384,4197
46e41340-1a4a-4857-8efa-ae05e851d8a1,Commercial,0.7355017035681825,6,4,93,673,580,33.55187580663414,8893
591c9b74-dda5-413a-b096-68680fc9ade7,Commercial,0.5986206892293126,4,2,602,1264,662,84.72034099631816,5946
5ae26287-ee9f-4250-8024-0168bec8afd7,Commercial,0.9214806922548383,39,17,592,815,223,94.03638492907909,1162
de5c16e6-af2a-44a3-8a54-d71e7e46a7ad,Healthcare,0.45596847360217574,21,43,93,356,263,26.061728129754883,6849
f53a7e2c-f408-475f-b8f5-4b194cad8fdb,Commercial,0.7421754955567611,5,35,563,1014,451,39.5850342294294,3537
32d0b545-15f7-4931-b96f-3e85f63f4f2b,Residental,0.08182474314657295,43,38,14,665,651,79.40743931445483,4565
304c0eaf-5120-4b6c-8170-97f338976d5b,Healthcare,0.19179506668305701,29,42,210,951,741,63.004835003160125,3625
da9cb5bf-b095-4827-b028-49ad3f1af28e,Healthcare,0.0007201225452381221,19,16,544,556,12,86.34161596927876,9480
13b0f6d4-171f-4a9f-97f8-6fc3a2d02b16,Educational,0.4517158427173147,32,26,495,1241,746,24.39208344422166,5419
232a7da2-e94d-4e27-94d0-86dc9073758f,Commercial,0.664265939670808,23,42,216,664,448,69.24739585104246,3587
a7c4347b-bfb4-4384-9fce-9334bd7f1e83,Residental,0.08140728722761814,13,36,133,732,599,72.7728920705257,2401
a85900ec-f8cb-47bf-897b-7879d826e901,Educational,0.2924226289432994,16,10,343,873,530,82.6419110697191,6697
60cd6799-d98b-4bf3-acd0-5faaae50991f,Residental,0.9332218025006196,33,28,662,1344,682,54.590729077999185,6224
c0f34a2a-e982-489c-bc69-d496b5482a4f,Residental,0.7926630616091349,44,35,196,1403,1207,15.569719982071225,4272
ba674b02-0fc2-4a21-af32-5a3d5128ae0c,Commercial,0.03250494076859345,23,1,117,685,568,91.4037230784837,1939
8562553a-b7fb-4971-acce-753ba21b35d2,Commercial,0.933682438791688,34,47,124,1037,913,39.47081625684754,8871
8848453f-a9cf-4a8c-9167-1dab5adf9a18,Commercial,0.4645249878636928,15,47,586,862,276,30.5596333948131,9558
b04ac495-5702-4c60-9efe-0d45691aa742,Healthcare,0.9855316737726528,24,3,669,1129,460,39.194610047577115,6283
878b4863-0615-45ef-ab02-b4165acd5b16,Commercial,0.5743760465551025,41,26,537,854,317,51.14898289825737,8990
b46dc184-47bf-4c6d-8ea6-5505eb1aa6b3,Residental,0.09144533047663095,48,24,118,1182,1064,25.12207050124219,9560
294831f5-7417-4e5e-ab81-fc2d0e003c78,Residental,0.6665438236287868,37,30,438,512,74,61.50650507280759,4395
14ef80f3-9a73-4877-a287-33a62fb24aa2,Residental,0.7102954227904835,38,4,412,1210,798,94.0149429481255,1728
e23b2f8e-3136-41e9-b728-7e1c031f31db,Educational,0.7521445317925802,34,25,442,1361,919,47.43067953313644,9785
1a9cc577-8156-4e40-82a7-b5c019e3b958,Commercial,0.890005404363106,47,38,193,531,338,67.05173191895005,5789
220163a7-eb7e-4912-b1bd-30fb690c96c9,Healthcare,0.4737411860752325,48,47,649,1425,776,40.53478009363825,3750
92f497f6-74f5-4cb5-a8a9-ed35349952b2,Residental,0.8401708226941962,26,46,678,1044,366,96.11420863489045,4849
1465b0db-6deb-4ee0-8294-b1f5ffb364c4,Residental,0.3346437044837187,28,42,422,480,58,85.7124125128233,7128
d1626f5d-058d-40d0-8b65-c4e5e4c69115,Educational,0.10950439129718681,46,21,601,989,388,87.74509375287045,9001
188be9fb-e3d3-4039-b084-6a718f8bae9c,Educational,0.5777931149610824,32,18,249,440,191,95.74137857617316,6029
6fffe070-25e9-4574-8c72-e007d12833a0,Residental,0.5303896023939642,41,30,339,947,608,14.21764511211072,9277
dcaf6e9e-d7df-4d22-9d96-0c98ab789896,Healthcare,0.39113214281544606,2,38,364,548,184,96.0844946505503,8055
63c8ed8e-5305-458c-9129-ef43c2612651,Educational,0.01425670239438337,47,6,301,942,641,39.97668722103671,6850
33e5ea80-557b-4f0a-bd84-8d9cb39b86fc,Commercial,0.05997753912341486,13,30,59,1195,1136,42.41103218179196,6407
95e8eb01-1fe1-4a1b-8132-8e0fa08de317,Commercial,0.8624210242013562,49,46,36,563,527,74.79860629758143,9578
f5c613c2-8c2d-4a6d-99ce-8ff6cf696fce,Residental,0.363921134623869,49,25,711,1378,667,21.86155806371044,3432
5c21ec38-b422-48b2-b07f-d76800b53fdf,Commercial,0.035131541860305204,44,36,8,194,186,81.27149280028043,7317
e8f404a2-6433-4f55-9574-36825d70fbc4,Residental,0.38601122121252385,34,36,513,1420,907,54.32413819644515,7746
dd3aeafc-2904-45f7-9ced-47b464aa03b2,Healthcare,0.9607392325923988,47,29,620,1139,519,29.35090860710817,8975
b6118a98-687f-410c-985a-038625876848,Healthcare,0.9419998760164467,5,17,318,771,453,79.6682956196979,5984
81060c29-c238-4546-8061-e8618dff524e,Residental,0.949786885123765,8,33,596,1263,667,35.28315783431705,8710
5b5bd6e4-022d-4ce5-8bb1-7112f3abb305,Educational,0.24907386355559902,11,42,400,485,85,25.003717057934054,3141
babff3d3-8794-46d5-aa34-70b3f626ed7d,Residental,0.3110197415071194,45,43,259,1011,752,72.5410304360283,1102
b07b9a0e-ac47-461f-8e7f-79bf46630d93,Healthcare,0.6707076982672462,29,9,100,845,745,90.1579686193653,9663
6e36ef1f-6fdb-4bd0-8306-0176422f2d0e,Residental,0.037743959221019474,7,17,4,1319,1315,46.450527932371,4473
d37ead69-5e17-4e29-b8f1-6db95c101e76,Educational,0.5905762342792151,21,39,237,565,328,95.67014688774444,5216
a622e1f9-400b-4f54-add8-95cb46afb6de,Healthcare,0.0826414291769556,12,46,189,836,647,16.25550165943635,9310
507644a1-f168-4754-9eb3-72e0b20d333b,Educational,0.8698243652700423,8,31,19,958,939,28.8441218461894,4494
9c1100c9-7eb3-44cb-8f7e-f5d2e1a53e6d,Educational,0.8414470075895071,12,7,189,1347,1158,46.65082812060968,3106
30baeae8-7a00-4efe-8c53-9f0a6055b497,Commercial,0.3726389125129872,10,32,561,654,93,27.84354230477772,3747
abe5b0af-e12c-44d3-b8cd-0e336540c578,Educational,0.7917490881738032,16,41,519,691,172,35.552905528786155,4098
1c080815-aeec-46b0-ac47-05171b9ae7c2,Residental,0.7732268385820563,36,45,497,1073,576,84.8560589361365,5832
84390051-322c-4fc5-8db5-e59f87db6171,Healthcare,0.19123263826774806,2,20,340,514,174,20.340224989299664,3719
b3cf4e97-9a7e-433e-9218-ad3af1108099,Commercial,0.22072385976991493,35,31,539,1195,656,18.410270219202115,2332
128406a8-514d-4660-9e06-797bbb5e68d0,Healthcare,0.8883522427079945,28,5,435,894,459,56.47279393719276,2212
aac3e95e-160d-48c9-8ea4-d917a63779c5,Educational,0.24352331533959815,19,4,18,1170,1152,80.08610058146341,4070
de359125-2109-4571-a03d-680b56230087,Commercial,0.73191985394259,50,42,101,1090,989,88.73120371732354,8114
52f9bec7-327c-4876-89f2-8c3c68f864e4,Commercial,0.12419990971147032,7,41,298,1384,1086,54.82917752367849,4231
9b90f381-bb18-43c1-a6cf-a65f4e55b733,Residental,0.37933834136289113,10,48,327,753,426,51.31292432591434,2270
451140e0-4bb5-4413-b737-10cd83827d47,Educational,0.5515310888289185,19,27,51,829,778,48.95418432562504,9543
dacbf010-0ab7-4d5c-a485-489e830642f6,Healthcare,0.22853436030600882,22,40,216,1236,1020,35.43749089248317,6272
dd99183a-159c-4d37-bd14-f0b69fb68021,Commercial,0.8063779109381931,29,34,286,1212,926,36.1119519760785,4613
74fdb1f7-4c86-47d0-94f0-373ded668c9c,Educational,0.23864391491700654,22,22,65,886,821,80.63408194734134,2125
d90daff9-399e-4dff-8f6a-f5323e27b1a6,Residental,0.5331057540582465,2,15,277,1126,849,12.319195777342292,7461
93ee25ee-4efd-454a-98f4-4649e7f313da,Commercial,0.5015925522845177,13,36,414,1145,731,43.02672477492448,7637
7e3f32b1-a7d2-4059-808a-d07b5a264402,Residental,0.06834112717728136,36,41,606,1408,802,20.968046387596686,1480
50ce23c8-87d0-4b9c-9073-8e3347018894,Residental,0.677944813878404,14,29,236,416,180,97.70733712107736,6003
22ec2c84-ba5c-40e4-9977-f6d585a9329d,Educational,0.9806771878810352,15,13,517,588,71,66.0495076139419,4818
1fb15371-4557-4ba0-8934-0524ee13524c,Commercial,0.45305414809226374,40,50,60,674,614,73.1692683518578,5461
9cd6621a-120e-4b62-9f00-22e0025716e6,Residental,0.321032076070634,17,43,511,825,314,84.1324200581535,1774
506a90d0-ffa4-4578-827e-083a9fd16847,Commercial,0.906353378277603,19,4,541,1221,680,68.06508868496438,1876
e2957940-3768-4a01-a067-fdc1b2cab301,Commercial,0.5873813617731802,7,14,294,1405,1111,73.32680858490221,1253
17d7e8a9-a9b5-4d5b-81a6-9bbce15ff374,Educational,0.07876900112297036,20,34,501,1416,915,52.94560691947075,1612
7863e50e-b613-4dac-862c-b4527397ff7b,Commercial,0.8157371677291159,37,24,355,1154,799,90.7779028107809,4304
9dc56426-9f3e-4b37-8281-e53c6fed7efe,Commercial,0.7017007190821469,5,30,499,1120,621,15.666922818019088,7707
0782654f-190e-4dc7-add6-4408693e4696,Commercial,0.4035437680949061,50,12,386,955,569,44.43213423523923,8386
75186292-0869-44ad-b453-b9baff88444c,Residental,0.6697603069183663,35,36,76,1387,1311,93.85609345808656,4370
d56241f5-4f4d-4054-bb17-758f230aed3f,Commercial,0.12105593168881312,33,30,76,685,609,18.903690524664732,6619
c899b5f6-1260-485e-a517-2d39a5590af8,Healthcare,0.5684851111480174,11,20,395,1052,657,31.5779244247851,1947
07eed140-6daa-45b6-9ef5-d5a351c2eaae,Commercial,0.9398266834888604,1,41,21,362,341,54.73865749940664,1496
96ebb680-c06d-4e2b-8ca0-a9443c7119d1,Healthcare,0.8686538118739698,43,40,663,1100,437,55.88124778280601,7010
8b953304-95ae-4068-8db6-0252780fca63,Healthcare,0.25910874609152124,5,22,163,359,196,18.26520409287299,3727
fdcbf8de-cc98-4a5e-9440-1d72fd74733b,Healthcare,0.38764936050979615,19,36,483,1074,591,87.74174420714694,4778
e35b4cc9-3143-4411-b0a6-6ce5c66445dc,Healthcare,0.2343695003777816,32,4,36,1010,974,22.196549427333153,6255
6a3cbd13-254c-4f71-9ecb-2b92d78e7763,Commercial,0.971061012276618,45,12,446,813,367,41.187233524815255,2858
cf6ec4c3-b651-4647-ae06-2332b49fe1a2,Residental,0.7269864453624717,32,32,665,808,143,98.75698129102331,3964
792f0151-79e5-4b7f-94ec-0ec512e99ca1,Commercial,0.4439820943113145,43,35,192,606,414,87.51750509925115,2639
0d895de7-72d3-4909-af3a-1c3522723dd8,Healthcare,0.6879157772167932,17,43,615,1060,445,79.52853807168087,8785
c6b48c76-ac38-40e1-a2e1-abd411392d72,Residental,0.582915041183387,48,23,555,1425,870,81.59639175345158,9831
ed0ce551-8724-4472-acd2-984b9bb51b61,Commercial,0.8673061028666375,7,29,510,1353,843,30.45945634727324,2740
57c9d70b-212a-442b-9b85-9840c7a9efce,Healthcare,0.4290840703945046,28,7,671,1307,636,44.41203425418599,8885
b8728c4a-a041-4c69-8e24-25b6dd1f9bc5,Residental,0.565977284613507,32,20,599,654,55,87.22201684880885,2212
902539dc-acaa-4b40-b675-f40cf60af354,Healthcare,0.047009535607249964,10,42,306,1193,887,26.964217350488482,6816
dbae701e-7ba6-4ac5-82dd-4a81d001c08f,Educational,0.8123218809903997,21,2,493,1018,525,71.60365579750984,2632
70957a7b-f75c-427b-b25f-3340bdaa4739,Healthcare,0.2340308097928404,5,47,493,1400,907,85.19072565000606,3065
ee0dc5c5-e393-44b4-8d86-5b255ae95735,Residental,0.418301683296208,3,42,282,1385,1103,98.41516954971175,4800
d8c06899-7fc5-49fa-b70e-3bfb9e846e8f,Healthcare,0.6823905952479768,39,47,676,1173,497,10.796871297821921,3826
d823057e-5c45-430f-a048-ad2713192c28,Residental,0.41191895230193043,43,31,553,791,238,35.41378773301737,8622
b1902807-dcb3-4353-919c-0e0ee7f509a2,Educational,0.21400860917777176,46,39,65,1417,1352,99.38464259967242,4939
a4c69934-55ad-4463-b6c5-1b0eed3590da,Healthcare,0.8268916809795839,30,41,206,1344,1138,33.22265161230344,2368
fc372107-31fa-47ef-ba72-705110c1f9c1,Residental,0.7952932093554156,8,8,657,900,243,76.7930933770218,6757
2571ac45-4fb0-4cc4-8ca2-8bf1c4daaa1d,Residental,0.4733098818136977,15,41,391,1440,1049,74.73887482233805,7276
d7d03a31-f88c-4bdf-b3b1-167e8bee9241,Healthcare,0.19182241352066554,28,44,566,964,398,93.5335888201849,7541
e31d1446-1972-47bd-9307-b1662aa4bcfd,Healthcare,0.9440724194283182,32,16,188,1128,940,91.29947110874276,8100
f31eb992-1b71-4fde-8ed4-f5efad643ea2,Educational,0.9773301306053398,9,22,510,603,93,42.66405341240946,9947
86480776-d53a-4837-8c9c-7e793729ae7d,Commercial,0.6131243556991197,36,38,635,1071,436,90.31349597691067,2865
89f9a036-d561-4f49-9a8d-f62c86be0ef2,Commercial,0.473590179044184,12,38,481,630,149,23.550387860509737,8978
a165e3c4-657b-4b6c-aaea-b258e8b04637,Healthcare,0.6888978707260881,16,48,532,1252,720,37.42655372682661,2715
91101c8d-0698-46c6-8bd5-bc2e5448af03,Residental,0.8064422372877248,13,7,314,449,135,45.48468225716654,9032
ea5e5baa-4912-4683-9f18-de867a955f45,Educational,0.3492891703681942,8,34,503,1048,545,58.03028302037591,7085
74d0766f-4650-4410-b2f8-ab791fe84225,Commercial,0.7004034310695364,12,26,465,964,499,18.01108811063964,4035
b84a98fb-1cb1-4472-89b2-31d3b6abf745,Educational,0.6867488599777097,6,46,269,891,622,33.18545026323589,7600
0535d11c-29e7-433e-83e8-b907297ff000,Healthcare,0.8875899587505446,28,19,171,1333,1162,23.479597843666266,9215
c899caa6-9eda-47e2-8fee-451562147911,Residental,0.9554193084481392,23,38,446,716,270,37.17495141459413,9659
8c842583-eaea-4819-8731-90e4498eebe0,Residental,0.8851435230112057,25,25,518,652,134,31.751447538170503,4732
abfd3832-5e3d-4cd7-a355-7058bf1676d1,Residental,0.33905500952460765,33,44,161,854,693,80.32617418351076,3534
d8c05404-d68e-4822-831e-ca638f31260a,Healthcare,0.9956221406602831,39,30,501,905,404,80.18530601688438,6104
1c6b3611-4d81-4b89-a023-4911cae1edd2,Healthcare,0.8099888401581987,28,42,434,1328,894,66.67582689564513,6263
2763c5b5-71d5-4af5-b91f-12f32d0627ea,Residental,0.9594338638488235,12,23,283,1301,1018,99.57922587309704,4168
a933cd5f-54b1-4954-a3ec-e9bd9a866162,Residental,0.7430993323844354,5,48,278,752,474,35.79841958183752,9721
dabef154-5256-4095-a9b9-a0141bb59ef6,Healthcare,0.975450483000002,39,47,450,1047,597,43.254832787119334,1119
19763f9a-02d4-4f2f-84dd-29ee5b3b8046,Healthcare,0.6696594876928923,45,33,184,971,787,72.61281132934496,9526
814353f0-c860-47c1-92a7-d6086915a863,Commercial,0.3902385934889817,45,6,271,668,397,18.97474757192705,2604
f41b94b2-5cf6-4b9e-a058-4d11260f6bab,Healthcare,0.5353633915414622,45,47,152,228,76,47.836911629728306,8212
6ca7822a-5d1f-4a92-bd3f-65a4657aa209,Commercial,0.7843399847647226,25,29,30,342,312,65.52726459541478,8228
0da9cf67-f9d2-4151-9bc3-9c9a761eaaf2,Residental,0.8746665044140561,5,42,582,1129,547,89.28265381410958,7363
dd2b4fff-319b-418f-a325-c92b045e3101,Healthcare,0.25656510760460094,48,44,205,852,647,81.80539136309801,9911
a4911727-8c28-4bb3-b83c-6b38cf379316,Educational,0.3460348219158478,17,27,96,149,53,68.66789329181287,9184
88d11440-5788-4cd5-99b7-a45554dde50e,Residental,0.16792909341603823,39,36,128,851,723,34.24450754605802,7870
65d44615-dd79-46d1-a9ef-b8f40e83e9c1,Healthcare,0.5133988750321028,14,50,403,1316,913,27.29446338017569,6090
a2878bdc-7d3a-470f-a58b-21fd5381aa39,Residental,0.777916392067125,50,48,526,1245,719,78.12841575217928,6504
73115ab9-43f3-4ce7-a23f-7912a2788c51,Educational,0.04861730596828917,36,2,278,603,325,79.07649603704876,8169
cf87c7ca-9d24-4f72-94a5-dab6daf24476,Educational,0.5121698058075874,8,34,205,504,299,54.18223110125465,2858
1c0e2a0c-0c36-40f7-9a8c-ce152692a09b,Healthcare,0.6751782863886476,37,48,44,602,558,90.16850568919949,8300
becec2cc-3186-43ba-89a9-7e024a539827,Residental,0.6578479303772069,23,22,41,1081,1040,14.938797807218513,1764
10dbe4cc-7a8a-400f-9a48-cff689adea9a,Educational,0.07611096386574401,8,23,572,902,330,22.60010852200042,9317
24ebb936-56e6-4608-87b3-5219a15c9dfa,Healthcare,0.6742030078806883,11,19,49,1276,1227,73.29318870286228,4916
7ddcbb87-726c-4772-8e10-92651aa0bbd9,Commercial,0.06723080661568681,19,24,551,890,339,50.7184172284946,4965
3e3bd75c-0471-4ed5-ab56-a65639cdfe0c,Educational,0.829406275477577,41,11,362,381,19,16.86960093350895,9256
d0902236-942e-4264-b78e-19b0acc3b77f,Residental,0.64088471486682,28,5,88,1250,1162,96.91893573352122,9518
b32ade49-4447-441b-ba57-d62833d629f4,Educational,0.8649611087323765,7,32,205,1437,1232,49.18848113314346,1810
5b5432dd-24a7-48ae-b1aa-755a4fbae5cb,Healthcare,0.7328358219846383,16,29,398,1126,728,14.242293684544567,1877
1e8c637c-c06e-4aad-86e9-014df2a38f1a,Commercial,0.28993515758023725,9,20,484,955,471,12.68482846363474,3986
bf3ef9be-02da-41f5-b7cd-e18e86195bd6,Healthcare,0.335526119958517,19,40,457,1099,642,27.374547733814747,7258
01fb7803-8c6b-427e-b356-7fc6656a984b,Residental,0.623070525015913,25,29,157,1332,1175,68.54912480262166,9257
d2832bdd-2522-4832-b4ef-d4cb033447fa,Educational,0.6008418918276054,45,27,694,815,121,26.246601637910068,1417
ad6d7521-4390-49da-aab0-fc836b728a7f,Educational,0.8236340950049467,46,10,320,611,291,86.1119737052383,9516
84472926-ff7f-45e7-8375-54aa586cf5a1,Educational,0.44748271231850134,27,14,400,1269,869,74.76284747698317,9559
fa4634fd-82f9-4ce1-b078-007a3f60f1c5,Residental,0.5136771665502103,11,24,186,511,325,30.08536291718415,1548
106b7c6b-88e3-4ed0-9531-5f4b53f1641e,Commercial,0.9244197306506324,43,21,340,867,527,30.21941089233771,9043
e9ce0a68-e565-4eb9-9021-f8c13780f4fa,Commercial,0.8020726495757144,41,9,139,717,578,48.7313984872578,2892
80dc99ef-2cac-49e4-a1f0-2322fa8e871c,Commercial,0.9331284062197341,25,30,105,308,203,11.515172058793336,1165
13f1c14d-2ecd-41a4-8feb-335fce420b45,Commercial,0.4723802554649148,27,44,537,1228,691,33.79453990075623,5878
df813387-6633-4000-9701-4bde5aaecfb6,Educational,0.11228566755009439,21,20,80,1144,1064,30.580959081129635,4927
352be949-d95e-4055-bb26-710de5e65967,Educational,0.8829808213741063,28,27,510,1120,610,87.57164292510772,8522
e3649100-d67e-4413-97dd-5a5aa0fb298e,Healthcare,0.7626749099501602,44,45,163,746,583,67.75456008596531,8337
21c87c53-372f-4742-99b9-b6b8607e3fa7,Residental,0.6940424042339624,41,36,428,658,230,97.57316062524472,7926
49a5e50e-927a-4ccf-901b-c34c24478a49,Commercial,0.9220136803107404,41,1,534,1154,620,24.54591421230583,6512
876bda38-7244-4858-9d93-3943e0e38d9a,Residental,0.2293124404480148,25,4,199,583,384,90.1261125253377,1262
ae0d8500-e816-4a22-8957-fbc8bb76df44,Educational,0.9617019721602602,50,2,680,1009,329,22.672006409199327,6903
a6cd0cc8-94a9-4411-a031-10d7838e6fca,Commercial,0.30492798765503304,46,22,112,984,872,28.487169931921702,6806
f1d4da0f-0fbc-417b-b4d1-6250095e5742,Commercial,0.6964570048155564,24,39,392,877,485,34.95337487960153,8680
14018ea1-e24f-4014-9791-d97126997f5e,Educational,0.7423468857393211,25,15,600,893,293,93.84366892648161,5162
830ad6ff-84d1-462b-a9f4-b42eb6be8f8d,Healthcare,0.8199710483466902,48,16,639,1102,463,51.384183234802755,5083
9ee254d8-2c39-440e-a268-491540e9582c,Commercial,0.72002772023719,7,9,381,1307,926,27.21906220439397,7041
48df30d6-ac52-4f83-90da-6bb7a00d9ca2,Commercial,0.0663585026939163,24,39,466,827,361,95.820894251585,1443
3a658014-1b66-4316-bacb-0a919078fb04,Healthcare,0.20916327254684874,8,48,680,1422,742,99.51355081606043,5889
71385fec-661d-4ebd-a96c-08b8017a4df9,Educational,0.4029406205037239,40,21,45,976,931,72.00606281500367,6467
a481e0c7-8164-40be-a009-6b6aefcaf514,Residental,0.41795827998367807,3,26,304,689,385,53.90692018579956,9475
d991a4d3-b09d-481f-871b-ee760239223e,Educational,0.6080288865619565,15,13,680,1212,532,84.76953760395791,7422
729753cc-eb85-455a-9a23-dc491dca2507,Residental,0.9102716942721845,33,42,569,1252,683,66.18077011064875,1592
a1833fb1-d1a1-44b9-bda9-2fc78e739d07,Commercial,0.5227726570797264,11,23,627,1141,514,15.389116277158315,6008
b7494de0-3073-4270-8fea-3de4b3c69e4b,Residental,0.14473182118693206,49,8,510,672,162,64.21907836087341,5286
0b9d3285-bdb9-4bf6-b97d-55ec32c0c817,Healthcare,0.18596375886238292,35,41,695,1194,499,17.34729223358363,1645
7ca1af75-c2c5-479e-add9-bffa704ee18f,Healthcare,0.055658464614555925,29,10,446,1061,615,89.3743276954023,8349
544d4c78-1d66-4c40-b686-cf2379de52c5,Healthcare,0.2634442491176552,45,38,399,819,420,68.8587200457492,3347
e34742d8-b803-42fe-b700-bb9d30ff23be,Residental,0.014909228513225958,10,16,654,997,343,93.6142362773904,1770
3ab5f388-b14f-4fbd-b895-20d7eb5508a4,Residental,0.11507689071582927,40,19,110,917,807,53.935209338713534,8591
15834f7a-9c55-48c5-8836-3fef881ee685,Commercial,0.11094334247130977,31,27,470,882,412,92.2017595233013,6079
a26700c3-fb0e-4df3-81ae-a79fc086a3ed,Educational,0.6919445702724368,25,13,231,686,455,39.813341133207345,7710
06116e8c-041c-4f94-ac4f-ee155309b56a,Educational,0.9325911343658821,39,34,702,1142,440,60.520721207796235,4115
1b169516-f503-48ca-b7fe-e7d2362fa86e,Healthcare,0.882768422774459,9,19,380,622,242,21.296470462489946,9230
012d1f55-0ee5-4248-aee2-f314d5b3d9da,Healthcare,0.3277883863305683,16,17,310,755,445,22.297492707389914,5952
c6479ebc-f5a1-416a-abf2-9c3346147e92,Healthcare,0.4896701700622965,8,48,373,1237,864,55.35203083380965,6746
1c8194de-a63f-4209-8bd1-d918ac7d322a,Commercial,0.30212249476186936,28,37,31,842,811,55.847556134597426,8765
36b32c16-740f-46ca-a356-a6f4cac70e7e,Educational,0.2824881391673598,26,25,486,666,180,82.3214275249638,3308
5a724bfc-6909-4371-bd4e-2de8a29a58c3,Educational,0.3496662700632588,14,16,660,1085,425,77.04138201710795,3868
e69c6693-6d1c-4364-b6cc-f682a308d9c0,Educational,0.2707436388532144,10,27,406,812,406,55.32000176690717,3702
4351e7ee-0cff-4d27-a1ab-d74f593a29cc,Commercial,0.925381579897399,50,20,507,567,60,27.461110311994503,3031
e7b759fb-0960-4958-a1bd-9e6aa1cf1fc1,Healthcare,0.5756109662474438,41,14,698,970,272,98.29057425487042,5137
0e2d99e1-d6c1-481c-8291-a49a606c11f0,Healthcare,0.8937396079472212,26,34,267,1282,1015,32.21311234403568,8087
9c20934e-ac8e-4e5e-b73c-7911927469ed,Commercial,0.16280927538669043,49,47,672,812,140,70.48933306584651,4509
d1637c19-4cc1-4825-9d60-06b4c6ceb7f1,Residental,0.02338722407811311,41,8,716,1227,511,35.457463009125846,6240
09fa9b57-3b78-43b6-acdd-2665d35bfec0,Healthcare,0.4666167291749076,17,14,309,533,224,99.9430830020988,1686
701dcdbc-2cc1-4da1-97b9-16099e0a0835,Healthcare,0.04834501135767144,40,45,26,165,139,26.290974179635754,6602
b256659e-035b-4696-a7b4-693ad845abfc,Residental,0.4933343381693168,22,2,140,904,764,30.25529929749368,7557
8a945633-8bce-4b07-bfb1-eb3c339a2143,Educational,0.7949873415627996,11,39,411,1340,929,74.17511641854294,9565
bed254cf-0798-4538-a550-495dcbbcddcc,Commercial,0.35877448603462814,21,1,351,603,252,90.78953142094646,3948
e8e653e5-404f-4cbd-932b-230c94cd8f08,Educational,0.5531665638057617,26,23,218,793,575,83.10925152229353,4255
b1f9ea44-e041-414c-9135-94c06e010fce,Educational,0.48932100857652616,1,35,21,519,498,47.07179883033774,7380
865a6196-d4e1-4816-9401-bbdbfd23b84e,Commercial,0.522226246020245,42,4,674,934,260,73.0159532753449,9767
d67fd7e1-edb3-4aee-916d-aae8ae9c942c,Residental,0.9591310772736124,11,43,648,959,311,23.17519907341064,5754
70fbf14c-49d7-4642-8745-a4b528cea811,Healthcare,0.9891192134731122,16,10,654,1302,648,59.36576336045668,6500
4972212f-3f10-49dc-85ee-2ddebb610109,Commercial,0.7599900307661355,42,45,392,1333,941,54.13391833332687,9532
1cbe1569-ae1d-481c-9f11-b9364bd82d6b,Healthcare,0.47149557259445474,22,13,47,61,14,53.013917224635186,7085
2190c01f-e319-4c1e-b13d-a4f2f8c0ee1e,Educational,0.2792098534423204,1,45,714,733,19,61.659699696168886,1159
180231a1-6cc6-4ebb-855d-a660b2f690fd,Residental,0.8706826932071885,47,18,474,1064,590,49.549920101360954,7589
c9b735b4-5fce-47d2-903e-e0aab806e501,Residental,0.30187699645499566,33,40,447,1166,719,23.68761993723068,8009
f7546474-f946-40e9-b69b-018813bfbba3,Residental,0.8158611149614832,32,5,196,817,621,10.039555510637985,6795
8a5a0ea0-8ac9-437a-9c41-235d6a086bf7,Residental,0.6153503135761409,11,28,494,1305,811,40.48283680621734,7583
9b08ec0a-a7f1-438a-93dd-940abb101723,Educational,0.004450193158151872,24,20,616,844,228,97.91421519007011,2273
f6049beb-39a0-47e1-98eb-cbc91052391a,Healthcare,0.35403526284135334,17,39,333,1210,877,66.12591301779338,9285
fa9a458d-cf74-4de7-b3ae-c9ab017002ac,Residental,0.7942736193073182,47,47,679,1289,610,19.616430494774306,6996
4c45a574-c70e-48ff-8442-f7ac1a5a7734,Residental,0.4642552092770813,17,26,105,676,571,53.86895543486197,4525
66bdbc5f-4e48-4dc0-9c95-8a7d94baa279,Commercial,0.3480365263615911,35,27,230,306,76,18.409592503097187,3808
2324a417-43d4-4e11-9be2-a0936c1f0152,Healthcare,0.8913638373841306,32,49,685,803,118,59.3497755546826,1133
73c51a13-411a-477e-a578-18d8f837611b,Residental,0.6779829173656567,5,8,537,1335,798,67.01952181396268,5016
1811929a-0d91-4e12-b654-a9806447a692,Educational,0.9235719024634963,34,37,474,707,233,69.43325894705184,2119
02bbc24a-bff1-4b7f-a2d5-f3335c5a28bb,Residental,0.8894007788423455,26,39,394,1131,737,52.70694329105049,7333
7d5b2fee-df5e-4ff5-bb2b-11b6f842abf0,Residental,0.4781744199301933,38,43,356,1315,959,11.981418257094187,8757
20e12e84-7b71-4e7d-8563-6e241ed91e9d,Educational,0.8269548528963798,25,6,367,1410,1043,31.68428853288875,1815
e0cf747c-4d44-40e4-87d5-de84f503fb14,Commercial,0.9210907725662576,2,49,574,1385,811,86.54194199543988,4953
36112d3a-63ec-47ff-ad12-bec1e241bb5e,Residental,0.4357887640457482,13,42,680,1317,637,19.575417663468286,1032
8827b469-46ad-49fe-84ee-0f34f60e1ba5,Residental,0.16459188486901621,41,34,182,1007,825,75.28273085093986,9704
272ebebe-84a3-4b50-a6ee-3c760db3cd78,Educational,0.9037506502929847,13,26,235,728,493,14.24836033912344,1715
8e082a14-e658-4f49-8b76-bc1b9fa7ba93,Healthcare,0.350171563073286,14,41,4,896,892,51.28732095800034,3842
d42f55d4-aaf2-4f3b-abc3-1112e60ed46d,Commercial,0.40850799287073036,22,19,607,765,158,48.390902982459735,2635
6ff043ef-dc6f-475c-8346-856d812e862e,Educational,0.947171646052862,17,28,422,458,36,26.172163651085533,6999
12849148-4cb3-49f0-a2df-952833bd0510,Residental,0.4932810768650854,14,4,373,1405,1032,12.67488365069191,3286
646f26a4-af62-4eca-a5d5-636a1a50d6dd,Educational,0.5959779449891768,15,2,290,819,529,47.90809193275193,8547
ad330ca0-d5ec-4e9e-bacf-f0e993cb2ece,Residental,0.9704206228954595,21,9,453,879,426,34.46035441923949,6847
8dde2dd1-d630-4b37-86bb-bc86f428a1a2,Commercial,0.6181917901871226,27,8,200,1146,946,86.44684232247936,2111
b460ac4a-7a42-4397-91a2-7a78da67927e,Educational,0.6583201822099781,6,11,620,1134,514,23.118321380894272,3514
612de03c-ea73-4118-a2f8-aff816d819c9,Educational,0.14901334330155636,13,39,175,443,268,77.75647845018374,8402
ebd8834e-6fdc-435f-a29c-09c780f324b4,Commercial,0.13810933464966857,45,22,123,356,233,28.08376669998481,2574
031b00b8-74ab-4adb-bb28-8ba36c8f343c,Educational,0.6650376341021923,19,18,464,1422,958,81.50393074215225,7912
08faff4c-5dcd-4626-a3b6-b9a308e41351,Commercial,0.618190030017621,15,37,568,826,258,51.87381148312599,6058
d45a424d-662b-4346-b8bb-d39d522ff041,Residental,0.7292376947298189,7,49,324,509,185,41.639278078054645,6516
0ec39ae9-c66d-4b80-b197-433e7be48dcf,Healthcare,0.9151584764810851,7,25,49,327,278,14.55095296248037,1081
7857d422-138a-4258-9ede-eb04e79a5fbf,Healthcare,0.45998416737245496,31,46,415,1099,684,29.173119026925264,3912
e417f764-1c02-4529-b561-5d6defc049ca,Healthcare,0.44947923822516833,24,39,696,1325,629,85.40824350503398,5803
3893281f-302c-44c7-ae4c-fa49285ef27c,Healthcare,0.11960681238818627,2,14,643,1043,400,63.38975512320476,7589
2a24751f-71b9-43c4-80bb-02495ec6b0dc,Educational,0.3168080202224839,35,1,303,826,523,65.79942740117366,9439
05b40d1d-600e-453d-9c68-853815a2fb7f,Residental,0.5254941386168186,40,36,170,258,88,78.35243233500458,5569
70ce7e3a-f59a-402b-ad4b-a22672e1cfbd,Educational,0.162940926645729,7,18,268,1300,1032,60.57893148058682,9322
813c246b-1667-40c9-95ed-13271921f9c5,Educational,0.19146683968252387,14,41,277,607,330,98.82520058054119,5321
455643a2-e488-4fbe-a600-d908a98ef20b,Educational,0.6391364654546176,30,13,550,1140,590,66.78757256238507,4722
e9bb6195-752f-4286-9ef2-b39c3a0e22e0,Educational,0.3871084327316072,48,36,223,1157,934,76.32936073538436,1607
6cfd35f6-34a5-4393-a9e1-748ef8b3c005,Healthcare,0.30586823981157796,25,3,452,1331,879,85.90967201997958,8521
8f383af8-9a2c-467f-a7a1-8a5d14932fee,Commercial,0.5110113123237106,34,3,75,577,502,78.32899755022918,9680
711df9fe-9fa9-4295-81c3-6c85a12caa7e,Educational,0.44513891958475205,29,4,630,1037,407,60.13776994426557,1520
af19aca9-0fd3-47d0-86f7-f9e2390ba176,Residental,0.22812217012128344,24,24,568,780,212,74.98819793084533,3252
3816e1fc-25a0-4629-88b5-b7bf68387160,Educational,0.6196264643004104,44,31,5,1384,1379,65.24085133496149,3513
2d54e191-5b4e-45e4-bf6a-173ca0e6fcf5,Educational,0.913461278750359,30,13,212,405,193,73.14614997017941,4259
6a77cc35-613d-402d-9541-3d0b61817ac6,Residental,0.9608130867983373,37,11,492,1275,783,11.519060407582575,3027
3d349863-e4b5-4912-aab6-21196c0f5634,Educational,0.3735619385081056,46,35,405,472,67,85.24814029589227,4373
f2d51a23-24f8-4877-85a0-ecea9e996732,Healthcare,0.08040805072722801,26,8,337,1384,1047,64.02656655234946,9689
7d137c78-59ee-4288-8cc8-f2c3097cccf6,Commercial,0.3374642684574295,13,18,215,1270,1055,65.70606283561233,7138
07b1c98f-cf17-4db6-8a23-6f4d97805859,Commercial,0.2443085244147305,13,46,414,617,203,74.04664258769066,6291
4195dcbb-b128-4cd3-9c0f-da2880f27b38,Educational,0.9240812725498031,3,39,329,629,300,66.0582229091099,1496
dba5cbf0-a39b-4179-8f60-0b9d74363ae0,Educational,0.1613712511152302,43,15,694,1409,715,69.98629110266542,8714
f294f86d-8e07-451a-ba73-0b884750aa11,Residental,0.009869682416866477,41,31,468,1138,670,75.08502291476952,1199
679da089-3f4d-4928-872f-57035ab2db49,Educational,0.7100243197092617,35,9,500,782,282,51.27895915703191,6265
8ae82425-dd37-4eb2-ac4c-454c18c1282c,Educational,0.6676789026547829,38,16,503,1399,896,12.43353636443359,4472
7c963b3f-fc74-4dcc-839b-6d0c9c8fb538,Residental,0.393376139106717,20,11,598,863,265,25.240874410678035,9044
85af8d63-d40f-41e9-a1b7-c5638c3291d7,Commercial,0.3152256535290151,48,45,717,1029,312,86.09313976103876,5467
86ec521e-7d74-46db-8e12-3be2ba195a0a,Educational,0.008983485188848506,29,47,348,392,44,22.192875513508298,9204
b5470f47-99ee-42db-b7ac-afa686f95079,Educational,0.41830534196342584,40,3,555,1219,664,25.214747457437234,9596
4538ea24-1d11-46b4-9d2e-41577e720d3b,Educational,0.5583034355662518,32,26,158,925,767,57.566770360810935,1292
675c8153-c3da-482e-a40e-ca47b7dc5f57,Healthcare,0.014148188814466,15,24,354,426,72,31.418548836859657,1164
ddbf13a4-fca3-4578-9f0c-60e862d08e04,Educational,0.9078813333452935,42,31,714,983,269,63.66633381629307,1172
d45b7141-f2bb-485a-8939-a839bd5c8201,Residental,0.825996727883877,41,1,438,900,462,58.641486637609134,9281
1824064c-2b4e-466c-86db-30fada87a4e2,Educational,0.29946136975415605,31,6,620,1404,784,99.30549369031458,4518
71671eec-c767-45fe-b129-e59a344b52b0,Educational,0.28012810983373715,19,43,375,1036,661,22.73420071568571,2869
6b33dd05-352a-4cdc-a41f-555d4522f945,Educational,0.10440367362010305,37,37,15,1082,1067,78.35516674085277,8432
ca5312c4-4e8a-425c-a96a-39efe9edcc0a,Educational,0.08900869566681358,2,17,657,1060,403,61.93379643713158,7082
c0c6f998-a215-469a-b536-29c3fe62725b,Residental,0.7268019764269975,42,23,279,344,65,14.69940412882932,6924
1feab256-8701-401b-ba4b-db666a0647cb,Commercial,0.21778646266754376,46,21,359,1175,816,94.9907957002867,7103
ac713bd2-be60-40d0-b7aa-df5bb483c918,Healthcare,0.2662024105741828,34,15,447,471,24,86.65100469689204,5885
4f9902ba-e5db-4eac-bf3e-e4953f7ddb36,Commercial,0.4235146976188836,22,24,499,1416,917,69.85994839074044,8383
1351d6c8-cae5-4792-98e3-cc820cd7add4,Healthcare,0.35457271367457033,46,12,22,1429,1407,75.2513908117446,8686
62aa6a22-e133-485b-a214-67933180993d,Residental,0.8610707695412556,26,19,447,1218,771,16.3012763860754,4283
47f8fbc8-f4f6-4967-a9f6-fdb3837b799f,Healthcare,0.5808657601494821,10,50,232,1096,864,84.70782635554097,1239
47e98f18-26bd-4e79-b0c3-556255f44618,Educational,0.33171949861603156,39,8,54,1416,1362,94.24140601879618,6418
3255edbc-c96a-4efb-bfea-8b92363d0f1d,Commercial,0.575700863695475,11,23,394,454,60,73.67495373630373,4041
0300c3d3-e45e-4f4b-a7e4-248cb3656f10,Commercial,0.6088804897499177,27,27,512,625,113,45.675705004841085,4373
6acce7ce-f40a-45c7-9289-a1c73ee4dc6d,Healthcare,0.4411429715083971,2,7,538,1284,746,52.12343216631491,6587
a7e844b7-427a-4327-851b-5958ba5d9f6d,Healthcare,0.6763442226492341,20,22,598,1437,839,90.40020745949222,7414
79a0b0bb-ee24-4f34-8d51-5aa128bc8fd3,Residental,0.657305602393819,34,31,647,846,199,36.5916813691575,6416
1c259aa0-a1d1-4561-9fda-310850bbb0cf,Healthcare,0.3107167488596092,46,41,64,1015,951,33.87809273963687,1134
11dbe245-0909-4274-b3ae-1f8ec69bc7b0,Residental,0.49750597478083836,44,27,385,1004,619,46.66140890139181,4396
6e938b86-8a4f-4649-8ac0-86237980ff5d,Residental,0.8692114300223313,48,47,203,695,492,92.51333362464531,7402
91494632-2072-4e93-8d1d-ef8cf141cd59,Residental,0.31062414705568164,32,25,87,1429,1342,93.46265006124365,8106
1a5d86cb-5b4c-4989-a926-67f177271350,Educational,0.8046686933264924,30,39,549,1421,872,45.36206243415235,1578
709bba60-f1b5-437f-b370-51d70f065cac,Residental,0.6539291230629349,20,3,325,1122,797,40.815781134037124,5874
aac42629-26ca-4f58-89e9-f27defc3b18b,Healthcare,0.8967426846809685,17,39,652,1184,532,38.55618672340903,7824
c6a1a24f-bb10-4c98-8296-d4e5627cfc9f,Commercial,0.3346608684470108,32,32,401,1349,948,26.95397020791609,3007
763a96c7-3bc5-41ed-b7f2-451a678a84fa,Residental,0.7572446618369377,4,21,304,1384,1080,56.26237077559615,6350
000c1691-aed5-4ea5-bcfa-e98e16844e5c,Educational,0.08773339359331767,26,4,466,1069,603,47.55827288800761,5547
cdfd39fc-c8e1-403d-b11f-e1f387d394d4,Healthcare,0.3456520187271578,32,20,260,657,397,41.12569166945494,1526
3597962e-76d4-48e4-bdf5-7582e165fe64,Commercial,0.6448683931454976,26,4,279,975,696,52.2040998980639,5584
4e47a065-6def-40b5-a5b8-9a2b66010b56,Healthcare,0.3335871231629246,44,49,622,1078,456,30.81047835920951,9267
938da5a2-8085-4c43-be9e-f4506eabee06,Educational,0.7453303664978542,21,16,124,772,648,23.318474137249652,8840
dbe51126-d174-448d-bcfe-38b24f08cee5,Commercial,0.03901509012078763,43,22,7,1333,1326,76.18635495468955,5037
2b91b8b4-02bc-48e2-852b-f9c90cb5794e,Healthcare,0.7830010621299771,6,47,666,1042,376,30.699333068885373,8403
4bf25c5f-0f1a-4854-85be-d282a17d1b6f,Educational,0.2750913673577371,6,42,398,1263,865,92.54857888743373,6062
40ce327c-9bec-4403-b2bd-ad4f77969bf7,Educational,0.7076065232230789,2,8,39,666,627,95.74225831287156,4923
dd9213d9-c6be-424c-aa07-f3c84aaa021e,Residental,0.3522816644862252,6,24,30,262,232,92.38410047304691,8575
c258f2d1-29eb-48e2-ad96-39b4475b2a41,Commercial,0.2663327697886956,13,36,465,1282,817,16.117477446844354,5703
88f6d570-e6f3-45c2-b981-f07c429e9f42,Commercial,0.489878006229056,38,20,434,769,335,98.51301321953352,3665
6850c3c4-158f-4b34-9f3d-9060e8fc6a0a,Educational,0.5551798888039637,19,2,407,1083,676,48.92848721897931,7426
04dc58f8-74e3-4394-aae0-626b90c36e8e,Commercial,0.03313596502392402,16,43,116,955,839,15.474427391261502,8934
5e0233ae-1ef3-4f62-a492-c8b9391dbdd5,Commercial,0.08704611158887976,37,38,283,1268,985,97.2181391365178,4598
c70c6f53-edee-400a-b27b-b9e082752863,Educational,0.8457513006497271,44,25,358,1007,649,34.305262358064816,3937
9a72e240-ed5e-46cf-a75e-cca106b7cc9a,Healthcare,0.08975942468369347,35,20,632,1340,708,44.24515635266074,5219
92d95570-5306-4c7a-83ff-253a2c75bff0,Residental,0.8084980784197865,28,45,78,1371,1293,99.42364210867265,4391
853b2baf-0a63-455e-80d9-a8f0f679fa5f,Residental,0.06019449503404928,41,36,447,464,17,69.27489713189492,8659
0f1ab531-082c-4ec9-b7ef-c6c3fb410d57,Commercial,0.3070517530607557,7,2,344,352,8,92.9194292316933,6397
f7960ba8-b6ee-4683-bdec-e810e8a78137,Educational,0.2723535712410554,6,16,148,1440,1292,98.46768485355013,8511
8e18c630-244a-42dc-a937-26c4f35bce23,Commercial,0.28491521284062193,36,4,11,661,650,53.40130195171497,2008
fb519b76-5c17-485b-9088-43d6400dc44b,Commercial,0.3002883442672514,50,6,220,1425,1205,43.80100423879709,9610
a2a34e72-57a7-4ec6-8f16-bff2845383d3,Healthcare,0.1149963471557447,32,28,154,178,24,77.7927527810514,4942
2c97a404-1011-4ade-9682-5e547a45daca,Healthcare,0.20895063793674018,15,5,284,807,523,49.14756025920617,7975
11360be2-d87d-4e50-9cc9-dec0a08e57e4,Healthcare,0.54209596256042,24,50,626,768,142,95.32583288776836,8666
3b94e31e-9752-4acf-aa5c-692762feb46f,Healthcare,0.5804588772501674,19,35,235,1138,903,20.12811258446073,4822
9099eb73-9c65-4e8e-a2d7-86d9e73a83d7,Healthcare,0.37593878012543436,12,19,14,337,323,47.60187299793721,2778
37b59989-f270-4271-9f82-dfff2f931c49,Commercial,0.05245209075983592,7,27,451,570,119,79.0054713658775,5019
8671e41e-e649-4b2a-9a48-bda56e74bb43,Educational,0.41565346296663086,38,47,376,1107,731,68.01504813067427,5948
806c77ac-3fd9-4a05-ad06-4dd09fb42501,Educational,0.20386949110012786,36,10,15,860,845,14.013088345474097,7589
914febc5-ccba-444f-8219-dc96d44d7fec,Healthcare,0.3952290017995136,26,24,49,535,486,23.171170996958637,9378
28260ca5-a2ae-49a0-8b87-09c59328aaba,Healthcare,0.9729278947761018,42,44,562,1275,713,97.96415289224414,2192
bf2be573-a061-467c-a1c0-2d792704f51b,Residental,0.8415133384939693,19,29,221,981,760,68.95891901832894,1660
62ed06d1-f7e5-4680-9b58-8228bf7d579a,Commercial,0.8936763815423152,35,29,654,1326,672,76.11855108924571,3750
6f03808f-490f-43a3-a90e-bc6e33a2830e,Healthcare,0.17963703196169944,43,13,417,1207,790,34.75579879407393,4067
2a624460-734f-453b-80e8-4acdceec2dd3,Residental,0.9644625998139015,40,2,549,790,241,23.073245481066728,8051
8e917656-c956-42ee-8783-b4df10679dfd,Educational,0.001989417330659604,19,42,443,1135,692,22.42471046809796,2184
d4614d07-84cc-4e41-a834-0c6d15c801cb,Commercial,0.011324259542299986,31,33,166,1292,1126,47.23606176730108,5457
7e8c3ceb-5fca-4e4f-a2d6-8541dcacf4f7,Educational,0.674235594319875,43,24,575,1062,487,81.791637326304,7365
8b2489c4-1028-4f66-8b74-970ac4edd0bb,Healthcare,0.34883376136085986,22,36,33,243,210,40.53854667813699,7915
0465a5e7-19b3-4e83-9c36-7c58feaae29a,Healthcare,0.31878410785103417,46,33,591,1348,757,51.183829393609926,1430
7e808168-cdfb-4ca6-b2fe-5b70e6cc411a,Commercial,0.44253967848171194,38,48,252,1126,874,74.9409120299414,4876
3b20c71b-68d8-46e9-9234-99d0446cc07e,Commercial,0.14379415056050515,18,3,671,1199,528,93.045909854559,8425
cc442cf3-109a-4d57-875b-32628fd1ccff,Healthcare,0.9790888074966445,33,3,3,1370,1367,99.5521444322809,5654
b200c034-5b0f-4675-85c8-3a7a9e246339,Healthcare,0.8623341617762804,38,29,696,954,258,68.17977159338835,5383
e48f04d0-10f0-478a-8d99-862c55c12556,Residental,0.16504781949446867,14,8,186,423,237,82.39328545103523,8744
dbebf1c7-c0b5-4829-ac54-ef96afc772d0,Residental,0.5472538156948441,9,36,239,299,60,92.40753927183717,9238
be21a501-9e94-48aa-8abf-071fb864fcce,Healthcare,0.8169868501438263,26,24,484,1343,859,44.465680687094746,5578
9eec9ff3-4ef5-49dc-9f53-9f0a7904495f,Educational,0.1753457820821911,47,26,96,302,206,33.72770682226427,2786
78c6b7b4-7845-417a-b575-a93db54feb05,Educational,0.40575658338171894,24,30,67,135,68,19.376483298403343,4673
bc5eb0d8-5f3e-457c-8207-5df5b2266814,Educational,0.6327529276105502,22,15,11,193,182,53.38409835443203,1680
437f2afc-39d2-4c16-b028-f67ef2c2ad36,Residental,0.7820965007680493,35,28,469,1264,795,82.57015736962407,2738
20432cd2-2d82-4f1b-b2ab-4b46afd0e290,Healthcare,0.09750501082877394,26,33,299,765,466,95.24394567332624,4943
86eb853e-52af-4c5f-9dc0-c0da9a25cb08,Educational,0.6919325107119181,44,38,13,802,789,96.01177273219386,5349
e5a607ce-649b-46e5-9821-2aa1cc6350d0,Commercial,0.10833332232219117,18,5,399,920,521,56.094981859739356,2153
4fd5fa7e-8721-41eb-8382-9b9fad9cddc8,Healthcare,0.0017620009770845657,19,11,443,765,322,24.776559018914316,8758
51e6eb00-821b-4fd2-bbc4-94cdb7fb2015,Healthcare,0.9264564798600229,30,6,298,466,168,41.37159771098255,4474
9906954a-20ed-4fea-ba49-646789f1fffb,Residental,0.3550647947433836,14,49,307,779,472,23.00675169059695,5193
99d86460-2bb1-4576-924a-4f018554b6dc,Healthcare,0.7819152368488174,10,36,195,939,744,45.12668844668602,5580
f3026c53-fed3-4d53-a7a2-502d28483aea,Healthcare,0.6704405593552205,20,49,45,1041,996,57.52566604355937,3589
f1ea678b-3543-49c3-bfc5-09eda2e66280,Educational,0.021285443594595166,24,7,131,1206,1075,17.012147779233473,2507
4c816516-a99e-4460-a479-c424480a6697,Healthcare,0.42841582856433413,14,29,318,1408,1090,89.06382401635508,1962
b3266a62-9051-4214-8fa7-dac269c3f245,Commercial,0.584967579767557,27,24,571,1197,626,58.395712668323085,6732
c0f3a587-9c5a-442a-9baf-b75b84ff1477,Educational,0.23019933637608858,16,46,142,1265,1123,24.08820235411511,4434
0b9c7843-e79d-4d63-af5c-4ee170a3f6a2,Educational,0.6249144786801019,16,7,263,1217,954,73.10492392571257,4711
74897fde-c175-4bec-a13c-34153848440f,Healthcare,0.42802870656317993,37,19,315,526,211,58.49234348614731,2654
cd0022d2-ef33-458f-b13a-99bb93bbd523,Residental,0.43379336997046336,43,9,665,1332,667,49.09067950914832,1942
16f49ff4-0648-4894-8e1b-d41a5e1bfaf9,Educational,0.9077961038999756,14,1,282,838,556,93.04676446547533,9060
1f1d0e43-fe88-4cc8-8dbd-4c948d27f055,Healthcare,0.010741671244899442,50,10,581,950,369,23.32818911799245,3695
bf1e2783-d594-4a8d-b367-d6bd512ecf3d,Residental,0.31374894150337884,22,4,445,654,209,64.79902856351997,5007
af9d564b-11bc-4721-ab63-2309259ab40e,Residental,0.49157812855252114,33,40,231,331,100,82.7872785370041,6447
9319a252-14b8-4c48-83dc-78c0b3203896,Educational,0.8205598510819767,44,18,162,269,107,64.17796484861086,1471
4e3a111d-3dc8-4271-a712-b36d9ad6bf1a,Healthcare,0.6719453517192654,29,34,237,525,288,52.63466120694419,9873
7e0af0f7-9c2a-473a-8d84-27fbb3813668,Educational,0.9177687607413936,47,25,470,578,108,86.48551915910289,9649
618a9680-827f-4082-8d9d-2c6ffe675b74,Educational,0.787889006707255,6,33,44,232,188,50.92113713903761,3341
86453d93-6bfd-42c8-956e-612ba02feb20,Educational,0.9906838271750181,50,8,392,699,307,64.88569760169197,2679
6390a1d2-ad13-4f67-89e8-8edb93bd88ab,Healthcare,0.7814442544927985,23,1,365,567,202,32.31912355562577,6983
df4ecb86-66a6-4418-a10b-be836eafbef9,Residental,0.05379859745816451,3,21,66,123,57,91.24850854818932,9700
954ec232-cee8-4417-abde-660c1d1f576b,Healthcare,0.4081233577389868,38,4,483,929,446,60.33057732299223,2767
fbc7d723-0750-4206-8595-14fd00642e4e,Healthcare,0.5960839837981879,48,41,353,456,103,70.75906823918328,5185
3aaabe01-82e4-4974-b2c0-9ceb651d1fc7,Educational,0.19415252013694229,38,46,278,1240,962,70.58484346365316,8204
f84d6f80-5e7b-4e9f-afff-ee9a9b97be29,Commercial,0.235095154745652,36,49,23,828,805,45.95854098957107,1562
664b595b-85e0-446b-9bee-684da76dd15a,Healthcare,0.6238124514721548,40,38,693,742,49,97.75916234519318,7085
48f730c3-734b-48f9-8ec6-e08330445f93,Educational,0.4930505966542513,28,31,453,461,8,88.23105066700866,6084
f80adc37-240f-472a-9f02-f3b407f2f01b,Commercial,0.9564982155487688,21,47,311,311,0,45.88270059498016,9563
95d52ff1-b3de-4aa3-879d-785e67aada8c,Educational,0.39065579616233104,6,23,371,813,442,96.95849957520835,6628
0c4adcc9-0548-4422-9942-eb709177ffcb,Residental,0.6210158826124931,15,9,508,1371,863,41.46076610457162,6548
3dc8c04d-225f-4cbb-89d3-237a54edfb2e,Educational,0.39446608858788634,22,49,420,1388,968,18.558884293058156,6059
74c38d43-2a05-456f-9b9d-40d20ed0782f,Residental,0.4095860834963899,12,17,70,1424,1354,36.49649842290796,1987
67af6dd7-73ef-484f-b87d-f78480fa2e68,Healthcare,0.9243602165601357,12,50,497,670,173,87.23922935917315,6538
cc88693e-dcfe-421f-bbf6-c985017f6606,Healthcare,0.5428034286304813,31,5,239,1334,1095,29.4273787363569,9655
41cb5dca-6865-47ff-a324-3eb7210d6c00,Educational,0.6027631404281725,26,16,69,90,21,28.257127081297277,1204
7b533679-bf2b-4568-b107-e5eba7e05682,Commercial,0.0034180769109406484,2,25,52,354,302,75.06590057784459,3254
116e3dc2-aa80-4a65-bf65-4bbc31bebe38,Commercial,0.45006427932985427,35,9,415,708,293,83.5801851244025,2900
0619f301-bfdc-47e6-b96c-1941843dd861,Healthcare,0.4969113986320647,1,17,565,1051,486,35.221614556617084,1202
19964753-a281-40b4-b2a4-b02fbaed65d5,Residental,0.8112873347234902,33,1,162,477,315,58.13340681137706,6703
a5d2979f-f03e-4394-8afd-9db6bd49cc04,Educational,0.6866576358206795,24,20,432,803,371,21.66897773905476,1674
d0719dd8-ef83-4b12-9991-70b160c90250,Commercial,0.27726576489265276,46,17,183,1220,1037,93.35518338956331,1525
073f8399-7766-4c1e-825d-2c68e774900d,Residental,0.7501506348763489,9,16,187,452,265,94.02713040944941,9526
2b171bb4-1f3b-4a87-97f0-1ed35bb6617d,Healthcare,0.20059188769487168,14,44,260,1270,1010,85.0604338098511,5818
4a19a3ed-da09-4cc8-b2ea-dc36db127c91,Educational,0.5630436749112722,14,20,699,1263,564,98.74016645365072,9410
6717e572-d802-493e-bcb1-47e43d8841a7,Commercial,0.4304395569960807,22,32,368,1352,984,97.56162660557864,2438
e8996c2d-5535-4192-b3aa-2eb485a910a8,Residental,0.23230815298016294,22,34,151,609,458,92.54069107926654,9683
3c3b6266-b46f-4293-bc7e-2c0d1595bbb7,Educational,0.8620105531413603,19,21,317,448,131,14.132051880332341,7707
85b8f7e0-a7ab-4bab-9e35-b706f7bb6b6b,Residental,0.056675546223674544,28,23,227,405,178,74.75927267692761,9533
c84fd8f4-a046-494c-aa5a-6b818557e1f3,Commercial,0.02881320799681797,20,17,76,677,601,86.55120100430878,9397
c8fdcfe7-ae85-49d9-88e7-cbf20f21eb34,Healthcare,0.5845402168238053,31,1,436,1400,964,17.83548947846166,9051
0fb93e1a-5206-494d-8841-984ffe765e8e,Residental,0.07292504057576876,23,8,72,1409,1337,54.23729961661603,1101
16eb3f7d-4840-497c-9d10-a3135f9e677a,Residental,0.5334536506773815,41,38,355,1027,672,98.9788703598492,7200
29a51efb-7a48-46df-b92f-86bb8d183305,Commercial,0.18953657881502717,28,18,327,898,571,10.400060618633995,6011
d7579268-9917-4c25-98ca-95ac133a5f21,Educational,0.3135038912822389,22,12,328,820,492,65.28665750656641,7572
de524d10-fa9e-4f4d-be83-8aaae32f567c,Residental,0.8760438361968864,33,25,276,1158,882,45.12811294049786,4004
1ea280a9-6f6c-4eda-9936-853a6def620e,Commercial,0.45421129260478277,47,23,81,508,427,62.19871794485732,2816
6cf3d004-4503-48c5-887c-09a0a6623af2,Residental,0.8866894594432915,47,39,82,668,586,34.567721443823515,3130
876e18f6-a341-4081-a6d9-90551f9fc3b6,Educational,0.4445362545912003,3,38,719,932,213,82.26587388040664,8454
ca60635e-9eba-4d30-bf8a-0d6ef50a67bc,Commercial,0.7139855078775027,19,45,409,654,245,94.54468743467653,5813
3bbec8ae-2b7f-4ee9-ad27-c617c75f144c,Educational,0.9308864956745856,4,26,403,1290,887,61.287431039859754,5474
7ea8a567-bd74-4e1d-b11d-21a58421d34e,Healthcare,0.15240962191215346,37,21,519,916,397,69.32838554387456,9245
618ea533-c693-4215-8e55-dee17f43d14b,Residental,0.6502764236387326,6,22,250,1295,1045,46.432387608456644,9885
7ac29584-0118-4a44-8ecb-fdaadf42695c,Healthcare,0.04313345162570781,6,5,108,792,684,14.483958675256243,3284
baa8458f-9daf-44b5-8ec1-7358734ab7cd,Healthcare,0.43087486525746144,43,5,669,1136,467,29.530975443830027,6901
d6568309-7009-4920-963f-4e4e4a1397d3,Healthcare,0.8788786605331884,31,40,522,668,146,39.826585258201696,8880
34a4112f-ae8f-47cb-8e23-ba783d7aec39,Residental,0.8703467677788205,34,8,243,276,33,26.649306117662018,9941
7ba28762-3d90-4695-81ab-4fb4a6393ccb,Healthcare,0.6869831971162681,42,20,422,861,439,17.813909938987994,8111
1c04f059-4997-434d-be66-78655e4934e5,Commercial,0.5975166424024615,19,28,230,838,608,41.38943071981913,2410
6ff4c2a1-33f0-4f15-9de3-42ffb56f4585,Educational,0.6019214963568228,42,11,713,1428,715,46.527373397402876,8635
97937af1-d193-472c-9187-daf0c5dc4761,Healthcare,0.9213752064190169,33,40,257,387,130,13.81037001832522,8171
d307197f-b347-4779-8f4d-99400ff05d6a,Educational,0.13235842215424398,23,18,9,589,580,50.386949187503795,4548
afcca0e2-224e-4033-8e27-7ca1f82fef78,Residental,0.2675936943777091,19,5,2,781,779,83.31189558048361,7150
9f1d8dcb-76fa-409b-8e65-623e8bd96c6d,Healthcare,0.801112858338242,36,45,253,471,218,95.59614360277473,7048
29d690ad-0888-443f-a77d-5335355d8635,Commercial,0.9937674686034159,16,16,437,681,244,68.02709083430717,5853
6fdc7155-24fa-4b1f-83ed-748f7e07753e,Educational,0.5347087132025857,36,16,657,673,16,29.209865620721047,3290
c0a87c6f-c348-42ed-9698-0d0f720de928,Residental,0.8033742600824383,35,35,647,873,226,46.28460634720676,4596
87a2f91b-ef55-49b1-af71-ec42f17d8cd3,Commercial,0.9364501925317323,19,34,28,337,309,81.80481193876815,9445
45f0e430-dac8-4c09-a096-2921791ee35e,Healthcare,0.34457422829096895,13,4,148,796,648,29.537172121594,5196
77fcbc53-e047-4490-80c8-3ab21fa616e9,Residental,0.8023811626692169,26,49,71,74,3,70.98198197037149,1307
822aaeef-dc90-44e3-b68b-0eeac41f9973,Residental,0.5054577308787871,13,44,305,1186,881,58.12266090107447,5743
9149838c-09ec-4844-aee0-a7e8476dcce3,Residental,0.8725313039342196,30,11,135,1085,950,87.54696123533405,4055
1b9a5f53-ebc5-470a-a857-21c9002ebea6,Healthcare,0.47486843719856286,23,50,702,1048,346,84.72283786622897,4678
afe98d30-d5c0-4e04-a637-abcc82f1f95c,Commercial,0.13175571573903933,22,22,42,134,92,97.41653506954349,3635
549dd964-cfbe-482e-a31c-c1d965883eb9,Educational,0.07881796145982456,44,23,317,697,380,43.094017055945756,2805
40540215-4fa7-4317-a209-660679b3642e,Residental,0.8540836118908812,43,41,449,898,449,67.77235283230216,9333
b8a1c69d-6ff0-478a-879a-03b9f54007e6,Educational,0.24544845469191212,31,47,481,1328,847,31.303727417766513,2123
87ced685-2a83-4a17-9222-6725dc6465e8,Healthcare,0.5538641679194936,50,39,714,884,170,53.44525281493132,3463
c78b2872-e5fe-4b42-82b0-57b771d1068f,Educational,0.6391024155350632,22,43,328,1245,917,33.57547139587905,2062
ae77d224-a2db-49b8-9cb6-b492b760a8c0,Commercial,0.9643994313888232,16,11,639,1030,391,89.89005427429433,4736
87f3eab8-4c2f-486f-897b-d1e4b816c57d,Commercial,0.0569830187005993,42,29,123,1117,994,46.432376965252956,3987
cde42fdf-193f-42db-b11c-aee6e6afcb56,Residental,0.5657401540090334,43,39,700,995,295,55.44886216462599,7243
e300e0b8-4e8a-412d-bdf7-334b82a55998,Educational,0.39129465052018486,24,29,439,1387,948,94.99410177264775,7611
d6e0540d-60e6-4f08-8bed-30a64c87f3af,Residental,0.6567465909807939,33,22,63,952,889,34.06392052545141,6277
94d0ff78-515d-4f6f-a6cb-d161a0ebea89,Educational,0.8659260342143417,18,2,385,723,338,23.293491201179435,5066
02016cde-a89d-49f3-8d9a-1d92d8300238,Commercial,0.07142198257603771,15,33,114,874,760,75.6836988313807,2348
9e20a15b-6cce-48f5-82a6-c267d366da93,Commercial,0.7319853540851058,35,39,284,326,42,91.9828207851251,3423
0f3d1150-d5e2-4d5c-b796-8c9fd997d2c1,Educational,0.026381183528399577,35,4,561,1120,559,11.0332600879862,9980
0366e5f1-94fb-474f-92d0-47ba1c066c6e,Educational,0.9379675640008999,36,23,632,1301,669,27.811961444884744,8233
735518a6-264c-4bd3-8658-d5cf8e80b75f,Educational,0.7896267294824019,18,6,579,1190,611,75.44099795101647,2386
e7f5a652-fd66-4a3b-9892-60543d82b386,Commercial,0.1738966352518969,32,38,242,1212,970,87.56889694780259,3473
ca614eb9-6634-4a59-88e0-cbdb96524649,Commercial,0.5380894978712405,38,17,488,1156,668,59.35431292445086,6554
d4599bab-c8a2-4198-8f86-cbfa19056974,Residental,0.4609128366364408,4,21,390,990,600,23.505861019772546,8392
91d1a67b-851c-4914-998f-26eff06ffad5,Educational,0.51940480383065,15,1,716,972,256,10.142868184245437,3618
e54af478-58b4-4e40-b177-6399ce521e2b,Residental,0.13504157959431407,46,17,701,1422,721,45.34121779289558,6883
5e0ca17f-9854-4a7f-9236-1aea22d73cad,Educational,0.010198453211579528,33,10,267,484,217,43.62050359118446,8987
38edd6cb-2b01-452a-af97-a938514d735d,Residental,0.42282076308298633,5,19,559,980,421,55.37744590243057,2619
51197dcf-1c66-4cd1-88d7-5654cf6d68e3,Educational,0.8490528175555883,40,4,360,905,545,41.68384543878274,7141
c8cfa658-301f-4ff5-b434-7e6f2dd05c52,Residental,0.9635418075314878,46,39,383,715,332,38.49517798205207,5442
8ff9befb-1c4c-4b54-962f-4ca4897cc701,Residental,0.4585500771749855,47,19,109,1122,1013,72.99958583263765,6351
f60da891-4ca2-4b21-9143-a1b729c84c25,Educational,0.8866315367865957,23,2,429,1092,663,86.39247352116548,7068
3555e9cc-077f-4874-a013-20d512900fcd,Healthcare,0.10805402173742984,49,13,38,511,473,64.16668125695837,3573
55f4da2c-02d3-4bdf-90fa-a51aced5871f,Residental,0.6377168751893841,23,10,529,574,45,83.14843770027595,1285
3d66b664-5951-4175-8781-6ddb52e4bfb2,Educational,0.9193396741499719,5,39,612,681,69,17.340337923574317,9567
7561b35c-6509-4bba-a56e-f76213db5572,Commercial,0.9538184553688517,37,30,332,779,447,41.28193046531254,5564
f5d9546d-dc38-43ff-9f10-a962170df700,Educational,0.11072826477866993,47,21,600,1069,469,87.6166014478094,2196
a0667e83-8b4b-4742-8a11-2b52123616bf,Educational,0.92863490146294,1,5,102,1257,1155,81.95386385515059,1436
4dd78d6f-fde9-48c1-86e0-42e1f9413058,Educational,0.7486278358599199,1,43,338,845,507,99.67687550533256,4306
809d486e-1c0d-4687-8d83-84a28794ca83,Commercial,0.47361787684721124,33,23,7,1192,1185,41.93430500926587,2687
99f2b4f4-ab60-40d9-9e9c-a2b554223f17,Commercial,0.11782266783893425,35,39,530,902,372,55.65401570618338,2428
c9bf2aec-2925-4576-b055-ff60be94c423,Educational,0.34368091603968387,36,30,112,562,450,12.299538255787905,5557
adc2403d-62c4-4a6d-a551-29d1b94a3c44,Educational,0.8793463336237533,45,1,37,1108,1071,29.752974479250465,5049
91bf3531-146b-42a3-be3e-ac24c607faf5,Educational,0.3272961704773456,47,39,170,294,124,18.18422364216174,1610
24089669-d001-4876-8e6a-e230f41608e6,Educational,0.4687269899171661,42,2,391,832,441,44.09168250586339,5706
07fae3dc-2696-4af0-ac4b-1a1be76dd763,Healthcare,0.5664890457354027,42,26,719,819,100,54.331398442431535,1687
e2907d54-12b8-4ba9-bc33-f49894f6616b,Healthcare,0.6973051601971968,16,16,30,875,845,25.04799797180432,5390
22a4409b-6b15-42ea-9e33-b93838bea6f8,Healthcare,0.6398175622270726,22,39,530,846,316,76.99198004542637,2971
72aaa155-9a75-4f19-b168-0c730258e5df,Commercial,0.7499389443481056,21,2,475,629,154,71.48616309163475,5188
be57f5d5-be4c-417d-ae10-64e960b50d48,Commercial,0.7217854407096398,39,41,433,1046,613,40.95905831126226,3696
c04132d4-0f00-4efe-bc1b-5e7473bee149,Commercial,0.9359045158502162,7,46,609,1401,792,20.577300643971416,6288
1c4ec624-9076-4140-9070-50c54c2140c8,Educational,0.2945159989942424,46,32,193,1174,981,73.23442401835192,6803
c2085f5a-b251-46a3-b190-5a895b450143,Educational,0.4709350948553356,44,10,465,1043,578,57.12633566105665,9584
8afc12bc-c6aa-4610-9584-c8466c48ec54,Healthcare,0.5481503493397962,20,36,2,1243,1241,97.6126114234883,5799
a528edf3-7c82-4272-b36c-49c29e963ffb,Commercial,0.3863623597079505,7,14,196,1014,818,20.518038271559192,7102
aa80cc78-090b-45c5-9567-40dad1e271a5,Commercial,0.5591567161963071,48,34,383,895,512,57.221816764223945,1572
40c834fc-082d-422d-a3d4-a709ca17b272,Commercial,0.6037487454519528,18,9,439,722,283,84.83355868664196,9498
201dc499-39cf-452a-842f-3857967db882,Commercial,0.8482262136687098,8,35,422,528,106,69.03702755663505,2633
591e725f-be6e-4c4f-8e28-040bbb939b0f,Healthcare,0.6983893694342718,26,25,170,471,301,57.247149537191895,9707
dbecf1b0-f4e8-4c1c-ac25-0413365671a8,Healthcare,0.20821103525724582,9,42,642,798,156,58.67561002935464,6283
1593b456-e90b-4609-ad2f-3ac35d8b5760,Educational,0.5315123327110731,39,37,16,444,428,28.400129120170206,1877
d5675451-de9d-4c2b-874f-1d16eb79327c,Commercial,0.5331715688513013,18,47,388,845,457,25.444229671326454,3527
b8d2e432-e172-4752-b5cf-f021c598c34c,Educational,0.8897212254284789,29,38,258,408,150,83.12875917971365,6145
b576109f-6639-4aac-97b0-5d141069e4b4,Healthcare,0.07017659747885541,26,36,719,1278,559,22.112736568424303,1581
27fe25e0-c678-4b1f-963b-923045e5174f,Educational,0.9737656806798575,21,43,650,951,301,56.567615958668775,1833
1064eeb2-a2f8-465d-9136-a2a70fadff17,Residental,0.042415258017981405,26,40,152,218,66,44.99927202816446,2542
336615ca-c380-43ae-bc6d-224b7bdccf53,Residental,0.22549667120148764,37,29,260,726,466,60.525882844956264,2329
2cd61d6a-90c2-4cdc-9451-6e346503d365,Commercial,0.8967380904024023,11,5,222,365,143,76.32861432367683,2642
7929a9c6-3707-4148-9787-8d589a753167,Residental,0.0031843056408908943,33,48,309,778,469,46.79936035547076,4307
24e8c313-0752-4908-a31a-12fa42ead1c3,Educational,0.3216813678461393,1,15,217,863,646,53.52996458105651,6262
58faac80-d396-44fc-b016-3bbcaef248c0,Residental,0.6339895389681752,15,39,591,837,246,59.42752528951998,1417
372dab70-f0fa-4438-a6fb-f9ddc2e67f39,Residental,0.746945178188397,16,2,385,776,391,20.155220657728748,5660
c80dab78-0f3a-4de7-9480-7cb31f1459cd,Educational,0.9448657856669557,47,5,231,993,762,14.570809732644948,6920
768789da-013c-453a-adf2-82873aa2bdc5,Healthcare,0.21467003734807322,28,16,105,469,364,80.48911162914193,6141
fe2b18d3-fa4a-4a84-b4a3-c05b7a9fd72e,Educational,0.8012556731092043,45,27,520,628,108,41.705894911955134,2475
0bda36e3-9376-4ac3-9b3a-551764ad7c70,Educational,0.07235677041965405,49,6,278,585,307,40.6773808872874,6914
e3d90232-e746-485f-9b99-5b91cb342a0f,Healthcare,0.2164187237992119,33,21,42,1002,960,34.5648403330611,9529
4e651db3-ff61-48aa-b138-bd47c029141d,Commercial,0.4394666311362745,49,6,55,1013,958,34.8228382928992,3208
7816b8e9-476e-4799-9185-1cd32ed28d4b,Healthcare,0.6933464094742807,34,6,243,990,747,12.865049949825309,5860
fa5ce3da-2b68-4d82-b077-5b05712fa192,Residental,0.1853253011917939,34,5,121,670,549,95.65811491667449,8762
0ee16983-6542-4500-b2db-49b3e2f74364,Commercial,0.7453867125036024,35,25,392,1118,726,48.762845696567624,4051
2e372c96-b1e8-4e2d-af78-e0fbe9f6d80a,Educational,0.09202803802455028,14,6,143,761,618,59.43957586842665,6292
02c1a402-11da-4f9e-8fa6-a6ea66b2fcec,Residental,0.8464897860377016,38,45,564,1081,517,43.34022798893403,3515
aa1ca70d-da13-495e-bc69-b0ddbba79fab,Commercial,0.40472199724810487,20,43,552,1151,599,36.89164898797614,8562
34ee9cea-91e4-4d30-877b-5f7c3148baa1,Commercial,0.35302644110566983,13,14,453,762,309,10.02550134634944,4416
a03e6f85-97d5-4e69-969f-dd80b97d2a84,Commercial,0.950630086636186,42,1,638,1359,721,50.84439270751203,9263
1b8be7f9-60b3-45a2-bffc-68d2a51c9d22,Commercial,0.11806390977198455,2,12,401,540,139,99.67112470426895,8533
09c8f07d-79ee-415e-a3b5-19c99ee354f1,Commercial,0.537798872405113,14,49,381,997,616,15.850081581073571,5741
e4fae2b4-850a-4b4c-b57a-861fd1a0dbbe,Healthcare,0.6655895154209038,13,15,127,1057,930,83.04687512127221,9130
a31b4925-a00d-4490-9522-58645cd6610b,Educational,0.8453085462952884,20,39,625,1084,459,39.960568141006306,7847
35721a58-c4a8-4c60-b989-e6108112a093,Residental,0.38621974508707557,44,5,271,446,175,95.0144173385587,1749
c408a1cf-edd3-4c41-9768-a953f80e84d8,Commercial,0.2607305302670596,12,29,463,1143,680,94.98463129816277,7030
9613d718-b2b9-4f7d-b460-79909a3b7596,Healthcare,0.7759663492583183,45,29,594,897,303,38.02696864686138,4756
bf1fe503-ffab-45c1-8228-9bfeb9e3b6e7,Residental,0.5900960284096495,3,17,435,880,445,33.256755676046204,1760
ab3de8c3-ba61-4d97-b363-28472ce66dec,Educational,0.20526694422335923,26,48,175,191,16,95.90773628831951,2443
29a34d4c-958b-401d-bb52-0e9e7327c3db,Healthcare,0.09064685576803466,2,28,710,735,25,54.50236159600389,8688
b820be97-ff47-4174-b71d-7b00403fc2b1,Residental,0.9434507536592615,21,10,601,620,19,68.86070262258426,3957
46627571-d52d-4714-af1d-3c126c9f44e6,Educational,0.7576379825978763,48,47,48,480,432,28.418115740674292,4881
a5125314-ffbe-43e5-85cf-8384718ce162,Commercial,0.8577828263197996,41,12,292,676,384,12.026240167805407,2082
c90dcbdb-9500-4bfb-b56f-926da4ed36e8,Commercial,0.7910576061918463,26,10,97,1332,1235,28.683978033195196,3632
eb48de66-06be-493f-8364-7c906b5b521a,Residental,0.849428065154062,16,50,474,679,205,42.326383067214095,9798
11b64191-4c49-4d3d-9353-0287c7d8bfa4,Commercial,0.25102276456858197,3,16,467,1427,960,79.0962807812296,1584
21a9529b-567d-444b-8ff9-11d14b941bae,Educational,0.7468722373212188,18,35,33,361,328,58.931589063355375,3643
ded467ba-eb46-4484-9a2f-92537f5c925b,Educational,0.13708939500372974,29,23,514,1137,623,50.682109650618834,5955
ecb14430-f8ec-404c-bd3f-f13a078c2199,Commercial,0.4909671213289354,27,34,346,348,2,51.928659436312735,3957
b6602bab-5990-44bb-ba13-e75568be2c73,Commercial,0.6610884248822728,42,48,410,454,44,29.25961230930587,8741
39dbd9fb-e431-48e3-a8ba-2825af4072ab,Healthcare,0.617600680974253,3,49,478,1058,580,99.24019304195775,1836
577dff3e-cd8e-4f9b-b8a6-363f09fe1ec3,Commercial,0.9543967244703534,13,17,605,767,162,11.463020646860274,3707
48c5c302-b1e1-4683-a084-a66575f8a369,Healthcare,0.19815343497429672,19,26,412,609,197,77.09804475140369,8736
d79cb888-1455-4dc7-863b-83ba51bb0d5e,Healthcare,0.7422608074442113,39,2,99,1331,1232,89.37228714017405,7453
3e15ffd1-611a-4990-b3cd-71a80e123ec8,Healthcare,0.46297691983199063,34,47,186,1112,926,86.17408638188974,7273
d373ea8e-0370-4574-8fe8-dc3a21df384c,Educational,0.09765867781374005,40,26,180,1206,1026,14.80063480140835,6437
f6088d66-3766-4b7f-a304-402c217439ed,Educational,0.622424829421775,42,22,669,987,318,34.95506174493566,2967
9737be78-8761-4913-8222-e77372f57389,Healthcare,0.7666395770273449,28,34,98,913,815,85.97091260446233,8705
87de2303-1d45-4ac3-b6d9-e9f7914ea591,Residental,0.1420661303567773,1,37,581,811,230,84.10309147426541,3786
9e6d2cdb-8e67-4c11-94dd-1714d5bb29e5,Educational,0.699960134365333,15,10,711,824,113,87.70477709015783,8323
142f0bc6-7b6e-4d13-9fd3-9054fb64faab,Educational,0.9431678748601329,41,17,219,237,18,60.313937553677405,9078
6cbf1026-694b-46b5-a606-02a21b9ca428,Educational,0.5529666130785243,14,11,230,1232,1002,87.4033949831419,8880
c9279593-3791-49c8-b01c-b76a93dbca3a,Commercial,0.8492102510541139,3,23,640,1285,645,21.475084974832026,8202
dd543114-178b-44ca-b1d2-eeaa00b91732,Healthcare,0.6152577048194852,9,27,156,1003,847,25.124894321775074,9922
819320e6-487e-4dd3-8ae4-a35cee7d9ab4,Residental,0.7396658291098759,14,32,31,575,544,73.97176280364042,3940
bf31c5fe-65d3-4146-bb07-2c07784eec5f,Educational,0.6248297143291216,1,34,167,676,509,75.88201704463746,5230
68f37e38-7a93-4d6e-ab56-fabf3091dc0d,Educational,0.2803377352739628,21,9,344,1253,909,31.71294457360352,8611
8573e64c-246d-4bf0-84e9-2232eafb0dd6,Educational,0.3736281924143484,25,27,622,796,174,24.919401572229205,1611
7f8b9d7b-d38d-4340-86af-20e09078003c,Educational,0.7519904392262726,11,7,437,773,336,27.61929412758249,7952
04471613-b62f-41b0-93e2-e18dff9adb40,Educational,0.22796077000666182,26,35,57,1215,1158,30.797255108088237,7865
f9243737-f16d-47dc-bf3a-443cc272a8e5,Healthcare,0.8717862042184772,23,6,191,866,675,26.52050949811769,8645
b2ad92be-a8cb-4ddc-aff3-2187200f1b49,Commercial,0.9144918143154754,34,14,720,1416,696,53.15167151066064,7368
8f2ab998-8e97-48ba-918b-2b61b8460057,Residental,0.45740262655178376,17,33,702,1224,522,20.84895338594273,8814
ff6128b8-66ef-44cb-9c62-b1b6311152ce,Commercial,0.9576022466486568,36,5,383,931,548,11.717271573822698,9084
20a643df-82e1-41f4-9e5f-ae5f729f7d3a,Healthcare,0.33831766531757124,46,39,577,628,51,43.94136682045052,1391
103fd46f-b38b-46c4-95b7-1768dd7de580,Residental,0.7764902393747098,14,45,268,809,541,65.26238687024207,4344
03133d67-b91e-4e6e-89cc-7f43b9428c6d,Healthcare,0.1441471050805122,22,36,188,1281,1093,88.5623219463317,1930
d00ecefe-f427-4358-abdf-2fb77a5c7c4e,Healthcare,0.4820657602999704,4,13,669,677,8,69.2688139516723,6562
47a5eef5-5a8d-4163-a4ef-7bdc0ded7c70,Residental,0.11590384768387763,46,23,652,1296,644,91.61703364751858,7027
6e303d21-9304-47a1-bd1d-48f778c2e619,Educational,0.26143099789778956,20,40,336,1436,1100,91.51070648648287,8711
d361863d-4247-44c1-a000-1360e9618ecc,Commercial,0.3690463864833343,12,32,336,647,311,86.23737247509447,5667
4bdd7855-da49-428d-a6fb-578ce04d60e5,Commercial,0.551080436219763,14,30,434,1397,963,72.26621117227542,9722
6650cc42-86e0-47b0-8edd-36ae6c27f691,Residental,0.1496680197216893,19,8,627,1095,468,57.97531314319274,5143
25f1302e-a64c-4539-b9af-c1c17b2c7ff3,Commercial,0.6442686473569096,4,23,327,1105,778,47.60961479602193,5385
23d2d9a7-7acc-4280-b37d-dfd57e24e70f,Commercial,0.4899656097667149,13,36,651,1200,549,49.88887180325229,3316
bfd0ab62-43e7-4392-b489-dcad9fcf4ed7,Commercial,0.1467759853353442,3,35,86,369,283,71.59242412390728,8836
547c8399-2efb-48ac-b19b-80d8ad34b647,Educational,0.3116758290541919,5,48,213,370,157,96.50076705490406,2457
48eaf331-f3ec-44f3-9762-b89241059020,Commercial,0.44425323832525576,34,19,585,1344,759,68.67226414644315,8531
0cdb958d-7058-46a3-bf2c-8c412bdc0934,Residental,0.5692239700344179,48,27,525,1289,764,26.021929890084305,1719
357e28ac-7914-4759-911b-6dc188b87c23,Healthcare,0.8020513354356189,39,46,40,352,312,95.40834110843008,1899
e3a88213-7b4f-4aa8-b792-1f78733db739,Commercial,0.2025150579032008,18,5,158,1133,975,73.6876010706348,5593
fb156d1b-3110-4bbb-a4d8-265bda56fd34,Educational,0.6396403377253067,25,15,348,1231,883,16.46329643798852,10000
03ac61e4-1e35-47b3-beb1-7b44bcad7cb0,Commercial,0.688494991948393,16,3,699,839,140,13.425393261218206,7529
a685b691-4a8f-49c5-aaec-b30ddbf345c8,Commercial,0.9492845185444153,13,20,243,1159,916,42.59394769920396,5092
be2640d6-27a6-41aa-90f8-7b2818149dc9,Healthcare,0.2191990077068927,49,44,439,932,493,44.4898029178014,4637
2354444e-2e56-4553-abf1-924ee03f97ab,Commercial,0.03082989915645229,27,15,70,739,669,12.709927799189249,5614
de38833f-d974-482a-bd3b-f1002eb1a244,Educational,0.16443620187024377,48,26,236,1043,807,78.12061835547271,6522
cbaed04a-4bdc-4e9c-af43-fbfd4e4a5736,Residental,0.35308583100448965,23,20,205,309,104,47.08616951572318,7454
06f6ae11-ebee-4878-8dce-7f68f684ceaa,Healthcare,0.2684903726758635,17,17,413,875,462,65.88089443389052,1819
4151d2d6-20a2-445b-990f-4753cd1b46f3,Healthcare,0.5984495887908667,38,26,77,853,776,54.25796222658808,1930
027dcfa6-93a3-455c-8b7d-48b427107389,Residental,0.7940229900092425,25,5,377,874,497,35.485794414390085,8642
90bfcd9e-2c6b-42c8-9c40-86adf57a48ee,Commercial,0.2138525865031895,48,4,296,1016,720,46.607830452046464,3723
06d5742b-7441-435d-94ae-2b7b62fdbb69,Commercial,0.6477160617589891,35,5,157,449,292,68.76710669965198,7450
1b1ea28a-0974-478b-9197-ee37bbd5f92a,Educational,0.8335469175311905,39,38,209,434,225,95.69081751783428,7747
b48bdb19-4c65-4f37-8b9d-147a06dfd7e0,Healthcare,0.5134615322622965,20,28,528,864,336,39.428240970316864,9784
e3b3e51e-b8aa-46f0-ad5f-7492cc6f178d,Commercial,0.45680017183292176,37,44,175,584,409,72.15403911778739,4031
3142acdb-302a-4240-9f7a-960d485e5b32,Healthcare,0.023894108159405847,25,35,478,1405,927,10.82500709190836,7886
94200ad8-277d-4ee2-b4c6-67d86c26f5c0,Residental,0.6907366164131402,20,8,184,684,500,95.31901090717797,9096
b437fbfc-3707-426d-b146-0457ddb25581,Healthcare,0.7362480480926891,40,32,101,1038,937,95.65848963668185,2006
acea9ee8-3b90-45e0-b04d-6f2e9b6c7140,Commercial,0.24063918787282734,43,34,110,1388,1278,95.71207095416801,1917
d47f34c3-a3b1-43d2-be62-742c2280a616,Educational,0.07268370954899683,12,48,209,992,783,93.4571191983468,7103
0b881fe7-f740-4352-835b-5cc7816b84ea,Commercial,0.11322378099976538,6,7,519,1422,903,56.18084279997099,9564
cd8611e9-5349-4eef-9c16-8a97fcffa927,Commercial,0.172476337560595,46,47,538,1293,755,58.855551654061976,9711
55481885-66e9-4c6d-8706-080c8ebc122e,Residental,0.5203796338546235,7,39,311,458,147,18.63925046365526,5584
397cf654-6c7c-4976-9dc8-584931421a6a,Educational,0.16106792486599564,37,34,720,1437,717,31.77600950977649,4232
002ce7a7-b1f5-45f9-9001-f181a274d6f4,Residental,0.20112514957874505,30,14,348,1283,935,89.72380919190655,6728
579ce045-d2e2-4a86-b470-9cbd8bfa7410,Educational,0.7830224831979592,37,29,613,779,166,78.23972573384505,5576
5b31f63b-306f-423f-9d37-fe1ff148c2d5,Residental,0.563727619632262,4,39,194,237,43,24.682505713809398,6199
51fdf95b-fcd0-4de0-ae2b-6faa9e3ed53e,Healthcare,0.5483737401110844,43,31,268,1045,777,94.32739701926621,6241
5effefea-5c81-4827-8d38-ea730d6b9f4b,Residental,0.3808428138096611,16,43,125,273,148,49.08884591172204,5623
ade3ca97-fcd4-40ad-8382-e66ba2cccf15,Commercial,0.31821031487684215,20,42,688,1032,344,87.69184319924292,4601
a72f91ad-f96b-432b-8205-a3356a8ac0d2,Commercial,0.3260427519990948,27,49,384,716,332,24.387778143768777,2312
3897dc4c-ed0f-41b9-92ff-57d82e921da4,Healthcare,0.7124546074983765,50,23,121,1332,1211,39.39007985460488,8135
7a5adff1-cb68-4816-b3ba-48d3b70c1bdc,Residental,0.8059156354373935,40,44,281,305,24,53.38700813792402,1684
4c7e8cdf-8ecc-43cb-8d41-dff90d09a69c,Educational,0.3125428363006505,19,28,632,1115,483,21.73187494337158,4743
e9de80f4-d66d-4942-9d6d-1df6ddd6d747,Healthcare,0.46149736413575415,33,49,256,539,283,83.47649020260636,6723
adb71905-dba1-4898-9cc8-bc4e96437cb4,Educational,0.32937795743505205,44,3,623,855,232,59.100143695054626,6195
6a9bd851-33a0-4dee-bc8c-0dd3398399d1,Commercial,0.17811629805356466,17,32,225,457,232,85.40720721946133,2485
6a22a4dd-b90c-45f8-8920-6a90c4b45153,Commercial,0.05320734680768924,15,20,534,878,344,15.926592327903329,8297
7be91cff-f517-44ab-a6a3-7ade38c33cf5,Residental,0.8155827615002526,44,32,366,574,208,13.220057947911851,5320
7a92f0c4-48ee-4853-ad93-d6d2117279bd,Commercial,0.8250326764278899,17,24,288,683,395,96.21847948131693,9349
53d82c91-fc57-4c3d-9fd7-f7e7298e4497,Commercial,0.749822665178818,35,21,444,687,243,39.46769033294875,1893
4ae4a15a-493b-4d8c-8c5e-814e04902e52,Commercial,0.25290359820147335,18,30,106,1125,1019,15.550310221441073,8743
977665d2-4286-4c19-80de-d2f5aab6d536,Commercial,0.4244963506364565,8,11,432,877,445,97.52428656892117,5245
de9b572d-ee36-484d-9c00-337bb938e675,Educational,0.6814299030460764,45,41,669,674,5,21.997690028431713,3360
45599f87-46c5-4b22-8a27-6b3125936e09,Educational,0.003814878832408053,48,17,67,417,350,25.020261014118944,6639
a94e50f9-c0b3-4005-9a47-88204d1832c8,Residental,0.9885935828379766,44,50,473,1111,638,84.90473990328381,1943
d3e3751c-e506-4589-8dd1-67dd4095e654,Residental,0.6802530953016825,40,39,642,1198,556,93.9558376109398,2605
47127dff-295e-411f-8462-ecf0866988a9,Healthcare,0.8365953542678687,38,25,113,844,731,51.605989012263464,2082
1ae3128a-96fc-48f7-a20a-d765ac0249c3,Residental,0.9335381069378467,7,16,201,1002,801,84.46061567845464,5926
f97bc99c-c44a-408d-854a-999720f155b3,Healthcare,0.3192939277294341,37,12,411,941,530,49.57566091295871,3371
6505288c-c8b5-4f6d-82bc-7c1920d4ad87,Residental,0.265696236944296,23,40,130,679,549,28.41759726275616,1893
8523cf10-273e-4e71-b84f-866d9546873b,Educational,0.06290226937845722,38,40,690,1399,709,42.82871461840795,4244
585280cd-cd80-41ac-90c4-ad1d8a5a6953,Healthcare,0.9316740222244798,41,13,236,606,370,97.55141877800155,5108
fb10e0e9-591b-4ee3-b6f3-246180355616,Healthcare,0.7021169680100308,41,22,683,1069,386,27.20923207586085,4430
154d26af-9e97-4aef-9070-701f217e3dce,Residental,0.8126397372212032,49,1,550,794,244,45.341142632588394,6536
90b216df-837f-4394-8a14-e4ea08b1bdfe,Residental,0.7865665798325682,22,2,232,871,639,32.2240211513769,4673
333af9cd-6eaa-4665-9564-c8dd6ad9cb93,Educational,0.6611508562818971,40,17,125,864,739,70.84222420129882,8662
5e546d48-7d22-469f-b847-298c75f7e86a,Educational,0.8533631514462213,4,31,399,633,234,12.507854690110392,8029
858dca4e-0df4-4981-b8b2-17777c4a6a04,Commercial,0.8387166646157774,9,15,630,1307,677,84.29318061256797,9661
6bfb5464-4dc8-483e-96ca-c0924dd019d7,Commercial,0.6658572270313201,15,9,427,1376,949,44.55049275233536,1933
c6736f39-56d3-4316-9e2b-6f5895abf956,Commercial,0.5129189841176452,21,7,559,574,15,44.771217247618026,3667
2d4afc4c-ab30-4d04-ab1e-d7c822923998,Commercial,0.8316001652278633,38,9,407,1395,988,92.62210845061779,1150
887160b4-a59d-488c-aaf1-3d86feaa1149,Commercial,0.6036208441424148,44,49,670,1295,625,45.327086485909454,7393
6d5b5914-f526-47c9-a49e-f7bd511df2ac,Healthcare,0.09027849029024915,3,42,304,1080,776,99.49263012890374,3328
cd507a8b-e784-4414-9328-b6347304af17,Residental,0.9430546772817922,16,44,693,1282,589,27.495556429969866,6249
6a0b539d-90e6-485d-b5a1-489d5c7762b4,Residental,0.16400368375052676,7,28,687,971,284,82.71980705622732,3700
9dd01cfc-5c2b-4109-9cce-5d2a39f85066,Commercial,0.43168827528694176,34,42,350,396,46,84.08942503874157,5825
ecd9401d-869c-47d1-979c-943756793f0c,Healthcare,0.012360858605729885,2,15,71,114,43,45.288210090428734,2516
cc84ea9d-977f-4b30-979b-0361347939b7,Educational,0.5477364589444773,44,37,316,1165,849,72.45422684691134,7757
58d9783b-41bb-4ba0-af30-52e76973f6a8,Commercial,0.6082476276921387,17,40,495,744,249,29.334815410547467,1392
2fccb4f0-7ad8-4bd9-9b42-d596cb20f955,Commercial,0.7474261632304334,37,44,711,1088,377,85.90420428626472,5326
37ddaa2e-e89e-445b-834d-c1f2bb9635d3,Residental,0.9210089615293022,13,37,56,657,601,53.98468621259346,6041
a80306ef-e53d-4685-a902-374e8238c6f0,Healthcare,0.8839495152622843,6,43,289,304,15,27.215128229431873,6736
e695896f-ae6d-49c4-82f8-0f827cad0872,Commercial,0.9739785844500511,32,34,52,142,90,73.49609123790209,4563
8cff80ce-64de-45f7-8072-c08cc7d11ba0,Residental,0.9504919236422872,22,21,441,658,217,88.58756119184363,1108
5b48c553-9bc4-4984-a828-b2d2f5f1fd28,Educational,0.09338039695311695,31,2,9,271,262,83.3799019830937,1888
1567fa15-2bdb-4a65-84ff-ef19f278e80c,Educational,0.6359977428964568,3,35,330,819,489,21.459885548131165,6099
0eba1de6-2405-4baf-b695-9faa82c0d579,Healthcare,0.5640810266020917,5,19,591,1193,602,74.66121396410824,3345
4f3d2124-f715-418f-81c8-5b6ce9208df8,Commercial,0.09598203487697177,8,44,540,837,297,59.1720154551776,7758
1edbff6d-d85a-459e-8e74-707d6279805c,Residental,0.5338730229980835,49,9,318,1009,691,26.932451210463665,5215
26f2e4ba-4e30-4e7f-a0ad-3d579a89b9ba,Educational,0.9111050922881003,9,35,681,687,6,70.59538845560418,4685
6f22396e-5dc1-49d8-bfb7-ea4d59c822cc,Residental,0.7528567344601239,28,10,675,840,165,43.860098516228454,6656
2b5be6a9-8001-4d7a-9775-61ba752ddad1,Residental,0.5845877974909506,36,6,194,391,197,33.52577708706008,9265
7c795f9e-9706-4d8c-b963-2e7326ae678e,Educational,0.5535841501975434,3,5,20,518,498,18.01083127170217,1984
cf77a7d6-8159-4956-8d2c-2076a8fed793,Educational,0.05814452321895047,9,24,224,736,512,69.46259408931229,9789
82700060-ca13-4245-b829-3ed7ebd0f205,Commercial,0.7388451435260597,18,37,94,435,341,20.51588911446843,5711
567da853-32e4-4198-9f7b-d30df6323f7f,Commercial,0.3398526122038197,10,5,37,565,528,32.2879840869966,2549
bc8c007a-8d10-42da-a7e7-72376f89f72a,Healthcare,0.9977041589143922,22,6,228,710,482,61.98914267766863,8809
67c553a5-6c0c-4146-8580-7d68b511e791,Educational,0.16878440141764706,26,43,272,1436,1164,24.867867116087037,1341
1392c6e0-c1c6-4455-9c79-7032460843bc,Commercial,0.4774440607482061,32,47,182,850,668,82.78052426117416,6481
9557768a-2927-4e86-b2fe-f25c86d83a8a,Healthcare,0.5358200461632945,7,11,17,1070,1053,76.81897700729469,2746
c55d4de3-9580-44da-9a97-5f4aa08f75d6,Educational,0.2414078339562714,3,50,9,640,631,73.26795451134623,7431
bdecf00b-472c-48bd-84a6-82efd136436e,Healthcare,0.2709100672559379,44,49,182,297,115,50.20827882515658,7329
a90d9c76-1aae-49c8-9f1b-5bd4bf8fd2e7,Commercial,0.6926699972733034,41,36,336,480,144,37.21117557872418,4316
998e0d1a-6608-46fb-ab8a-5d92aaea4430,Educational,0.7410044770068032,44,44,477,1020,543,50.001219986304925,6957
eba0b5ee-b6bc-4641-9528-6e6263024c75,Healthcare,0.6058811070636018,41,6,619,1133,514,83.43464593528236,5219
370c853c-a19e-4f94-8fdc-65420d133b0c,Healthcare,0.7077456450185166,9,48,66,409,343,47.05959591265414,5273
ee9ac5fa-8c61-4d28-aff1-455faf04a411,Healthcare,0.9089764956510914,35,19,211,628,417,79.74605620407101,1373
e394bb61-0d02-429a-b30d-1c9fe2cf79be,Healthcare,0.2699162490204101,46,2,571,859,288,95.94612844180384,4428
d8d0e537-ad09-424d-9168-186bbb45e686,Commercial,0.9767096693139422,44,21,589,731,142,48.76288625646099,3264
6dda80d0-e730-4be0-bc08-e9f1dbe8fa95,Educational,0.6364528205781739,50,1,380,557,177,33.75277665339597,9518
55bbfb7d-c572-42c0-bdec-5f56232a7f9d,Commercial,0.9700333438243924,36,37,171,534,363,14.395722454206645,4559
b834e68f-3e46-4993-b2d5-98893a752784,Commercial,0.9584197890429409,37,34,11,1123,1112,40.0885833026357,5172
081fa5d8-8dc9-43a5-8ae2-9c2f76d351dd,Commercial,0.06690369866833834,7,7,78,691,613,41.30777496346357,5004
225be199-1151-490f-a5bc-a462ea3c8094,Residental,0.8461539569966217,27,50,15,1410,1395,70.75591782659762,6979
b833fb6a-d681-4ba8-93c7-9a53d23e0e3e,Educational,0.5903545081848206,41,17,493,743,250,69.83831965181155,9384
1b083b0b-73f1-4c6a-84f2-86c948488820,Healthcare,0.2889311069342675,24,29,578,699,121,57.962957522241645,6286
915198d1-5a4f-487f-894d-bd1053a3023c,Commercial,0.9583467253829652,11,18,101,676,575,50.500537005347404,5929
16ae8960-4b11-40aa-9962-c93392f5232f,Commercial,0.2153847018575218,45,6,521,1053,532,54.950834575344835,4726
3f13ccd9-f42e-47b0-8c45-72f77049c33f,Commercial,0.48004369811332437,33,13,285,783,498,19.11184746061295,7845
c9e37e30-11be-4728-955e-90d088b763b8,Residental,0.8723718903692675,26,50,683,1001,318,23.88188892644641,3558
97004133-b51b-42e0-9fc2-2f7d5a55397c,Commercial,0.2537632145658759,11,21,517,963,446,72.47810740195425,9666
7f8a8bf1-6065-4584-b726-d0f38b37c537,Commercial,0.8545027253141934,1,31,638,1396,758,20.891637697148802,3608
f8976163-2b78-4a68-a6e2-87855b88a531,Residental,0.7919029775900329,32,41,204,896,692,90.14643726385506,5676
d74f5205-dfab-44bf-b2be-99d31b025b24,Educational,0.10210982268652347,34,49,78,905,827,97.05759488804387,3487
1a3e5280-03c2-42e8-9a9b-d3679f7139a5,Residental,0.6743564498443513,29,4,246,1191,945,21.480995210837087,7539
be86fc6a-cc9b-4b96-8ae2-264da03314c7,Educational,0.13800725619693366,43,38,115,845,730,99.6861812735349,4460
8679ee6b-31a0-4511-a3e5-fb83a4ce57eb,Commercial,0.8495513404240208,14,10,535,1187,652,90.76911484419313,4427
98de384e-c3b5-45d3-94f9-8daf7b076df5,Healthcare,0.0322692152992311,47,28,446,1422,976,67.48982497635978,1826
d4029b2b-9b20-4cd7-9914-8df3c42d6844,Commercial,0.2749170427103246,49,18,431,480,49,96.53489432071456,7147
1f1a433d-a15f-435d-816c-d36da64c7110,Educational,0.03811660024860686,40,36,478,1122,644,95.5223623383958,6047
9520ba80-81bd-4643-a1c1-fb917a1e1d9c,Residental,0.7559267491767344,26,28,89,1214,1125,23.8214324627966,8733
16c86464-1c45-4dbf-a34c-9e1eb145c75a,Residental,0.2765001790604641,47,46,67,208,141,51.335523897018085,3979
194b1a39-bf82-4beb-bd11-9c33955f0db3,Residental,0.9399938402925264,25,44,364,1281,917,98.20416959658552,1537
145dca8f-d7c4-40b7-b90b-44623ed485ec,Commercial,0.12471067503125055,36,43,209,758,549,61.83127245964681,8774
ab2eaa60-3613-4e47-9fcb-889e955def7c,Healthcare,0.34996011500932533,25,18,592,623,31,62.26452769881984,6267
4975cf2f-eedc-4b0b-bde8-2b48ff496801,Residental,0.6439650553471886,49,1,393,1339,946,41.382408183654405,3947
86b1973c-d705-4021-9853-a68b10bde7f3,Educational,0.931351375857289,18,4,372,425,53,70.26932278668532,8120
ceca8135-e2f3-4a55-b24c-2985db500ef9,Educational,0.47450970568970385,44,16,535,1278,743,48.67542519338602,3671
f5a73162-a6b5-4bda-a805-0e4c438345fb,Residental,0.28357555402787005,27,31,57,643,586,94.40532155175498,1397
f394b62f-ccb9-40ff-b9fd-4b837dc52db3,Commercial,0.9330629945202291,22,17,420,918,498,66.1213982534463,6310
03721bd7-8688-489b-a8fa-09e005939bd6,Educational,0.1451131005847025,13,33,605,860,255,36.3186216739264,8481
ba16a759-aa1d-4a9a-b30e-a066bd85ff4e,Healthcare,0.9696749495997957,32,31,289,701,412,88.69396277500647,9106
a4e50950-1283-4b2c-8005-2d3f71dc544b,Healthcare,0.2852309539145229,26,11,122,692,570,78.35062703061628,7656
bd71bc06-9af6-44b5-ad4d-dd2dfe5d387e,Commercial,0.8747559692490786,3,4,552,1104,552,47.64765697986637,8168
f7d3cf64-216e-4eaf-8dbd-607ef62445a5,Healthcare,0.9828285025894814,27,11,672,962,290,31.307998633808054,6681
42045dd8-94bb-4c3d-a39c-c23988e6f0ee,Healthcare,0.27762073312230195,10,50,60,65,5,92.19440899516194,5559
685f7c33-9eca-40ad-9e9a-5a8146b1cf3b,Commercial,0.8021367470803121,34,28,405,1427,1022,69.01138752239223,6790
d3c6122b-30f6-4257-8d71-b5c1a60f75a0,Commercial,0.48169995309913305,43,30,409,1185,776,29.63160480755225,2848
de60fe5d-12ac-419b-92ba-2d325c02dbf4,Residental,0.26385158562893196,37,46,556,783,227,12.62173826169612,7415
b140287b-de95-4e5e-9c28-d792a1f9e21b,Commercial,0.04817873633361969,10,21,13,1336,1323,92.33736629219888,1179
772ac415-4aba-4b9a-a771-2ac0344a49f0,Educational,0.7957978438993325,6,37,355,1078,723,95.09396419350897,8417
7d5e7eb7-f7e7-4f43-a6e8-03fa8fc18092,Residental,0.7767398066950564,47,5,231,470,239,61.96523791786171,5553
7c425856-8616-46fd-bf6d-7d5be48339a6,Educational,0.29555629759654833,24,30,200,1072,872,23.62503764379543,2825
f4209742-780a-42f6-98ba-811d39e1963f,Residental,0.9865231421955479,20,47,165,331,166,60.63070027022146,3659
71e05d31-b421-46fd-8f81-6c8967168a72,Educational,0.47798283256749163,11,41,598,616,18,85.22365416442352,5100
7f6d9f4c-f0fe-4464-b0ab-79691870e9ee,Commercial,0.606828957944967,23,38,638,1270,632,74.62938714689311,3647
026e43fb-c337-4a09-88be-938afba2849d,Residental,0.4415027352596753,34,25,235,730,495,17.40948708193747,9483
e2c36ac4-2f2d-4d1f-b9d4-2db17bbbc6a4,Commercial,0.8492967733745248,6,25,478,904,426,32.69153012415008,5933
b231feb2-725a-48fd-9f7b-dc7cbe14e9bd,Residental,0.1283008221847466,22,50,368,418,50,82.24828076972443,2171
266116a3-44a0-4d18-9016-244f33500784,Commercial,0.9877487809095966,39,43,704,778,74,60.048630541585034,2514
e96ad163-812f-4561-802e-7fa287c8f1bb,Commercial,0.8089507913271196,42,42,358,514,156,22.13966727589133,9457
ff8ea86b-479a-430f-ae5e-2b69260229cb,Healthcare,0.31712072597158447,28,38,184,1098,914,85.57997181138329,1220
dc407599-f90d-460f-b0db-704507454389,Healthcare,0.7326084921447704,23,6,393,1100,707,96.718388016394,4058
c4100258-fc11-4d68-a3af-55fde51c0265,Commercial,0.4593195847589119,30,29,597,752,155,79.66130521487479,7239
45ba1ce1-3af4-40e2-a8d3-28f442225064,Healthcare,0.4978772156460012,36,36,254,1376,1122,18.593339673587387,1810
1e486b23-e73a-447d-acd0-e983d640d4ea,Healthcare,0.5267006924018859,14,23,104,535,431,14.860138608610445,4067
d20ee392-5f31-45e5-a5c0-3e679cb83d34,Commercial,0.21783291848048747,9,26,713,932,219,28.47840592211668,6725
518cda7e-5b44-4a9b-8614-6acf834aa011,Residental,0.06638966304872573,13,11,715,1081,366,85.77315056758172,3412
de567425-f7b1-42c8-9dd6-979f2d9d288d,Commercial,0.9449748348822794,22,37,320,1067,747,53.7528092362919,9847
e5d88359-4c01-422b-98db-ebc899dce43b,Residental,0.516327862879904,45,18,602,1064,462,22.12243071005807,6632
85fbd0aa-f52d-4b31-b130-b1f3c49bd4a0,Healthcare,0.12671460290183112,5,2,330,1323,993,35.414396417837025,3383
68f2e972-0523-4f03-b3db-28743ba411c6,Healthcare,0.19666415944255056,5,10,678,1370,692,79.74247555124407,8816
9ea966f4-23e9-43e1-bc7d-d1c82d132711,Residental,0.9963589212420776,31,22,355,588,233,22.651687764087747,4681
ed0cad4a-2949-46f9-86dc-ee2d7ca302fc,Educational,0.20135376681617256,27,33,213,661,448,85.66781554023795,5617
614613fc-9647-40ec-ad21-0954efe3263f,Residental,0.30973956103826683,47,12,128,1429,1301,36.14916018028751,9681
299a459e-b5ea-465e-9ddf-960583808c4f,Commercial,0.8422031101132897,17,15,37,1133,1096,95.94469419958442,2027
46ff4d1c-7506-4a7e-811e-8389672f5277,Residental,0.7014811053705201,11,27,620,1140,520,33.76620938130891,7750
bd3c4eb2-f7a1-4a75-8f47-cf1f1c957e4b,Educational,0.9539559826482239,35,31,696,701,5,16.416709332493888,5908
0dd25136-9519-4f85-ae92-a08b8eee354d,Educational,0.33981741290175005,27,1,565,1339,774,48.818332033984035,7238
1c066a30-be24-47c5-a97c-943a78732146,Healthcare,0.12437820027008784,41,10,529,1088,559,85.65013686601725,1963
2b625a37-2ba5-480f-8385-22393e1a1108,Educational,0.6506005891317531,24,17,210,368,158,46.17052671498951,1078
8f293faf-9aff-498f-87c6-db8e0329eaa9,Commercial,0.1643933473899738,11,11,485,1028,543,56.35954048571312,1569
29a8f15c-f6c4-44d7-b591-ade92a75f8a3,Commercial,0.8230225921779332,40,49,690,1352,662,57.655718438808854,3247
b5ff8f9a-0b33-4dd9-aa87-caef4f8a593d,Healthcare,0.5650913790161102,23,17,464,1356,892,81.73376525502559,1676
a4566074-bba7-4b13-bb91-b3f1767a23fe,Commercial,0.022669916409437718,17,40,228,762,534,87.449886716954,1344
5ff72bf1-93f3-48da-955b-9ef808bbc9f4,Educational,0.3719555716282852,45,9,202,1351,1149,71.4623133139099,6290
3be9cc16-ed8c-4b29-a5ee-96cb9f37afd7,Residental,0.058508951752533234,10,35,528,727,199,44.148148630014745,8679
f1aebaa2-8641-4977-a828-03dc2bb1073e,Educational,0.22197727682681356,23,5,413,979,566,75.41191090900759,6116
7d3e0d18-2e63-4d4f-b8bc-06e023f9b5bd,Educational,0.6011657680781488,23,45,550,1343,793,42.729582634792465,4046
fc291138-bde5-41db-a67c-d14fd48860e8,Educational,0.6867199121854999,5,3,195,886,691,54.508048363970005,3166
66845a9e-0df2-4f6d-85e7-c2d993e42a9e,Residental,0.9629452667958891,33,47,514,867,353,99.93832544483169,9699
bf57c38f-d230-4687-a0a5-273a7ebecf85,Commercial,0.16899903797125648,28,49,391,1271,880,40.95532102756029,4106
23ed670c-fdb8-4cb1-96c2-737bad443587,Residental,0.7731773304003183,29,13,552,628,76,29.043703992658262,5233
1d4cd7aa-15db-432f-b6dd-6541c68ee294,Healthcare,0.7780806708099666,33,30,692,792,100,15.209557174488548,3177
3bdbb1a7-2bb9-4f5f-b21c-b383b33b85b2,Healthcare,0.2120401970653154,15,43,29,236,207,38.68745242986493,8605
e88461eb-a44c-4aca-8cf0-278049285357,Commercial,0.08637024244486369,48,18,549,557,8,60.17374454242079,6361
70c227f9-bad1-4928-89fb-f2f6c2fd8c8c,Commercial,0.334734492457061,36,8,473,506,33,99.09020856649519,3584
2cfea2b1-cac4-4644-8d2a-4743e5c26589,Educational,0.7251541669790788,6,32,718,1170,452,50.36464823369873,7269
b8e27d21-99ae-41dd-bf62-0c5efec75ec5,Residental,0.03039361947122876,34,6,187,242,55,65.00343647847674,5529
1d1413c8-2191-40e7-941a-cb242d5fae24,Educational,0.5922525349503134,14,50,627,1071,444,42.404739005866276,2960
98c68cb0-9bda-4b2b-8b2c-1d54542c6723,Commercial,0.7340819403384438,6,8,92,594,502,53.72899739173737,1209
cdad2b2e-5abb-4bb4-8015-81236ac8a865,Residental,0.7384476110747734,30,25,82,1356,1274,82.86048652712755,6553
db295e7a-a00b-44d5-973b-bae991ee6fd2,Healthcare,0.6269984018196617,14,29,478,1416,938,86.23365814875268,5673
ce9c1cee-b34a-471d-ae68-fe58f06a0e23,Residental,0.5476987455391755,30,38,91,959,868,88.56742821585759,1660
69e2511b-72f1-491c-b9b0-38545b3945c5,Healthcare,0.7945661522993033,3,33,594,860,266,22.697525839183022,4706
0b4992c3-37ea-42d3-b91d-126bcb4ae030,Residental,0.959835856652704,16,6,214,1085,871,48.50557887452913,2066
76c51d87-d2e0-4d33-a7ae-bfef6caeaacc,Educational,0.9307094930140721,4,5,278,1134,856,61.79978442118751,2364
4931d64d-0e6c-4956-9f92-d6ac45c1ebab,Educational,0.19831974474601055,44,44,376,425,49,51.420297841645706,8165
173b4cc5-4ce2-4ba4-ab51-fe257d565452,Residental,0.5265831504982249,27,20,185,682,497,41.13278425963373,8188
7ba705e6-7e7b-4823-9c37-28faa49f72e5,Commercial,0.4105818963588259,14,3,491,1277,786,39.8870409230377,3215
8cf43fb0-4f12-4c20-9bed-676906b31fe6,Educational,0.48559878174319593,49,20,20,330,310,91.11273611245862,5030
8bd2953d-27a1-48a6-8e2f-24a7bd242f95,Commercial,0.10665766187326353,13,37,102,671,569,34.812088845242485,9360
74d43586-7a61-4252-b47d-12834b70765d,Healthcare,0.20383021488634012,47,6,131,987,856,65.7000554779786,3802
71c14940-c1dc-4c77-aca2-dab50639ec1c,Commercial,0.7701334009385238,1,11,400,507,107,92.77559344625823,5497
05ac7365-2a88-41ca-9f0d-941ecdb1928f,Healthcare,0.04853678073367973,8,20,77,777,700,77.56829248013024,6460
4003bfad-4004-4637-a51a-27af299c42a6,Residental,0.7847563674101548,9,32,683,804,121,85.30527328904195,5456
740c8031-84bc-4bc0-b8ca-b5a1dc210f59,Educational,0.47563302155720955,2,47,686,990,304,74.92252825332704,1117
83b76c2d-d2bd-49c5-899f-5aaa9dbf8720,Commercial,0.2346567859299512,1,32,406,990,584,81.26327490832922,8924
a88f5df9-010d-467c-bf7e-f369bb9e3fb9,Residental,0.6748257413012032,27,8,405,1234,829,30.7390751854747,4610
a8283813-10e1-4496-9d18-89c69edc1e18,Healthcare,0.5478255371069386,17,17,153,923,770,97.50403582374716,2097
8ea844c7-77e0-463f-9e63-ee03a1ab80ec,Residental,0.06110763498469718,4,22,429,1353,924,74.61830871321207,9347
460534d8-f0df-4b83-902a-bbcc29e6125c,Commercial,0.0612150605259143,26,38,480,597,117,29.215638049079924,9886
ab93c677-0d83-420b-9a4e-c761024309c4,Healthcare,0.20145033293078174,6,44,97,124,27,80.8111749590032,8865
c95084d5-4ec0-4ba3-a1de-83faabd911e4,Commercial,0.0762347836409516,41,27,403,1186,783,94.81157448738828,9890
438c50ce-b15f-4792-97cc-1732ce4c6f50,Commercial,0.5763658951415965,3,42,50,84,34,84.64075527311908,6992
3965c6c0-ea8e-4635-9601-7ea492f4ca65,Residental,0.6096406128289239,27,12,710,794,84,89.07079090734631,3512
f42d29ef-3695-428a-ac2e-f3fba4636fda,Healthcare,0.7556791922173602,49,9,354,683,329,51.163305375010815,1747
73a9b427-3c63-40fd-bd5f-8a3ea83e75a3,Educational,0.029227388135086074,42,4,345,1289,944,39.0958025378583,4292
0a516118-738e-46d4-8111-56fac8481f2d,Healthcare,0.8430834015009504,39,38,302,397,95,16.71127542988393,8688
8a5d4d8f-8962-4e68-9b7b-bc1a76d67272,Residental,0.6494131978811755,6,20,645,1145,500,73.4304949549024,5214
4311642f-2633-44ee-a8de-1928c3743a34,Educational,0.6179177245368062,11,11,252,755,503,79.6857963201081,6449
b70a94f5-72d8-42ab-b18d-8241ced0b5e3,Commercial,0.7158831583731309,14,34,481,483,2,10.186022229624001,9193
9aa78474-0a9f-4424-9392-80946909c510,Healthcare,0.04188752927207329,47,3,408,949,541,48.65220078791283,9486
507d9f4e-73a8-4612-b867-0f5074983e94,Commercial,0.47515187865360897,42,1,436,662,226,16.528910905242007,5543
3efa3186-e7b1-4b1b-9152-32a1111236b2,Residental,0.38480733535366884,35,46,632,1073,441,52.67500154229545,4614
1534bb6a-9d3f-4392-b20b-5be01ab1a1e1,Residental,0.5416069551440249,33,19,520,1147,627,52.85642186172721,9805
4db73160-1a4f-49f5-afdf-f814deedb941,Educational,0.07677408882578696,21,12,584,1416,832,14.192340886056378,6819
29fd81bc-de69-4964-897f-da70e1270a90,Commercial,0.8032891331578269,47,45,168,888,720,13.999612847404084,8691
dc486160-7dfa-4349-9182-ad39168686b4,Commercial,0.4542361259646621,48,22,656,1252,596,21.376280837843606,4676
8b79d5b3-1b94-4806-9029-3a719df2ba30,Commercial,0.9301907299863982,11,45,357,1137,780,59.970219051375096,9556
e351fbb9-8d15-4704-85a7-cddca0c0e8d0,Educational,0.5530077584483459,46,40,322,1340,1018,86.9807443302239,9765
ec1a8931-67f4-481f-936e-a7e1143ba41c,Educational,0.049507851628603494,3,2,411,651,240,10.157016116708517,8516
0b0583a3-6e7c-4bc5-a0a0-9b9229fd2766,Commercial,0.7696253085030521,45,20,269,1175,906,64.63441920915606,4809
121ad361-9fb2-4c02-bcaa-233322abd2fe,Healthcare,0.4034632609141723,37,2,12,1231,1219,53.20154492003341,6763
f66c9184-1a84-4815-a989-2a9440d3144d,Residental,0.8254230015356429,49,41,585,1408,823,99.06807240325797,5819
1a4d4fbe-3cf7-41b7-b1a5-46bfe806b711,Residental,0.1252756439063304,3,26,15,1281,1266,86.2268986770908,4987
74e23917-7d57-4feb-bfba-eac8903c2642,Commercial,0.023497713317877755,31,11,671,873,202,44.66289781163355,6485
110515bb-d70b-4295-a561-c77960500524,Commercial,0.7057163333124952,5,42,399,800,401,91.69159146684939,3255
2fe46b95-d4b6-44e1-b307-1e6a930c458e,Healthcare,0.21838643859151097,14,12,354,1081,727,86.17923140904173,3298
9ec4be6f-04ab-4edb-a9bb-0ff9179db040,Healthcare,0.45391747912707503,23,4,120,266,146,74.10489295068152,4610
91e4e10d-132d-4d31-9b37-5afdc9d7794f,Educational,0.8120674552918647,18,7,518,792,274,17.55011696967391,5602
fe0718e2-a027-492a-8707-edd0b7fd7f5c,Educational,0.801739873659662,39,1,256,433,177,14.39705196486393,2229
7997b56e-a6c8-49a2-baf0-29d273065516,Commercial,0.3714728767522827,39,31,522,1240,718,65.95397616800469,5699
f1068fce-06a8-4682-b4b8-965142d1e36c,Healthcare,0.08354504149716047,4,14,486,595,109,24.789241006840847,3419
5dee1a27-a6d3-4301-aac3-9a9fb11d44b2,Healthcare,0.19217260738722886,29,34,507,730,223,55.02217328835834,1595
a1a3fd3d-8f48-4b4e-ac91-1d018156e9e2,Educational,0.9104372465151708,49,31,496,611,115,28.058887497891913,8238
238f0653-94a7-4156-8ca4-7ea02ca3ae6e,Commercial,0.23401571439348667,22,18,350,784,434,76.19395581276949,5283
3eac3004-402a-4262-bb8e-9b813ecc0bbc,Educational,0.16321193153528069,1,34,386,814,428,61.11691746926426,6712
05dbfbb6-565d-4c9a-8a5d-a65c455ab1d2,Commercial,0.0588553790041233,43,39,87,187,100,30.221828425451157,9515
0e8aee0c-16c0-4c62-9977-4b9dbe96d4b0,Healthcare,0.6002905844210191,32,26,360,1127,767,53.884009193632586,2177
1162e994-ef4f-4e28-ab91-f0b57126d8eb,Commercial,0.9463617489799936,24,38,429,710,281,97.49693324478322,5945
a945e030-db45-46cc-b154-c079334e873f,Residental,0.8546132830952137,20,9,586,1344,758,63.54171923762949,4253
e444268c-5f57-4705-88a4-4e999eec2d91,Residental,0.16266974792731648,2,37,101,1256,1155,81.33409548907449,6097
b3bfde5e-005c-4d4f-bf6d-d2dc250f939b,Commercial,0.21141338647025976,31,45,204,1157,953,87.27607007996104,7347
60c1bcf3-d799-4025-b65c-3e018bdf6697,Commercial,0.7497457975035215,30,6,288,603,315,81.5089260337926,1659
3c2f5f02-50fd-4494-8208-9c74407a4f9f,Residental,0.4777528452540243,3,40,254,1072,818,51.048779999571714,3673
3bcf5ec8-3829-4838-a82c-276426124956,Educational,0.17440253179210052,18,1,546,1224,678,62.22075081647224,7882
5c38870b-a108-4e6e-a16d-78ceb0338746,Healthcare,0.05321998967721375,39,23,588,1357,769,30.26064245805516,6439
64f9675e-521b-4901-b986-c95d0ee31e61,Healthcare,0.35955074681718946,18,17,527,1256,729,58.43934589223503,5140
705293eb-38e8-43ba-b5c6-6d3d16408812,Commercial,0.4330215846149643,11,38,64,585,521,21.089361013213267,7765
357c865c-df4c-41e9-917e-266476ea9cb6,Residental,0.18655506932822108,36,17,429,875,446,22.456693393924297,1725
4d5152e5-40d0-40b1-853e-4e38a68459f5,Educational,0.8692925663674725,33,25,306,1127,821,69.66713075379263,8224
173e3fcf-6c4b-4eae-a31c-b42301ee51d9,Educational,0.6047385667007047,38,48,481,737,256,13.703031132689885,8635
b8525b15-0792-4540-bb35-22e70e844af9,Healthcare,0.7939013922989431,46,11,208,386,178,78.69729834565888,8640
28d1a1ce-f957-4afc-97b5-3e9b30fddf23,Residental,0.7294617727196524,13,39,424,544,120,41.383656763954676,7513
833eff79-484d-4209-8ac6-584c44d533d8,Educational,0.23753271030327294,2,43,101,1363,1262,90.04003297074327,6711
806b6032-537c-4391-8cf1-145ca0a2f634,Commercial,0.22103670946624843,17,2,218,1045,827,33.80520917085049,2912
001be87d-e67e-4641-a371-02807a04b141,Healthcare,0.15545503002431438,25,4,102,446,344,23.331971960614425,5899
66860a6f-46ac-443e-b889-50c378c5e609,Healthcare,0.02679119273529229,14,2,286,723,437,36.98161352651016,1582
a45cda45-7d80-4d1c-aa31-ede555dcdcf5,Residental,0.4887629196308103,35,17,707,818,111,11.951625335937294,5370
bd252c7c-a0ee-4a7c-9f93-7aa8c33988c7,Healthcare,0.127496050710724,21,35,435,547,112,24.503686367950834,4661
456752c0-cb77-4ec3-8af5-591d38333893,Residental,0.10004687097842446,22,46,465,1152,687,25.16164231815978,1887
7555088f-d878-4e2a-87ed-aa22f97d8279,Healthcare,0.7876061463035074,3,18,617,1345,728,74.9680768111446,5221
a2b63b74-4f30-49d4-91de-4cb6c3034402,Residental,0.29534337058057747,12,27,24,989,965,83.2486083816682,4781
62b99e80-94dc-4bb9-a7a4-cc3bf66a7ba7,Educational,0.8503398568725915,31,47,42,1063,1021,15.941542081838708,3617
17646e28-9b12-4d96-ba7d-769c30f8445d,Residental,0.8919809095901229,48,18,521,855,334,78.6627360598138,3497
06172204-1f6d-4882-b370-446c3e767eb8,Commercial,0.5745479582952244,17,10,368,1387,1019,12.133929176188605,9924
29d99f64-b14f-47a6-b3eb-f4e24d9f427a,Educational,0.9058874175806252,15,19,508,888,380,99.29593042511023,3810
f59bab9d-fca3-4443-be3c-b50cbedc2e69,Residental,0.09302639385109124,44,6,264,410,146,31.89106761045452,1973
8bd108ec-5815-4073-8723-9a4398c41e94,Educational,0.8970864081384685,14,14,720,808,88,29.810736744735173,6959
a9359a94-3dcb-461e-80d0-a441da62b1d1,Educational,0.8341637625739265,10,22,621,812,191,38.310791936303886,4429
779d7ee5-f9ad-4ca8-a477-d365fe1a971e,Healthcare,0.44160353452558077,49,48,557,711,154,64.10066867007409,7631
f0df1f4a-8aeb-4fcd-bd23-431af0382c82,Healthcare,0.6066691125428522,5,14,482,543,61,95.10904595056174,8458
172e807c-3f4a-478c-a6a7-0fdd82396563,Residental,0.9902797616988913,15,35,72,1397,1325,29.890948693199686,8548
e8ec5aba-5022-4d91-bf8a-daab9001dec3,Healthcare,0.3778413031128107,25,38,267,1022,755,83.86148591080548,8229
7f294f8d-85a6-48fa-afee-842148931fc6,Healthcare,0.5308860601790083,48,11,564,1405,841,68.13551942218757,5935
f5524136-8c1d-4248-b412-f4d5c72dfbe4,Healthcare,0.4161323779574687,23,45,320,894,574,44.10409639240774,9359
14f4b018-82e0-4ade-9f9b-18b1067693a1,Commercial,0.032108087863492174,42,12,97,543,446,71.27560631607895,7159
13f7cf0c-11e2-4af9-8c49-e2ee057eeacc,Residental,0.29168419135754553,18,30,253,1122,869,63.75473680806013,5635
1391454b-6ac6-407d-8211-13386ce5182d,Residental,0.5191155608659564,30,2,173,1103,930,32.02191887054184,2117
eea44cbf-d0ea-4623-af6e-10c7c178dc2d,Healthcare,0.027100624713313315,18,35,441,1103,662,94.11190790148957,7114
7014d49a-50fa-4eaa-979c-166bfb0bf9f7,Educational,0.6825262194822673,47,25,482,766,284,54.956355087690845,8772
f58d7ca5-f9b9-4506-b093-cb357050a425,Educational,0.49389884656733773,26,42,459,1262,803,81.9144587125979,3485
0e386576-a84a-4fc1-89b8-ee2b31616bf2,Healthcare,0.9276574976472163,34,48,593,1404,811,41.199753035667136,2000
3ec1a8af-50c0-4dca-b39b-427b21d349ca,Commercial,0.9488715332373067,34,12,41,475,434,80.07243325606039,2913
9e0305ae-e51d-47b5-adce-2b5fa41f11d5,Educational,0.9932957658154165,39,46,505,1043,538,60.56818746854541,7301
90437488-c79f-4c5a-b8db-eabd4c60c044,Commercial,0.30909589922199243,48,44,29,1289,1260,48.01046905239797,3782
d7fb179b-2ab2-40a9-8965-829564e67b66,Educational,0.18758518664383494,32,26,478,673,195,47.23344308523229,5706
0f3e416c-f4d1-4f86-a762-5a3927909a7f,Educational,0.00021346924723264493,22,13,485,988,503,60.03356933684295,6672
66c08860-b6d9-4232-977c-bb9fb3bb30ec,Healthcare,0.9363851012233061,44,49,2,1300,1298,96.30372773329482,1740
5de36b7c-b161-4944-9e9a-644fb7bbe889,Educational,0.9890491459223311,47,22,607,878,271,83.13474331626797,7657
fe4ecc2d-838b-446c-bd1d-480af4c524b1,Commercial,0.5814935820674434,3,2,304,1094,790,73.35699667941195,8120
71b1c3e1-f8f8-4ca1-abef-afb71f1f2da7,Educational,0.29528687768264694,19,23,366,409,43,63.00339031652374,1878
53799aab-b112-4d45-b8f7-40f263cb6bcd,Residental,0.590813495586721,1,1,246,1312,1066,77.23585421828966,5524
1c79b4d8-5e35-4523-a682-f727fdb5d3ad,Commercial,0.01403516730563481,30,6,582,790,208,59.97540947890671,5501
761c3923-e31f-495e-b320-208a8d6de274,Educational,0.063265724803932,44,11,469,1281,812,12.408603185301875,3292
29f09e7d-7735-48ce-b35e-9da78b6f08a9,Educational,0.5941446522102038,15,26,66,1152,1086,12.286797509786947,5217
c0c30874-f947-4636-af3f-82f328c86ae9,Commercial,0.2891522722005896,24,22,673,760,87,26.494788760977613,2450
a6b328ff-0fc0-4e14-bf32-accad3e5a984,Educational,0.053833977097390684,9,27,515,949,434,20.91220740594896,7428
ac328570-c7c7-46dd-96be-5f1e85484882,Educational,0.344639214385975,50,41,94,287,193,16.840608664870032,4764
acbb0d47-36bb-437e-b7a8-c83ad655561b,Educational,0.27955325104526085,34,18,548,651,103,92.80356021559929,5843
195334e4-3426-46bf-ae64-ae783435c80b,Residental,0.9250093710170386,50,10,282,1134,852,41.957748162191734,9715
d372a29f-e667-4470-b59c-a5ba9159299c,Commercial,0.14731164385132733,19,8,587,1042,455,74.15432428069732,4861
5556ac5f-8925-4639-b3ba-3731c3b8db73,Educational,0.6093417854783012,33,46,167,1308,1141,15.001789989480201,6936
9b043480-e7a0-43a7-92e1-57761ce8d68d,Residental,0.9353836378762407,47,18,545,1337,792,24.77695528128759,6649
73c6d12b-1d6d-44d3-b243-8fb7ce08491b,Commercial,0.8028231676591202,21,45,535,1352,817,13.460831005588027,2564
4c072a0f-24e5-4966-9820-42b4ee7214ee,Healthcare,0.5076018502604569,14,16,235,551,316,11.63063513152485,2251
f7ab4015-9f7c-4a0e-ba74-2db7133eebc6,Educational,0.6272766187383493,44,5,626,1186,560,62.23567612159955,2859
fb96a937-79be-4d4b-a863-6f4d9badbc14,Residental,0.13516974214802968,16,7,629,1045,416,85.97371779928574,3006
7987aa65-85b0-4df4-be3f-07dfd6655087,Healthcare,0.05603929327699009,46,5,130,177,47,70.24469465270674,7385
e12c1747-ef64-41bd-bcca-ca113a5e927f,Residental,0.6453363911994984,50,41,671,757,86,49.69861977152349,1351
4d48007f-32af-4937-8d71-d4b5b5e4922c,Educational,0.9526754083779833,15,48,438,622,184,59.07620055698012,8795
eb157c64-5415-46ff-b656-bc0c31454b9e,Educational,0.23386362661353044,22,17,439,797,358,34.45466275086603,9038
ea444d6a-ed42-4bcf-b083-449399376ca9,Educational,0.9879137274702032,23,20,544,1101,557,62.98771539209494,9969
4a113cfe-182f-4dab-b21e-bbaa495650aa,Educational,0.14253237754604509,3,47,410,1369,959,66.01589489316214,9078
375f3534-59f3-4a14-a479-bd37e3e42c5c,Healthcare,0.6283283050970765,43,43,483,966,483,87.57914016717497,6909
6baa132c-bbbb-4b5c-9734-6555e73dc78a,Commercial,0.8546502411743986,18,14,405,553,148,53.10542927699445,2297
8b0f52cf-b3e3-45b0-9552-c0d092db0550,Healthcare,0.8560742145443963,16,2,108,702,594,96.1369492158108,3937
3808bc62-7f34-4d2c-a6cd-424eaece2b75,Healthcare,0.15213970773991004,21,11,135,417,282,54.61243733880322,1706
e8155d9b-a884-44cf-8d1c-26f1ef9bfa9d,Healthcare,0.5660846955613105,49,3,132,547,415,33.51584221185882,9820
d0ed24e2-2df8-427d-bc1b-e404205bae0f,Commercial,0.4323075233610777,36,42,117,1195,1078,81.36096146081071,8559
ffa3ac1e-67b5-4cb3-812a-ff14dedd038e,Educational,0.42984718634348273,14,18,129,1257,1128,87.6150678958276,3210
797f5bc8-7dad-4f34-b05a-c6dc47101398,Educational,0.01616050692120119,36,43,628,1295,667,39.280448751460355,8013
ec16cdb4-53c7-4d4e-bfd4-8843cb134118,Commercial,0.5799861946235867,1,21,504,635,131,84.91708575284086,9940
383979c4-a016-42c7-9178-5a349099df45,Healthcare,0.9724888906645038,37,37,32,96,64,50.914261033466396,5074
2a83fcc6-e1f1-4bbb-b219-4fadf3e62883,Commercial,0.18291027248962377,5,43,238,919,681,11.781591504825847,7360
ec5af310-ecfe-476f-8b02-d30cd35f1bc1,Educational,0.05585147250865208,23,44,137,1145,1008,59.10175655458597,7500
2586f6c7-4283-490d-a7f8-3202c67f50b5,Commercial,0.0019722902309162738,29,34,183,361,178,93.29833669362537,2112
83b2f577-7717-4ed8-98f4-8ffad724e902,Healthcare,0.3340144280019953,49,43,448,707,259,41.51701842153331,5348
af57d619-4ef7-4008-9fe6-bb9070195549,Commercial,0.2425624693509134,9,38,518,1053,535,19.831364423381196,8739
11cb5e53-3f27-4a19-bf49-68ba94681e3c,Healthcare,0.7275648340329935,1,33,540,1151,611,66.50818566795351,2059
6cbe3334-5b40-4450-8727-60db26a2d231,Healthcare,0.7308734817201463,19,46,558,615,57,70.17992459305638,9915
51baa0eb-38d3-4d69-8eeb-5a6cf2b701ab,Healthcare,0.13296267878344326,27,2,632,1128,496,95.79067190236874,6540
d8a99ce5-c7f9-46ca-aabc-a640d0fea179,Residental,0.27306201679741704,49,24,150,522,372,93.50623906969808,2421
81d543dd-123a-474a-8749-c9cac51cd429,Healthcare,0.18069317372369798,50,29,180,507,327,90.58323802827874,1234
131dc499-d616-40da-81c0-43893064bed3,Commercial,0.9667096759059969,8,2,379,1294,915,38.990011497378376,3213
59a1d2fe-39d9-43c0-a6bb-5ab7d7c30ee2,Residental,0.9939929973058522,44,36,227,1057,830,45.91815256511885,6283
9bd92730-64c4-44ea-a3c1-bb8e2ed4d096,Commercial,0.3375161381057584,49,21,315,1204,889,30.38763928524168,8416
843b7900-f165-4e1f-ab80-919bb421292a,Educational,0.7462758877672869,13,15,15,772,757,31.986966172295478,6135
79fd5b59-0428-474e-b86b-6c3c33dc0254,Healthcare,0.9915898194510571,5,13,417,1090,673,88.86895980252874,7859
8f64689a-1e25-4dc2-8eeb-3f6c6639eafe,Educational,0.4696022451315194,34,1,290,517,227,57.53387247911428,6973
0ca9bb21-20aa-406c-a33f-eca1539f1894,Healthcare,0.5972460856576394,25,39,337,434,97,83.4414573236368,5399
f50cc1df-0c51-41a2-8727-652f5e22e3a6,Educational,0.5930954109010765,27,22,611,682,71,67.99371790481426,7980
01a1c8f3-761a-4561-95d5-d7591b76c1e4,Commercial,0.49104834669604835,2,47,172,206,34,83.99591451815326,8158
8c8d3e37-b1cb-4bf6-9802-a96109804f98,Healthcare,0.3310365020832473,7,10,381,413,32,89.23687739615069,6834
870d69d0-6c04-41c5-a458-ff28bbb5d8ac,Residental,0.1816569732009483,14,10,634,1095,461,52.15716660330611,3676
605a0ac2-15f7-4dbb-b022-42f21d8c499d,Healthcare,0.5025937955889807,46,24,707,719,12,57.22666090932327,6124
ba3f5633-d1d1-4d12-a895-b375b6fe72b2,Commercial,0.8841672031139658,46,18,372,758,386,78.41118488103139,1444
ac3ce38b-6b57-4388-ad2c-08c77836afbc,Educational,0.3600503538544543,7,6,94,1041,947,61.23557540523868,7668
b497958d-269d-4ab5-9a5b-955a5595352b,Educational,0.06027906372289571,42,34,331,828,497,27.827069543406903,3635
a2df5022-2ba2-4b3f-b6d9-5751f85d4c1f,Healthcare,0.7337216333141908,38,39,260,1096,836,84.24933171639542,8609
08832586-6578-4965-9b11-ea3149cd45e9,Commercial,0.6224254836538489,3,37,558,749,191,29.330005928604475,1561
d0c39ad9-07f6-447e-a6f8-fdd5b4904558,Educational,0.9118623631376388,39,15,194,944,750,11.728195359605962,4230
bc13ee89-abca-4474-93c6-9578c48b46cc,Educational,0.9093688805256042,13,31,193,977,784,30.870105951048888,2571
6dd35fe0-8a42-4a12-a5bd-62b97ccf77fe,Healthcare,0.6378157830176411,39,11,560,689,129,25.598894898761152,6799
407ee2bb-e551-48bc-b467-15360a140ba9,Commercial,0.022842188622490656,3,44,413,873,460,43.342444670211044,8412
11d3a2f8-a303-4023-841c-a762ac7c595a,Educational,0.5056121098867696,28,39,69,131,62,32.804909184671516,1825
d98a0bd5-1e4b-484f-9b39-23ce60c91cd0,Residental,0.8289099026655795,29,32,690,1273,583,59.50375190143301,1417
c52647b7-0c37-4850-bef6-e0b6feb8a29d,Residental,0.32366405690604094,37,26,101,851,750,14.341836895304878,7230
5f899df7-9682-4ab9-ad0b-14a1eeeb1bef,Commercial,0.4093928709358,19,19,574,1289,715,65.73450495918266,8152
7ae3e0b5-8c2a-4a78-a089-c8b3bcf205e4,Educational,0.30090126887550306,36,9,146,1388,1242,19.993033398167128,2992
ceabe880-79a5-46ae-9c2b-bb7566b4d523,Educational,0.8595348558813424,31,8,249,1420,1171,72.04113749566915,8832
7fcc75b6-b5b1-46ca-a077-9c15c46b5729,Educational,0.8368571249047231,36,14,204,437,233,97.18305742771481,6483
ca4aaaed-dda5-4b58-8fb0-7c4f06bb1946,Healthcare,0.9365697597231056,41,47,66,1066,1000,90.63620285184648,1164
47ef56d2-ece6-4333-86a7-aeecae7555fd,Healthcare,0.7686807532634304,2,34,579,1146,567,96.80327199635894,4345
c3859134-f988-407a-aa78-fc7b2a6808e9,Educational,0.6638729332209846,8,14,418,1310,892,78.47834940341522,1566
0a83ba0a-7607-49b5-81bd-32b7c5b837a6,Educational,0.9015625328338962,2,20,62,522,460,92.23068214746432,2991
bf2b06b7-1de0-40e2-b341-484393f62b50,Commercial,0.7221683397365298,39,26,389,617,228,93.06905297956673,9674
3b8cfc4f-98a7-489f-8e74-7e7e6e0ef47e,Residental,0.21650218697600232,15,47,186,674,488,14.320089673207823,8351
cf4f6580-4238-4610-9b92-8af96f50219b,Educational,0.09280574603153458,16,36,369,969,600,80.6761650530969,3108
0ff0a513-76d6-477d-85f1-8058df3b6b83,Residental,0.42210211928997554,4,18,500,1254,754,95.92232966003411,4211
a5761f23-4a31-4db6-aa91-cfc600011b31,Educational,0.12415227552697583,45,44,267,362,95,68.46478389787703,6968
9ae0eb26-41d0-478d-b978-aa3f7f4f92a5,Educational,0.9217234650893655,22,23,565,603,38,86.40995149606715,2653
447f3fcd-8ee2-4e8b-8c2a-5438565ab7eb,Healthcare,0.9024916951296665,39,36,320,567,247,26.55622198819038,8191
bd107f61-1846-45bb-a927-3989632ca8b6,Residental,0.0701492342355241,23,12,460,875,415,85.0742743673388,8464
0c1fd3eb-1b47-4995-987d-5a63e394ae31,Residental,0.33438129658548066,15,50,241,752,511,98.29570831385304,4308
3d02e5ca-f3ce-423c-a528-6751d7f1cac3,Educational,0.8954128549117486,16,16,118,289,171,61.49939190907128,2825
7e413e09-06e6-4baa-8109-4535eb684983,Educational,0.8317662763848308,4,5,366,509,143,10.69025303873251,2069
8c735699-5fb3-4742-a157-c3ae28dc1aed,Residental,0.8695532447809857,42,25,365,1204,839,96.00985523218257,7153
ec2d167a-df34-4e61-99ec-11336177d6b3,Healthcare,0.08526305541525181,46,17,63,650,587,29.831352177023405,4321
485b41da-28fb-473f-b5b2-0906d8919a88,Educational,0.5448722874272784,49,9,353,688,335,16.313091143595422,8094
845b8291-f11f-4f44-9b58-eed62d62f77e,Educational,0.401589397744318,37,4,62,471,409,60.4706648480741,9984
7470823a-788e-45ef-97ac-f6c1015160f9,Residental,0.11891305325175883,45,9,142,978,836,99.95979457688172,6113
156a949a-27c9-4876-b97c-b0e8471ecdc8,Commercial,0.8548483092126117,1,40,93,779,686,73.42147139829669,5036
961cb68f-68e7-4976-a6b4-7db604358ac6,Healthcare,0.956648127263196,40,26,144,191,47,86.20264886431372,9652
da512180-43af-4dba-af79-d3a3b124be9d,Healthcare,0.4149199779763526,44,11,3,763,760,62.85966429632937,2898
9788a629-c732-45bb-8385-4079041812de,Healthcare,0.7335407046179022,2,26,224,917,693,53.570133292679586,6730
51f94266-e04b-4b7f-ad96-a1e083c78079,Healthcare,0.7771645298201907,24,28,615,1335,720,35.57734412722398,7171
bbcfc873-aaf9-45cc-aad2-7a54d79aaee7,Residental,0.5026272412552284,34,22,331,941,610,59.42640392020953,8432
d2b3c9f6-519a-456c-89e6-b8ab1676260a,Commercial,0.9141292049682699,28,11,574,1398,824,71.90630446198335,4290
37359f5d-8e4f-40c4-9824-82603f9070bb,Educational,0.6551773784643936,14,31,275,381,106,39.026355238564065,6902
b57d3b5d-6b43-4384-820c-eba59b1aaf3e,Healthcare,0.7145520288234923,47,22,10,739,729,85.21119975193008,1663
dcca542c-5aec-4dde-8bf6-3eb07bd2a082,Educational,0.3574384468602868,1,29,692,1411,719,92.98358536068262,6570
5d2e2a0f-49c8-486f-8837-4338ee13a8d8,Residental,0.9612594649511499,33,8,694,1211,517,78.88212724269333,6857
7c39270e-687c-4441-90bc-546ef1b82632,Residental,0.7485284683059076,11,50,386,858,472,27.26291301285081,7439
61453907-1817-49b4-a1a6-809083d42c08,Residental,0.8623769260438419,25,7,221,487,266,91.05752458835805,1335
382dd192-be88-48e2-91ff-f69c132cd6e5,Healthcare,0.5716595324802768,46,35,69,978,909,61.362666512730776,2500
ae39f7b0-1932-47ca-8d32-0c780f25ab02,Commercial,0.5152815634569942,5,1,492,1065,573,29.64932544098134,3369
c1c43a47-0acd-4fa2-9f1f-24bc3ab0e7fa,Educational,0.9368769691755464,5,2,666,1194,528,11.772253693274056,1299
4763ef8a-b5ba-4d4d-9460-64191caf0827,Healthcare,0.665600753124014,20,25,74,637,563,38.58495830083956,7283
6e98efae-2e14-4c6f-b954-1d26faee9060,Residental,0.8090905090007097,28,31,391,1199,808,16.701584050791496,4421
4bd2acd2-47a3-44b2-a7da-0eaa4ba1123d,Educational,0.2845833527561471,16,9,552,590,38,77.99749867914403,4877
46f0956e-898f-4f72-bb98-fd2fdbb11026,Healthcare,0.45940149755206117,9,30,336,757,421,51.423498649476876,8137
e32cf422-a05e-4606-a742-77ac7a8453bb,Residental,0.7374767225375078,35,44,461,715,254,57.56418872763442,2117
9fb01f42-53c7-466c-817f-16e1a9eba039,Educational,0.5480098167479721,24,4,73,1337,1264,74.1476493862285,4470
4b9e38af-9e32-4b72-b04f-160d3c9f798e,Commercial,0.4233751322587229,3,50,386,774,388,57.93730184418197,3587
42e2870d-c028-4f0f-a996-7c2f49a7d8a7,Educational,0.138758009951797,32,3,541,922,381,98.02273794366455,9741
10af2d70-aa70-495c-9fdc-7be6ccc3e949,Residental,0.5774338488656475,49,7,34,507,473,74.77938739239934,8427
3acff0ee-9b67-40ea-bacf-d71f7a544ec8,Healthcare,0.6975632110452692,29,4,346,1250,904,28.26942932459203,1476
14538090-ef5c-4a59-8979-242202af9196,Educational,0.6329269208555449,36,42,645,1166,521,31.69683186668117,9046
a5459927-22a8-403d-8c6d-3627122a1c16,Residental,0.8203729464769124,26,7,210,1343,1133,85.72534925403212,3482
6012f0d6-5249-4ccd-8e4b-9c7c4ac69c30,Commercial,0.4129944521083244,22,42,52,710,658,82.01961929378878,9650
c6ee1ab8-f25b-43f3-b368-6e859229b4c5,Educational,0.8567963591073153,38,29,650,1093,443,16.560688074400836,6991
d47168db-6dcd-495f-b97d-bdc994158fd6,Commercial,0.05478845455142611,37,21,280,1081,801,19.893757427357887,7437
07dde616-1385-4579-992b-b7f24c9cc9f5,Commercial,0.33784262486634653,46,11,88,920,832,56.74262365711248,8231
7df27337-2f03-4e23-9352-eb2f8f93fbea,Commercial,0.6296788404239586,30,31,652,1266,614,50.471802769768196,7058
ac5d3e07-0023-4104-bd1b-dad38c916f3c,Healthcare,0.8260852991341704,23,12,347,1082,735,63.52893067507961,1004
792bde5a-7775-4c70-8182-6b7c13f4f9fc,Educational,0.9308579230267644,10,36,324,645,321,33.78121906982501,5157
806bc965-330a-442b-817b-030374640a8f,Residental,0.3336866657107703,9,2,502,620,118,26.950875995743505,9345
df632748-3a65-4fce-9972-5e0c12f5d6e7,Educational,0.7370718585090584,45,43,227,490,263,95.6857015246541,1935
d320880a-5d60-434a-add6-adc5a521f571,Healthcare,0.18878592030564156,7,33,366,948,582,63.43979976566229,6907
249d5ff7-8d96-47f9-9465-679c22c9e2de,Healthcare,0.7641132322563596,45,5,50,64,14,78.60534379568614,4377
db2f688a-cc07-4ea1-a1a7-a7bee8a30f6c,Healthcare,0.5235833957524382,31,6,369,382,13,31.57576425150039,8192
b68b6c42-fe05-427c-a12e-57b5bb249264,Residental,0.07505585941149129,28,47,179,519,340,56.170766423343174,5392
1ffc8b39-7188-4382-b893-c55dd47a6bc3,Residental,0.7646048552091648,39,48,579,796,217,39.10340548876254,2577
344ecd4a-82ae-497f-81db-d54f7ae291bb,Educational,0.593857726795824,1,26,78,139,61,71.10974811269585,4385
0775ab20-bc38-4f89-9db7-a4e735ed9633,Educational,0.19389517649822074,24,2,136,604,468,18.742594062254984,9683
49944ed2-7b68-4193-84a2-7dec7d676153,Commercial,0.2540502349794318,14,28,250,1374,1124,35.38346324485711,1545
02b93a44-9852-4185-b141-9d5e3a2da7ab,Residental,0.468978449477755,41,25,97,1228,1131,98.92427669021639,7498
b9835bb6-d3df-4fb3-b3fc-d2504724aad7,Commercial,0.6264255628128418,7,24,486,815,329,92.74377629412695,2516
28bbba4d-0ee2-40c8-888b-d7d2c7da622f,Educational,0.7626042493544081,3,4,137,1228,1091,57.85224295302255,1704
99a9449c-0e4c-47c0-aeb5-d36442b699b3,Educational,0.7827484300941162,14,20,646,952,306,21.20912147175205,9336
25703133-8bf0-4620-b582-3403898505a0,Healthcare,0.7787001100101371,9,14,93,1195,1102,65.61813163403322,1490
fa5a2b68-d627-4127-9c04-8a98a5fc3e79,Healthcare,0.9288528530634689,27,49,547,1177,630,48.51786632613754,4150
6bf5aee9-df15-4e4a-9240-470380ee048a,Educational,0.19115776376337335,16,33,545,898,353,70.29488246693347,9383
0c60f369-fefa-493d-a3b5-48ed8215e35b,Educational,0.672464653115172,34,49,411,660,249,37.45732399116252,7435
6cc3b34b-4de7-4568-adbe-9afbe427bfa1,Residental,0.5853229237726901,32,10,26,788,762,52.63612230736412,7610
6effea6a-512b-4776-a145-59d55b72cc4d,Educational,0.3521918561765338,41,4,466,1149,683,83.49111028689636,4078
9118589d-425c-4c3a-b2f0-3978644f8214,Commercial,0.7226048273323435,24,15,554,910,356,28.815520159869877,2114
1e340503-eac4-472f-be81-91af4b49d15a,Residental,0.27757204872336716,19,26,15,935,920,29.744155697337742,1220
62ca901d-a1d6-402c-8572-afd79a5fe9f8,Educational,0.26513930037062905,16,31,342,801,459,76.70069684815283,1701
2c74d92a-f064-4ed4-8a5a-25b8492e5f3d,Healthcare,0.8275112066831787,24,40,638,1178,540,47.413184878445,2255
60eb19a7-c91b-4786-b896-18045525e213,Commercial,0.1585656155684605,36,44,508,641,133,44.43445781304307,1361
c531693f-e575-4d95-9edd-33f0494f7d91,Residental,0.7740137583915202,37,31,487,711,224,10.843586641734008,5562
205555b4-e93c-4be8-a08d-6668601e760e,Residental,0.4003251942356716,1,34,514,566,52,28.21395581244782,8534
431ca708-a8ec-43ff-9fab-9e065fc77ded,Healthcare,0.812213901594212,5,40,594,1292,698,73.556511468439,9584
200e07cf-10ce-4c4e-b9d8-15bc29360419,Residental,0.9249973933854493,38,10,486,1369,883,46.983365298160315,1838
9dde20d8-28e2-4e82-95b7-0ecdafd46839,Educational,0.15752571395411374,43,25,410,1014,604,67.28178521192025,3757
d38ae98f-fb6e-42ee-9616-e538d53fd0cb,Healthcare,0.9596057761027681,27,8,701,1360,659,20.231933705789604,6951
01daedb3-f7ad-40d4-b3e0-201dd42f959b,Healthcare,0.7841939516231471,27,48,367,802,435,43.12191394501704,8420
cc3718be-b2ee-4ff4-a24e-b636ae794c37,Residental,0.5597702122231535,15,37,40,276,236,16.79700821974201,1292
4564d32e-74c6-421f-9cb6-dfdbec219683,Residental,0.08751453871194936,6,21,574,1101,527,64.42356645811665,8513
11d7f7bb-8881-4eaf-8fd5-5fc787e58ad5,Residental,0.1766962088142583,43,7,118,571,453,12.351610612744361,6798
c06b6e3c-3e6a-4235-8747-bae56d4ff310,Healthcare,0.8863692154699566,37,18,526,1268,742,80.13305738985996,8873
cb644397-f5ed-42a5-9287-8fd7a32055e8,Commercial,0.8420466686242811,16,46,670,1412,742,91.24727702572197,3764
89c665c1-71db-45c0-918b-74569293bca2,Healthcare,0.5862003283594478,45,19,640,993,353,39.719815258891686,9411
7a296720-bcf7-44c3-bfa1-4ac37fa9e96b,Residental,0.049936452174430324,9,13,621,835,214,23.4185482531285,1525
3db7c7a0-7d20-4bdd-a775-dca1f9abad97,Healthcare,0.31541903756737866,31,13,599,1348,749,61.47671331889389,3339
a0715846-c962-478e-afbb-7f4f0b1f4ae6,Healthcare,0.5413526660283717,22,15,616,791,175,88.22098114303562,8064
2dd1fbd9-4d67-4cf3-81e6-9db5188b0761,Commercial,0.46323614620880227,43,9,438,1228,790,94.53443039272102,7141
904685ba-78cc-42f2-9c46-07635843a39d,Educational,0.5177279424315367,5,36,246,821,575,84.51232053480524,9890
4d7019e1-015c-483f-950a-e44666b58ce4,Educational,0.7929061789793689,3,18,347,1383,1036,16.14663283566462,5751
c6962636-8f4b-46f6-a004-9cd6e7e8759b,Commercial,0.32239485401002876,24,34,570,1331,761,33.389343311969455,6787
0e44cae2-9bd3-4343-a9c9-61e89644a2bc,Commercial,0.9130511851895328,4,39,89,1292,1203,34.147984954264274,6580
41de2868-08d0-400a-b9b5-0a54d038bb0c,Healthcare,0.6876236311648847,50,10,395,918,523,10.245215957780605,7918
2734725f-63a1-4452-821b-69d795e67dd0,Healthcare,0.8387578445596695,41,33,338,626,288,11.98654008967959,2284
27e1d2a0-6195-4208-8bc4-33d79c5ee44c,Educational,0.8104267393702398,8,22,421,476,55,97.43172997395531,2334
4309c482-d7a9-41be-845b-1944586d290c,Healthcare,0.9835624841123737,20,49,462,725,263,63.956425495497804,7391
5d9b4181-5321-4517-b27e-e2723dfdacf8,Residental,0.5754561445848683,38,43,419,653,234,32.25534296603814,7794
979adef5-feae-419c-bf54-6bc1f60c97e3,Residental,0.9422927128105193,32,12,308,469,161,93.76393285607206,4111
dbc04e21-6c92-4fc5-a208-7985d1ab04d6,Educational,0.40626116747521634,28,17,102,1355,1253,48.787720418553256,3388
0134de42-d7f4-4105-a50d-91e84ae4d6e6,Educational,0.9796953996409453,33,50,198,210,12,65.17677975889669,3388
0f2a019a-875d-4966-8116-65e7f17e9376,Residental,0.6441799773645457,1,15,598,900,302,32.19293637992513,7841
622ec96b-c640-45d4-b814-4c5da91066af,Commercial,0.22281714050957424,33,20,122,631,509,95.37306931295898,4770
abbce934-68c0-495b-b885-716c6724961a,Commercial,0.7001304065384657,31,9,604,749,145,90.34157081715183,2146
4a608692-a980-46df-9d61-62527d239a4a,Residental,0.8565167250536655,17,28,333,1341,1008,43.54286805514234,1937
99f2a4c5-fd94-40a6-9faa-b1cb9c224956,Commercial,0.9528172864251749,37,39,32,79,47,69.69504838873323,7671
70eb153e-8407-4029-ba0f-218d021d3968,Educational,0.15451336451134345,37,38,493,595,102,44.950498936101575,2314
3545cc51-e87a-46f2-a7ac-10574680b524,Commercial,0.2102172440545842,4,32,241,513,272,20.19061450140606,4957
c75244de-b99b-4c58-90eb-7ddee13e73e6,Residental,0.2420252819418235,40,29,297,373,76,37.30858315371278,3455
5e556a3a-5ce4-403c-be2d-f4e7929effc5,Educational,0.40205171364515313,31,24,293,555,262,85.95109713272237,1111
bc48bb1a-cdcb-4f46-ab45-577e51a6801b,Residental,0.10717051133427224,48,41,558,1280,722,77.57421515825561,2242
afbc6a41-9098-4d69-8668-e13363ef0745,Commercial,0.8292519032510884,37,40,391,828,437,68.73318021699836,9055
82057a07-e102-4569-980b-a82795c37a22,Healthcare,0.6420851287944445,49,14,597,1137,540,47.98631974229977,1676
7d931118-2361-4674-832a-e444846e9eda,Commercial,0.04116169954464577,6,32,641,1012,371,36.06656087072501,8189
fddc392c-17c2-430a-8320-54a8f0644554,Educational,0.4766928179171285,21,31,126,356,230,65.05954338979024,8073
7f5279a2-b716-4c0e-85bc-9640485a167c,Residental,0.3574009150303843,4,19,168,309,141,15.893611814976047,8286
de5e6f67-931a-462e-a855-1a66ab770c49,Healthcare,0.1443024360090961,43,48,224,952,728,41.20839619793116,9035
46d7edb0-cbdc-4660-acc7-9780b4adc1d9,Healthcare,0.6799249316701287,40,28,212,977,765,90.10138119633147,3084
fc3d5ac1-cf13-4320-b35f-cbabd7c37f4b,Residental,0.3961122991899194,36,26,661,980,319,17.03646917286602,2693
9440573b-261c-47e8-abe6-ed01f3236f7d,Educational,0.7733349450118814,36,35,289,1355,1066,95.27229135820679,3249
914af6b3-11e2-4c66-90d4-10b9b0fcd39f,Commercial,0.9219696383137281,44,10,428,718,290,69.89431327547818,5830
d5d70950-7c0d-40ba-881b-2e845ba3375c,Healthcare,0.4924800025433572,6,22,521,671,150,18.70795258350489,7733
70f62294-e4ad-4c24-8d63-d79c7bc97998,Residental,0.693234357513169,13,48,63,716,653,73.73757562751024,7543
c53171ea-58f8-47c8-bc07-ba27a768716e,Educational,0.5300333331297117,45,42,486,723,237,82.76678749288548,2687
c1197f23-bee7-4d18-85e1-450190928476,Educational,0.687528678778186,7,37,483,966,483,24.222529255045085,6573
d1924175-759e-4e62-bfc5-5ac7c316c191,Residental,0.3778502778784264,25,22,617,650,33,62.595969593377035,8364
0d825b54-bc71-49ee-a09a-081372a8d742,Commercial,0.0866153549168237,31,1,46,1234,1188,46.77385449065778,5013
dd7cbdaf-97ea-43a1-9d39-84e158d57603,Healthcare,0.9533738776321139,39,5,322,970,648,90.92327434607736,4627
a8438e86-aca8-47b3-be5d-34bc73b85d3d,Educational,0.47920134798875513,43,28,592,1339,747,93.25106030717865,8743
f8946040-be8c-4232-9b1c-b1914dbee320,Healthcare,0.31934514901141886,49,44,558,652,94,67.99841437887235,3134
b52ead7c-62e0-4dde-a14d-4ca68e12db37,Educational,0.9176477786593774,14,16,575,699,124,24.661442669682785,3861
0574693e-0345-4121-82e4-dc5368dcaa62,Educational,0.022078772593906892,4,12,403,1000,597,49.06214789596804,7729
a87e2ef1-3681-454f-a0e6-3b555c998960,Healthcare,0.4248811012351774,5,14,661,746,85,36.790166535970044,2585
70fcc5fa-6a6d-4cb3-8e58-bac1eeb97e5e,Residental,0.040093009660398304,28,17,521,1095,574,38.8072344165558,5155
d153690f-af3c-480c-819b-2ead85feb4f1,Educational,0.7361221001309821,50,42,708,1193,485,23.09140146097556,1656
1f3b0949-cb97-4714-a17b-629b29b80c4f,Residental,0.008729872310294873,36,34,490,869,379,73.58622549577595,8421
91fb5b17-ae6f-4d90-8bf1-861cfbd680f0,Educational,0.4903445380574738,44,50,177,538,361,16.069124516632836,2474
fd5365d9-1ef9-415f-be2e-786d2903a504,Educational,0.06999768933752626,17,8,281,1396,1115,86.36733721468178,4546
f05ccbf4-bb68-4f1f-8f32-d527065f64f3,Commercial,0.09829644891116474,36,17,629,912,283,60.47211882458437,6217
2cb4ea7d-45d2-4eea-adbd-8b01d283c1b5,Commercial,0.7373757166384692,11,15,695,755,60,59.009420084874,9959
541f4556-0a1b-4676-8b63-983506d2f17a,Healthcare,0.48836676878812846,45,43,304,912,608,61.471654982089504,1010
63ae3b96-a47b-4874-b90d-9b17758183a4,Residental,0.4461351698185485,40,31,184,537,353,29.167054662212543,3789
a6667150-2176-4bd3-919d-d2fe105688e9,Healthcare,0.38912916091001903,49,19,265,1163,898,98.4513697290281,4495
382c21c9-8167-4cd7-8913-d6ef1be502e8,Commercial,0.3786779277195751,45,42,282,366,84,59.273115040422255,2476
2b71ca51-ff8a-4e87-a524-4a5d6adc664b,Educational,0.8940937851635947,4,33,696,1375,679,86.00198722438513,8804
65026a7c-529a-45f3-90c2-4ee254d50d86,Commercial,0.6137119116175362,28,1,511,609,98,74.91611154826779,5429
41237674-64de-4679-9dfa-6d40a694fd2a,Residental,0.2193796590179331,36,21,3,1101,1098,31.16159472926244,5540
a3b2bc49-e660-406e-8d88-ab8107d61bd7,Educational,0.40802697317522696,15,12,653,770,117,26.311956795086303,5828
fd876b47-f638-485d-9497-418c4a1492dd,Educational,0.8665306682630356,38,5,320,1119,799,94.81357626650511,6269
0800e245-c585-48d6-99aa-168769278c09,Residental,0.3481787267129599,41,35,57,1099,1042,96.89798020525546,8590
19927f01-a14e-4a05-ac8c-77113cdc6868,Commercial,0.9651449692328289,44,32,536,1091,555,81.83334578988928,9937
96c791cf-34f8-4c84-8542-ce10a64dda39,Healthcare,0.004187048187717313,23,25,270,1282,1012,21.381062373587632,8120
b06b9036-3040-432f-b05a-d27b2f60e10f,Commercial,0.4381606700548001,10,45,695,1113,418,45.33442781757093,9541
55e6425c-d4fd-470c-8471-c9cd66001919,Healthcare,0.7483747006247936,40,3,51,636,585,31.003465254871305,6533
98f770ec-9f12-468d-ad9e-16cf22892a75,Commercial,0.310739050194067,23,9,487,638,151,45.51699940051904,8950
e7da8f2f-bbbe-4daa-81ab-fcb3a8855fb6,Residental,0.9174104171336225,18,19,361,1324,963,28.41939939735725,5390
6e1f1375-7322-42b6-ace7-5b0e7c6ea946,Residental,0.12776651438979214,32,38,412,1295,883,25.328493433697478,9559
6f19cb7b-14af-4f77-8917-af2ceba3c155,Educational,0.6328659380752659,14,38,711,1128,417,82.37289686548603,6491
52eb6178-8f05-4cac-a4bb-079818b98ad7,Healthcare,0.02827743734288113,40,50,272,275,3,92.34128088232468,7253
133b6ee5-6e06-4767-8416-032eff3ccec4,Residental,0.4078180028395293,37,13,150,1062,912,97.8941486223506,1761
a2491905-d5cf-49ae-9dfe-ac331c6ef49c,Educational,0.46933088869009765,43,49,42,269,227,54.67170922525569,4375
0718548d-4a9a-42da-a4da-eb4eeeda2e0e,Commercial,0.1770550573575289,17,36,310,733,423,72.27409253764492,1784
4a756e65-a872-42cc-818d-d2d040cafd1f,Educational,0.8492471780163107,44,13,391,1413,1022,15.591411211154565,3500
e402dc55-b3e9-4e87-b805-abf4884f387e,Residental,0.13600141842902014,36,19,373,811,438,63.9508835943222,9727
29417d61-907c-44c7-aa49-8e1b01ab7d28,Healthcare,0.9380100859775269,24,29,339,455,116,24.457071323207295,2856
dfc5c07a-1be6-4d72-922c-0dc843ef757e,Educational,0.9412359377525096,42,48,390,812,422,30.43502914471535,1711
cbead753-0527-42dd-85b2-c03eb8f9d5dc,Commercial,0.16030888946481703,31,17,528,654,126,97.67013301087395,2972
f2351d23-750e-48e5-abc3-fa98fca20eec,Residental,0.9671978353864207,14,43,134,829,695,73.68321396363599,9154
be3d36f2-1d88-40db-908c-0ec71eb5b112,Residental,0.22274650621406822,28,20,407,1194,787,41.40789576172824,8247
58433923-0901-4dbc-9d41-30f3c4fa3138,Educational,0.5650245200736217,11,15,332,927,595,38.18247813579087,8397
bfac13b0-fba4-4dc7-a88f-c4f7d036f5e1,Educational,0.642061778557041,32,25,273,1066,793,79.29032208916368,1404
062fd8c6-2994-4d80-bd1c-a46f234f4b6e,Residental,0.8368364515170831,1,37,520,1411,891,38.7754850505825,1470
db4e579b-93da-40e9-a12f-8dd2678e68c1,Healthcare,0.42825368447970213,28,19,625,850,225,91.76568816808512,9084
5dea343f-6a1d-49cc-a607-0274aa0d61c6,Commercial,0.08792107821630712,37,5,5,475,470,47.37937809173246,2014
de6053c0-963d-4d2f-b752-081d720e74d5,Residental,0.040668377116987786,11,24,8,798,790,44.368474895550456,6460
00b5d1fc-33bc-4233-8833-79022b649d8c,Educational,0.8763399636615065,33,10,335,959,624,57.641332071868035,3524
025bc821-8a32-48b0-b2cd-60d2570dafd3,Residental,0.3741815586250963,46,14,498,679,181,66.69191686221208,1010
c3b2f370-3346-45cf-ba3c-b06dbefd8e09,Educational,0.5821387987708719,21,14,347,749,402,10.69380740622822,5817
0cdae34d-9b17-494b-a20c-6cb18f8fecf0,Healthcare,0.4099026850099635,11,1,95,869,774,16.646727598999853,2270
25a337cb-9e36-4557-8119-94f4e9549751,Healthcare,0.5950269237357124,28,41,163,1391,1228,75.01207340937044,8334
7394e5be-5bc0-4790-bd38-cedc6d21ddab,Commercial,0.695098251538497,10,11,167,356,189,60.400479168222446,6763
dad4806b-0f0a-415e-8e6d-6b2ec65ba686,Healthcare,0.9062841410534559,17,8,30,790,760,16.44461845153871,9720
9fa3373c-cb1e-48ae-bc36-ed7ef71851a6,Residental,0.18203503848300462,48,10,409,576,167,87.22005084645016,7733
4df38ee1-05de-4354-b572-08761ca604cc,Commercial,0.1011722403334181,16,20,587,1174,587,65.00801797122104,8017
c58ea6d0-b419-47e5-bfd5-fcedde1eafb7,Commercial,0.7976550287105796,3,46,689,1200,511,23.649331570569657,8216
d50b5d92-b4ba-4c3c-8d25-9bc23c62397e,Residental,0.44608647177795424,16,5,542,700,158,74.9111989622554,5630
9f2f385b-99cc-4956-b747-50a8347197f6,Healthcare,0.08076790839382497,36,43,303,995,692,57.90048284827928,3972
716a9d68-83a7-4f5b-a7c0-3cedca6491c0,Commercial,0.4755891092333052,7,7,397,784,387,93.82206442199103,4538
416aaba6-b0cc-4063-aa8c-3bc65055d409,Healthcare,0.45901885296654155,24,43,486,551,65,83.98940750119075,1706
5949e4e6-8e42-41be-ba49-c5172f9dd749,Residental,0.8466405852143514,6,17,610,1171,561,98.8872707290663,4248
84858175-3f97-44d5-9f71-6ed6064eb57b,Educational,0.33471518742519113,9,50,377,1098,721,30.561993702649133,9862
4662fde4-4f92-461a-88db-baefec610821,Healthcare,0.9991962568629332,46,40,552,873,321,71.38543909854519,5476
d78577b3-fdd0-42ab-8218-66ace528bd3b,Residental,0.3440272087812968,12,28,203,736,533,29.23710954144789,7646
ff8af6f6-9fe0-4c4c-8c23-c6751c036d6b,Residental,0.15175492112264233,40,49,431,1011,580,15.687484035149618,6346
fea470ed-4d14-49b7-a58c-59dbdc8ed703,Educational,0.30765187727745646,11,16,346,630,284,31.479967135428886,6264
45e0f58c-ebdb-4f97-b331-6adf3ff53519,Healthcare,0.4986632827215445,49,9,303,706,403,80.13147656368305,2539
4eed4cee-2e43-4d76-a483-f9f7bd4ab6ee,Educational,0.6154091932244105,43,32,38,865,827,86.95846895831774,8811
df0df750-40d1-4cad-ba2e-b356dc21097e,Commercial,0.4590750140133233,2,37,84,1300,1216,78.00930359235983,2751
e2f8804f-3aad-42f7-b49c-9670084c386d,Educational,0.4769556339772346,15,22,708,937,229,81.56525199805913,9356
f2a16fd5-0050-4993-9432-7e38c4b46afb,Commercial,0.0764541852970122,1,34,257,694,437,61.46676797099612,9737
6267f5a5-2cd3-4c3a-980e-e2164664738f,Healthcare,0.7168444664414514,13,38,194,271,77,52.759357956181596,4648
140e53f3-b82d-48ce-915a-5d4a01848ecd,Commercial,0.8326842251837128,40,42,47,286,239,11.369114145318214,6390
ceb2c914-005e-4f8e-87d0-504bb0e86d77,Commercial,0.3059347949596042,18,46,705,1236,531,19.138935476962217,7247
57a57acb-bbdf-4a47-8a9c-5ca04b91b278,Educational,0.7422907927108762,27,7,23,27,4,93.21845666181926,4256
50f3edcc-1466-4033-a41e-ab43f2358c48,Residental,0.9063399417999292,14,2,445,1025,580,49.9567750460879,2253
482b97c6-d9ff-4115-ae25-68a2e2542e53,Educational,0.3206861324962532,35,45,70,705,635,48.154213451171934,9418
becb3325-cee6-41da-aae7-98bb8e5a2509,Residental,0.6776697581825889,26,26,689,1418,729,79.69042886179413,4712
2a3a4c87-d1ea-4ced-9279-707bdae8f7a8,Residental,0.9058190666275421,17,12,408,1320,912,84.00642024367468,1728
6ecd4955-7671-48d7-8363-b6316f0be873,Educational,0.4493843450281291,6,24,366,602,236,15.617238093637383,6357
d5149c5d-f3b9-48bd-b19f-8d31665c6f89,Residental,0.3310135487061995,26,1,159,999,840,55.15800645953888,5895
8279a645-136c-49ed-a7cd-3c934341cc9b,Residental,0.2732384544142439,45,27,420,1241,821,17.804695616515385,1028
4de57f0f-ef43-423f-bb63-0a690e89ae5c,Educational,0.6650023341483815,40,3,272,991,719,76.48609865391622,9741
9d5b6169-67a1-4ae3-934d-9d69b4fa4c42,Educational,0.6605324046967009,41,12,47,217,170,60.03016436156859,8484
d78ce490-fd5d-42ca-ba06-97b82bff8b61,Commercial,0.9449823588275335,37,25,21,538,517,41.10992886822123,8833
557e5ebb-4488-44fd-99db-c8f18c6f7242,Healthcare,0.5527837579251459,19,18,307,905,598,30.50032097066947,8319
56c4f4cf-0d90-4db2-a1ce-438e275e5d69,Educational,0.8270850150182327,16,31,4,1316,1312,34.856298145055206,8274
7e411040-8e87-4ae4-ade2-3e414fd00ab2,Residental,0.03001596031438858,1,50,155,277,122,53.743609820718,5816
3328bc8c-839d-440e-bd7b-fa8f7a736b76,Educational,0.726233393691306,19,11,74,468,394,11.121038386056393,2394
3e8ecc16-dae2-4647-b9d3-35327fd7eca9,Healthcare,0.42814798604010285,37,36,44,373,329,92.7914986122913,3448
84051918-0693-4207-b393-17ea1c25afb5,Residental,0.7230505597451116,17,15,295,327,32,32.47501245373426,8266
ef072b6c-ff33-4013-a2c6-e96d77ae831c,Healthcare,0.9603149208154652,19,21,287,725,438,90.216973872032,8410
e53b74a8-3d47-4e6d-80f7-d637ef22b807,Educational,0.7144095150151131,2,33,450,502,52,90.78121052915664,4391
a886c24f-9d61-451b-869f-6854c385f50c,Healthcare,0.5224839775982847,33,47,2,429,427,19.90687515045722,6224
2de36204-02cb-4ffb-9e4e-fe2eb88a6d34,Healthcare,0.5979190340901211,26,43,233,1314,1081,77.82872009909181,9529
f06a93a1-07e9-4fa9-a282-6433ca372ea2,Educational,0.9731397609038798,48,22,371,523,152,34.90485219266436,2251
3907dcab-a627-49a8-afa7-a3f74239cb27,Educational,0.7968905389593643,23,41,512,1293,781,80.68797287944732,3438
6bce5610-0f99-4578-a68e-e99e583709cb,Healthcare,0.18037114882370908,44,37,531,940,409,87.53807760395875,2995
cd615a83-45ed-4089-9671-d762cb19e37b,Educational,0.05998116874153181,50,43,153,341,188,18.669223357042192,4011
0045d2b4-3abe-4594-9232-dbebc451c9fd,Educational,0.07511784521071263,37,16,391,1252,861,68.00855652446702,5901
fedb4500-0727-4b71-b37b-99c36bf2623f,Commercial,0.015269056500563316,42,35,64,1198,1134,90.76868225887488,3355
13005080-c5e3-4504-abe8-9850d2233b96,Educational,0.8293547177437756,2,28,491,563,72,23.839741891681843,9517
844d714d-dc2c-49f8-b5b1-9267eb6af195,Residental,0.9658636791400012,1,50,379,967,588,47.00927605806901,6126
5062e97c-9d62-41a4-ae31-aa23e20eadaa,Commercial,0.29488823735629754,48,6,227,442,215,46.9860059138945,1512
45f0bb89-87a4-4944-b4aa-843140e03248,Educational,0.09113095039122343,27,18,545,1362,817,69.37070480226446,4092
7cc68e8e-5e32-4efa-ab21-459d012b7ac7,Commercial,0.2422749065302251,29,39,443,595,152,24.82655910351802,1314
244194ed-0faa-45aa-8ff6-e9408a3b05bd,Healthcare,0.2514121990761251,50,46,177,1381,1204,85.3296232044124,4062
9d0b44dd-ee68-4a5b-be4d-95466e6ee490,Educational,0.534639180292602,10,22,335,866,531,72.24664855201786,1084
6f4b2340-e87d-42fc-b23d-ad8a5ccb9d2a,Commercial,0.5683153491416673,26,44,445,966,521,48.59018580427031,2844
168e91d2-4954-416c-812b-09c40f7de4ab,Residental,0.8743712954428079,44,2,392,938,546,98.58079094513278,9003
d0dc0e3a-3f87-4b0d-93a5-80493c64b26f,Commercial,0.464096002181999,36,20,579,783,204,30.683479421299428,5866
b1e23ebb-a86e-4486-8349-81316d4f31d4,Residental,0.9960439251667742,12,16,10,1201,1191,15.024266720354383,7440
ae0f0021-a3bb-49c2-afdc-71eded07fdc7,Commercial,0.036629251265241525,4,41,49,129,80,15.774111960503825,9436
6fae7891-e1c7-419c-bfe1-51efafb674b7,Healthcare,0.8230958135970652,5,8,253,880,627,35.95876103826663,5842
1bdb3f0f-ddf9-47a6-ab30-8f051308e550,Commercial,0.6150510714795527,23,28,169,1418,1249,32.29044334088515,6917
54fb2b9b-d107-4711-9260-6a12f3d98141,Healthcare,0.9247097077315527,32,2,720,1331,611,58.196516634725256,7196
5549f7a3-d017-43e1-9a1f-e99981431ee8,Commercial,0.3994892498289614,41,50,671,1299,628,10.093586596452662,8867
57fc07d2-cda3-41b8-b33b-9813cad4857b,Commercial,0.1709890305206878,37,7,381,873,492,48.04494228343474,2987
fe86f9a6-ea2d-43d4-8518-5db3d5c45feb,Residental,0.13019434894812543,27,12,47,628,581,31.620966747222226,1672
e22477fd-b1b2-4f44-9647-23b1b7169a1b,Healthcare,0.24418454518399002,1,10,501,917,416,92.22501950131009,3327
52db15d7-da9d-4045-9ce2-e045ab13c520,Commercial,0.785482322642383,1,43,169,996,827,89.62981114537926,8240
2da62096-95c3-4814-a636-beb1b63078d9,Healthcare,0.9610932566743506,35,16,517,710,193,37.95807320112608,3616
a3d7aa4a-4d5e-4678-8de8-1a4d5db78c9f,Residental,0.7808902820897867,20,36,561,1106,545,76.62800885202458,6191
57dd8d41-5d12-4fa4-8239-0f9407b0ff33,Educational,0.7074924696126283,20,6,251,1171,920,92.44843720050049,3633
1017be0b-3549-48b9-8821-ef0cceea3167,Residental,0.7114258659705103,31,1,253,1256,1003,35.2056702672872,6403
e0c1711d-14c9-4814-a9cb-63b6e0e67064,Residental,0.21814795066411097,9,12,505,1426,921,68.96529533578284,3899
a04c9be8-3803-4614-bdd7-3bb6522ed360,Educational,0.47030985434628114,7,23,587,895,308,56.98553025726996,5193
a21da557-1288-41c1-a9ab-e7f77a12c516,Healthcare,0.754557816910806,27,6,481,686,205,25.923784017856626,2578
2ba4160f-a47f-413c-9a11-32004389e1e4,Healthcare,0.30314502634432305,7,32,232,1372,1140,71.95800365634456,4328
59ccfcb9-1393-4f3c-bc23-5cdf037b3b19,Healthcare,0.19296399216850246,25,36,111,339,228,16.397405918435187,7036
0fe0d549-3489-4eb6-930e-267e910ae7ec,Commercial,0.8900284797363728,45,15,718,1281,563,41.90584159306214,9763
8a6f10a3-04b1-4e76-9574-a31b048de247,Healthcare,0.28495760463272424,36,11,480,750,270,31.977571154203545,7576
73016dea-1cb6-4dcd-a0cf-962ca9e691e3,Educational,0.895223533391207,17,34,416,946,530,53.83118208358557,1823
d9fbff3c-7ab4-4cd7-9500-405018e7e802,Residental,0.3882166071141373,21,24,471,955,484,10.305664090359702,7957
df0746ef-e219-4ac5-aaf5-decd04790766,Commercial,0.2869838095242595,37,7,297,993,696,90.5720454968425,5810
aaa2a50f-08b6-4632-886f-e90f6bb432c9,Residental,0.17271180416524967,25,17,613,686,73,78.81535493976436,4626
c4be57bb-587d-4fdb-bd57-38e48df7421e,Residental,0.8500437324874499,9,45,370,644,274,23.3764939098332,9548
6a0eb3a2-5890-4590-b8e8-dd72b6df60ef,Commercial,0.6915458406689713,15,10,637,1222,585,77.00870601464516,4043
b1533ffa-d854-4889-80cd-205f4fd696af,Educational,0.3903357312904038,13,14,30,1284,1254,71.14403066511792,9384
4f8bede8-6f3a-4dcd-87bb-17b915fa3a08,Educational,0.8348723584122024,36,23,80,274,194,54.8602893899409,2580
fa1bbcd9-52bc-4412-8c12-77468c5e8978,Educational,0.004936040690528887,26,10,240,587,347,31.642618564337226,9312
6d2d994e-0376-4cb0-9a53-ed3502be87ad,Educational,0.8424584404943476,21,35,18,361,343,21.844231761162696,1287
7c8cab31-6a3e-499a-829e-62fb8e580222,Healthcare,0.3928492319924891,46,34,276,832,556,52.83101356103838,8537
1698d54a-1fdf-4b36-ab38-6c83a8ccf51f,Commercial,0.46787176726010116,11,14,31,213,182,82.14188091110587,7114
58b1d974-e3f4-4013-a724-6408571f1192,Commercial,0.5372563299900013,12,27,152,477,325,21.569515322102454,8953
5678fbea-a234-4a49-bdff-b64e94a95fe6,Residental,0.3305395791597139,9,18,146,1073,927,47.2003713316596,3794
edbb119b-e85e-4bcf-a4a8-8ca05b546a97,Educational,0.6218399771819609,47,31,167,265,98,85.80876943349186,6074
1f86861d-b588-4d68-9ae5-c633011daa18,Educational,0.6687281815355675,39,3,5,1353,1348,28.456995316784646,5759
cb976a56-85ce-4f22-904a-92547d652c8c,Commercial,0.6648213988317365,4,26,587,803,216,54.72495235748488,8404
ebae1d7c-ebac-43a9-848b-e32db7a1a6a8,Commercial,0.3939978834895558,13,8,111,935,824,29.34072639379071,6861
4fe089bc-3e20-4dba-8844-82333714b3a2,Residental,0.5883588321131059,34,28,397,856,459,77.9311407043832,3304
d77e3621-8be1-465b-9b80-4093dd148f79,Commercial,0.672681846088004,43,46,24,1276,1252,54.6447431303018,6539
7f0bc05c-28dc-4365-89bc-eee522fea857,Residental,0.4994548445667636,50,1,344,741,397,98.99028792917744,7575
c3bb5f1a-03bc-4f8d-92a9-0d856eb2de23,Healthcare,0.6238809277516695,4,36,137,292,155,34.802226171421765,1133
2f5a23cf-065b-4188-b6aa-cb762059bcf1,Healthcare,0.265360806396315,27,16,192,637,445,22.209956959871803,6253
2c742314-5ee1-40db-a991-0faa7319ec07,Healthcare,0.22959715479037313,28,29,412,751,339,49.778428769826036,1648
615e42e5-d2bb-49ff-a866-d7a2a2fbecab,Educational,0.3149826857655438,23,46,661,861,200,90.50955671664487,7057
1acd5938-ebb1-4f25-84ea-d99ec799e90d,Healthcare,0.35775213856940136,34,34,640,1164,524,53.81790938385079,8420
55bfd8b1-9447-4a05-9016-b61f022e2d9a,Educational,0.765541148996428,7,23,205,1189,984,61.737644008565155,2040
cd002287-bcc7-41cc-94f3-3b0972352ff7,Residental,0.19812651834212924,29,17,429,914,485,14.487475253743858,6962
42911aac-9f9b-4162-86c0-1b92d7d9caa2,Healthcare,0.3994091523983515,11,50,158,280,122,39.0347791990211,5804
d7f16c3a-6995-4979-accc-22b36a9fb525,Commercial,0.9124619967296533,10,26,175,602,427,83.27073137662943,7060
b92747bb-d15d-4dcf-adb6-6fd934d3673e,Healthcare,0.5711519002089723,39,29,373,738,365,91.98667773080811,9505
d56ab9e1-77cb-4ded-8bb0-67c2141cc150,Healthcare,0.02598095113912169,32,12,460,979,519,50.95760173346645,1520
22bd80c9-e092-40d6-8e60-aa744437a6d9,Commercial,0.7896879181217891,10,15,620,1029,409,29.89653730178627,6698
17e859bf-ada0-4627-8d80-edfc2773c46e,Commercial,0.13387454585887526,33,3,132,606,474,19.160566046830105,3230
1e6f61da-d41b-4574-9fe3-e9a7f93199d2,Commercial,0.708349653005358,12,26,523,1070,547,42.47895074788438,1110
a28b8f96-bd16-4cbc-8115-f40feff678c1,Commercial,0.7040983281169981,9,42,280,653,373,86.60486249607153,7321
32ee3d8d-a688-42db-94fe-a7b7155cd08a,Residental,0.13407380085836673,31,44,349,698,349,85.59215338107259,4523
94059a00-989a-4b36-83eb-bc6b679aaa24,Residental,0.622420484324776,26,5,173,365,192,97.27690001194155,8612
17b04976-fa10-4fdb-9f82-4d2be8ee475b,Healthcare,0.13733276403326156,13,35,322,1190,868,62.64244733207127,6761
84f9ab83-5f31-44be-b1fa-25d264c13118,Residental,0.4005013629587154,31,11,628,893,265,72.41384863281334,7953
b6b23f80-f67f-4b1f-8fe3-772d43c3d6f4,Healthcare,0.9825550458996738,41,18,264,1326,1062,34.11686963155549,6559
755fe75d-be21-429c-85b5-6217b69e19f5,Educational,0.15857037900584792,47,30,426,1432,1006,86.51064280956714,9235
8df0c0dd-9279-4941-9b4c-8e9562d76494,Educational,0.8992254684721831,1,25,433,702,269,45.459100428091844,4588
96b1a195-408d-45f5-a12d-4ad42ea666cf,Educational,0.8970739076490544,46,43,573,907,334,45.768611127338524,4675
a5c70a22-c2a7-486d-a446-61713cc772d3,Commercial,0.6717474075396332,22,40,626,1233,607,20.7419179508547,1965
fb6d7237-0ee8-47c6-a190-47adc3b0b525,Commercial,0.4651753640876406,37,31,387,1344,957,12.747795558868482,7477
9377d62c-fb25-4427-b178-c058f988f75a,Commercial,0.7936686189955764,14,19,638,769,131,57.981251316358076,5340
d0ba96e8-cb95-411c-b2ec-e6e212993cc7,Educational,0.47293859918302084,9,16,662,1306,644,12.59681990771763,3831
64b82526-83fe-4a7c-9ca7-ab9922de7619,Commercial,0.7799973405049109,10,23,356,1217,861,38.90827544252429,4507
d22b179d-91ee-416c-a0b9-9c4bf6235e69,Educational,0.6992746150507606,17,50,74,402,328,19.33894065345963,9010
3d1098e1-d94d-4d1c-af75-e1ed90723197,Residental,0.18884255581261267,16,43,598,683,85,84.78541639088492,5415
3c068753-c707-4e8e-b52a-b69e89b53d5f,Residental,0.43997181176017575,19,42,623,1385,762,68.79749111823682,5604
b7831ed1-59cc-4664-9e59-4a3b9a2a3e35,Commercial,0.8176319276535233,13,50,691,876,185,69.63485822607396,6937
1a286959-9aaa-47ad-b4d1-3e7325efef6b,Residental,0.9460076442844467,8,38,622,1320,698,80.85457862424718,5344
4bce48a5-ecf8-406d-a7e2-4f9cc14eac07,Residental,0.9093130933454265,8,7,481,1436,955,74.1346068686269,5772
59ecf0d5-b9ae-4ce3-aa54-3a660a804fa3,Commercial,0.5427706543986962,17,28,470,776,306,38.292522106576214,3890
139f5d53-faeb-41f7-8338-f59e4b77fdcf,Residental,0.28419069696833277,25,18,256,669,413,82.0724145577094,5538
597c10bb-f125-4b21-8768-d5c974f8cdde,Educational,0.9031696723756715,28,28,663,704,41,27.00346320496629,4843
e747c15c-40b4-4f3d-b7d7-084fa8a7d537,Healthcare,0.5261566018847849,18,5,712,1386,674,27.20285023290983,5111
767d4101-df1c-4a80-9bb1-5da17afc86d5,Healthcare,0.4509117251213597,41,21,318,930,612,47.6656653319427,5095
4f3df701-5e13-48ff-9a8a-9750b23c3e9f,Residental,0.8911169236432156,42,49,304,1177,873,99.24854959100962,6511
ed63ebd9-fcb2-4115-b58d-092e38942e9c,Educational,0.5863822375748048,27,1,400,511,111,13.496790549421886,4818
2089a94e-36f6-483b-9b98-749704adb610,Commercial,0.6967679156967116,45,46,1,1302,1301,22.45021928024476,4484
e24cdbc9-9d0a-4e20-a5a6-4236821152e0,Residental,0.6758919074596814,14,16,213,857,644,27.965538724555092,7374
f8f8244a-2308-4eaa-b3a2-2f4758d81647,Educational,0.9066225183049748,25,31,543,1098,555,62.930514971603486,3946
3315d90e-937a-403f-afef-f20a5a5691c6,Healthcare,0.7662396778557488,35,9,235,1357,1122,66.06602300586067,7793
38377bed-bc77-498a-b57a-e3aad1fa1de0,Commercial,0.20617667659901795,19,43,469,475,6,32.615824659542476,1227
bc56d2f2-8144-404d-bd76-8febb72cd7f9,Educational,0.23389611586102887,11,25,359,1230,871,19.192705123662925,8482
7c5b2641-ee97-445e-b812-bcffaa09fdb6,Educational,0.12922042602156192,45,4,716,891,175,44.91613620183836,8470
06a2d0a4-1731-4bc2-89db-13e30fa59171,Educational,0.0687014671795636,14,13,525,1042,517,84.42322606030875,2495
089bab46-022a-4044-9c63-6bfa8c794cdb,Residental,0.29961403720275415,22,16,9,412,403,55.68294760763404,1776
59fb39f1-f55a-4ba7-ad28-1ebc6bff8e11,Educational,0.689459067882683,36,13,668,1275,607,89.14518329468183,7401
58d542a3-1a60-4cf1-8ea2-edbf10d4dcc3,Educational,0.19332417173179517,12,9,482,503,21,95.52378786176529,9039
ca3a9887-cd7f-46f9-a1e4-d7072fcc7b2f,Residental,0.5297593425642132,8,48,671,925,254,45.02732232613885,5007
eaf4d51d-ce06-4992-acd5-6b2d1e64dbda,Residental,0.24321276817679627,8,31,621,1221,600,10.308946022266703,9426
b43df7b0-cb0c-4f7e-a33a-7896db1ea27d,Residental,0.1912565838196434,14,5,189,1060,871,88.01105156538166,1764
a8ee055d-9071-41c7-8afd-d2840b47eee0,Healthcare,0.7661537525868586,3,27,671,826,155,32.99105051851109,4171
f3fcbc1f-79c2-424e-862b-bc995f384ca7,Educational,0.0737573898499746,14,13,365,701,336,96.05128461307153,5672
e8246aac-5450-4c96-8515-62a8275934c8,Residental,0.06250164803082714,23,44,525,1376,851,94.0965811688016,2560
4f48a8c5-6df4-4679-b8eb-621e142623ca,Commercial,0.2967122907978478,28,27,411,1384,973,40.19822664228406,2670
172342fa-21b4-48da-a3d6-f2c4c12c6b5e,Commercial,0.7674005270606183,33,25,189,1207,1018,54.591652098699576,3950
ccd28ca3-e517-4471-843d-13ffa43bd013,Residental,0.23224121781774187,33,36,380,635,255,95.06393371994703,1716
c3ea2e5b-5677-4f41-a5b3-074690e63ae8,Commercial,0.39151312565390983,18,46,637,699,62,82.61399832888002,7397
f0a92797-ec23-4d29-9d52-434a4b2b5d81,Commercial,0.3724484094786159,31,49,101,1370,1269,72.51128364303293,8564
5f4a68ee-97e9-43b4-89bb-a61544aecf51,Educational,0.18016601611617633,25,49,413,629,216,30.983942727542406,2455
b913cf5d-e192-4fdd-92b7-ddc6dacc8875,Healthcare,0.6289675457830225,45,32,306,920,614,25.427824127129767,5989
0c748521-0755-489e-a57d-c002956868bb,Educational,0.256612186793197,45,39,189,1362,1173,91.24408696245762,4921
195fa8dc-61c7-4241-9d67-75d49e5821b2,Commercial,0.9323701921459706,29,30,188,1203,1015,59.17800448751687,5812
4df4521b-9105-4360-b972-30c499372561,Residental,0.8073971554501009,37,8,550,625,75,44.465899890922444,6499
6d22ace6-743f-4478-b3ce-439f7867a468,Educational,0.8942417426326082,43,34,91,930,839,24.72441384177244,4053
75dcc29c-cde2-4041-8906-8c5baf4c8252,Healthcare,0.08987166277612957,5,26,674,1005,331,82.25561512549726,4228
563a07aa-b283-4317-8d04-ed50e2726586,Residental,0.4838558796287926,45,23,192,1389,1197,53.91357199220755,9180
c5780b1d-f9b8-4bd4-a7fd-5a071df45473,Residental,0.020442781883760697,4,40,178,1367,1189,42.23285363682669,2330
03c9c613-5990-44b2-aa52-1d5495f907ac,Residental,0.667249198926466,41,42,162,812,650,17.687928621776535,3748
90bcb8e9-714d-4d84-9808-9d0c0e4ce2c0,Residental,0.5468980058775043,25,26,689,1278,589,86.56204924268958,8767
538d59c0-7c77-4ec7-bf7a-3378eb78ef67,Healthcare,0.6608535982842121,37,15,471,1031,560,50.67015227233622,2115
e1bf73b7-5005-439d-954d-615c5d4a15fe,Commercial,0.12552584134062827,25,46,143,473,330,60.433823242594066,6974
043f0f34-2857-4323-92d5-31cb1ad146db,Educational,0.8616150215660192,45,6,321,788,467,80.5467810932802,5738
62512b20-21e6-4177-b833-bfa15fd6521c,Educational,0.9016744286033254,10,14,377,1085,708,30.16945559199209,5134
8dba19bf-2007-4077-af1e-1886ee9afa50,Healthcare,0.9084399649129345,42,21,313,953,640,35.65419564602239,4052
1c1f9653-f453-46e2-90a6-d65dea5ffb2b,Healthcare,0.7056740874955505,5,36,413,1067,654,47.907307740091916,2480
a7e1b3db-50da-4932-a663-c88120f1a5fd,Commercial,0.5803719738881311,19,23,96,1402,1306,78.53611881328725,8308
3a06a5fb-31a6-4552-898f-74662a1d2062,Healthcare,0.7268801093271653,3,31,612,832,220,93.53211408267468,5315
229c9b8e-3c2b-44c1-bad0-dbe224ee806f,Educational,0.39854512787973284,25,36,602,893,291,70.2888663683296,4123
b6a07388-2532-4c38-8be6-6b4f295643ff,Residental,0.9687181909949841,22,21,383,1357,974,83.04219599231351,8177
7c148bce-3fd3-423a-aff8-c03b59b06f72,Educational,0.17348724745451383,20,38,372,918,546,12.925979195709134,7295
243924c7-e2da-4715-b7ef-c7be610120ef,Educational,0.619300445709253,42,27,698,1274,576,41.918007301048874,2660
a36176f1-e4ab-420c-bb50-88ba745a1205,Residental,0.04740353007173781,5,38,494,620,126,26.774785272705238,6125
c678e18d-cef0-47bf-816e-64c1e262ec6b,Educational,0.9220222876022056,37,6,289,1176,887,82.50906502494794,5108
aae431fb-60e9-487e-bec6-7ff58c47c7f8,Educational,0.24180238961409217,18,9,253,1198,945,73.86325661221858,7511
1ca5a5ce-4fe0-40ad-8264-c479fc63a43b,Healthcare,0.7002611761043702,26,29,469,729,260,61.71005788306762,6966
7fd0bacd-f4ee-4aad-ac49-762cb735800d,Residental,0.6951163333372277,43,17,33,860,827,34.042705723561724,8900
04e00503-827d-4a18-ae2d-3f775ff9b589,Healthcare,0.4375156044259735,7,43,155,296,141,66.17812997810411,9285
347dd041-3a48-4645-89ae-e35883bb11a9,Residental,0.6505990153779168,35,8,96,389,293,26.549590040782796,4115
d0d7540c-13ab-4877-90a7-db991fc64642,Educational,0.9786000391061334,35,29,38,1278,1240,66.9884091012959,8192
111619be-9344-4082-b79a-e886d9fef1e3,Educational,0.7795128975819394,17,32,40,202,162,39.52217210647346,3469
1d4d69f2-4d70-495e-abb5-eccd0464845d,Educational,0.9978823598258062,34,2,132,504,372,77.48688740753151,6592
99600863-276a-4728-8dde-f0ab3a2f271a,Residental,0.10706545347342378,42,23,226,656,430,82.96026359031296,2852
61012e36-4c5c-439f-817f-23fcfe34d6db,Commercial,0.6898283220114002,39,10,579,883,304,10.314949792019203,2319
0f49e889-464c-498b-9178-12847e688c48,Educational,0.9786565091601249,47,2,376,1105,729,79.04838261253911,7961
f8fa62e5-5254-4e88-93d5-e3b9f5c1d210,Residental,0.3779986681123434,12,25,671,893,222,72.88386259340774,9112
6deb5bbc-7add-498c-a5f2-3e3ee9f3a489,Residental,0.120045977967833,11,3,17,1101,1084,84.52522176114705,2627
7784e91b-c842-4bfa-8c11-aa0262d21d13,Residental,0.34538900184860943,14,3,97,1056,959,51.710916635311236,4982
5de67128-41d8-4ef0-adaa-7f2f7a5f7e2a,Residental,0.76526599240443,32,9,609,1234,625,74.3375034299137,9176
a64c5dbc-c91a-4652-8f9e-cc96e48b0dc5,Commercial,0.06136940528942947,18,9,626,1142,516,83.74162224256882,8061
6f565189-28ec-4adf-8c0b-4ed38172e68e,Residental,0.9325587254923792,33,30,166,968,802,37.1672059993255,1778
5c8b73b9-963f-4b71-8bad-8591f4f5d1b8,Healthcare,0.9787317121853452,24,29,596,678,82,57.9009544477932,2487
a54c57b8-2b57-45fe-8e02-178fd7268aa2,Commercial,0.23178523442634968,42,49,672,685,13,36.292456900990594,7498
c750dbd7-47a5-4b01-a363-040b00cd794a,Healthcare,0.7760491610917092,37,41,138,1420,1282,71.27614802159337,9879
86dcd340-1287-4228-8b46-480522ca436b,Commercial,0.5415498982137186,24,27,425,809,384,56.59533371790012,3115
5eddde36-95bd-4988-b290-c1caa37228e3,Residental,0.6250102568136429,48,14,115,269,154,77.6319792202559,7182
f368c67b-6a8b-4e96-9c86-760d8eeb42d1,Healthcare,0.39238649814347126,43,2,586,596,10,34.541910838481726,7190
4b73bb1c-5249-4914-b9ee-59151f3d7293,Healthcare,0.41330998606228064,42,2,218,1110,892,51.44558376161606,1178
ceb99869-d805-472e-9669-7e657e747fb8,Commercial,0.9119082823258058,49,7,684,973,289,93.03805850672934,3352
dba08009-e4b9-4b73-9758-a303e7466571,Healthcare,0.3698042023420173,12,23,188,781,593,95.20751610498174,5971
37d831a4-5367-48a2-8863-e6e2d55a279a,Educational,0.4227234487390237,25,7,14,810,796,92.42184100081916,4565
0efdd27f-c6fd-4c4b-a8fc-34588e9cdd3c,Educational,0.19408107777608763,14,15,258,1175,917,77.45982575418638,1462
2ffd3e91-e5f3-4928-ac13-fdf50f29bd06,Commercial,0.39603319815899063,9,9,239,1058,819,42.2003959603717,7837
ff93db6b-4c56-4ffa-8387-9432fb45706a,Educational,0.8644103923517693,29,2,496,852,356,32.03797630752817,3595
c84e61ef-e306-4921-be47-633d07e3015c,Residental,0.1874056890061725,48,28,223,1323,1100,68.79587519757995,7900
ca751ebb-9c5b-4812-8f12-5421c78bbcef,Educational,0.2400545250713637,12,32,682,1363,681,79.66738604431208,6070
4668e1dd-33b4-4a10-aa5f-1e915b808a49,Healthcare,0.4852417913032474,18,19,693,955,262,86.7420932605392,1263
2f53a421-a86d-4dfb-b829-6d179b50bf82,Healthcare,0.7852254778517442,49,40,661,1079,418,31.80694419492187,6985
046fcf29-40c0-4d96-9350-15ee20858877,Educational,0.22324106686273248,30,46,651,1141,490,76.94595238284825,9692
4ec2f689-125e-4b9d-bfe4-0f876ccecd75,Educational,0.08231772660809866,15,7,598,902,304,91.95989182090851,1186
35cc6506-4916-45ee-a656-719fbd68f70c,Healthcare,0.8179344270225286,12,6,346,699,353,85.54328784389428,4364
28acb915-f0eb-4af2-b58a-231ad1ad5225,Healthcare,0.9330307127000216,1,28,574,1134,560,98.67194383557882,8907
3886c2b5-13a0-4b00-82e5-565cede3f207,Residental,0.7009568242249734,47,44,606,1214,608,19.705900687447166,6215
db5dbe99-be45-4b12-991a-235328a302c6,Residental,0.19589712614954324,21,35,133,273,140,84.815833907052,7897
7e928424-d530-46a2-8bb6-eb1e93657b95,Educational,0.9203309243260867,34,29,644,1310,666,29.08668152394052,1473
d8533634-5441-4bdf-96b5-10b5808dedbd,Educational,0.358822422997504,49,44,386,557,171,61.53534012045721,9963
85d24723-47a3-48e1-b512-8237c91a0e53,Educational,0.32192139625898,46,3,284,903,619,30.83001450348874,3371
45429eff-6500-4b3e-9af5-a5edc4c57fb9,Healthcare,0.14154100218191645,19,25,293,316,23,10.6622929226079,7737
72dc04a7-0932-4170-8e3f-5d496b1315b2,Residental,0.31779747379940704,1,18,183,606,423,69.34121709886048,7028
1ff1cb11-c5ef-4576-b349-53d8e7a00654,Commercial,0.6143393096398185,17,13,392,726,334,28.487010704310517,2219
3d2667a0-fab2-4509-8afb-428e0160f39b,Educational,0.923092538062159,17,17,426,1055,629,52.712744386205166,5418
634841fc-d502-47e5-a7f4-25ccfa4982b4,Healthcare,0.8963848114267603,2,27,145,1303,1158,57.17687703167194,4579
395d756f-a9e4-45f8-b118-187ed4496f96,Educational,0.41372419810286476,1,18,337,830,493,41.50079239628238,1035
722313bb-dae5-43e0-af26-6c100aec4bdf,Residental,0.04081367547579762,42,44,325,1435,1110,36.36880015330953,2408
f1a8f581-5e48-4453-b210-c47d23c169e8,Healthcare,0.3250904891981431,49,36,141,1367,1226,75.75845007927602,2340
ea9724e0-f706-4e14-8c99-f1f273911a1e,Educational,0.529390433836802,47,24,168,352,184,75.96104865693235,1351
e7aad4bb-85e2-491c-be68-b77229a9553a,Educational,0.7470150150228344,41,9,183,836,653,53.051359409846825,2881
e9b5b4dc-1627-48c7-8849-13544b533bbb,Educational,0.5728424542721149,29,44,423,1022,599,46.14681492411736,8028
0c86ed01-1c26-4dc0-9747-e6ecae615e88,Educational,0.4643044837890563,39,30,85,379,294,47.181789304289865,5708
331e4be4-450b-4ee7-bf48-d4817d7d59a5,Residental,0.9378625469256305,9,27,624,672,48,64.67060795802784,5237
5204ec01-e28a-4687-89fe-5e03f484e0a8,Healthcare,0.04922307353051514,17,8,568,699,131,92.82797740063035,6211
1f9364ff-1640-4d82-804c-187c9fc28721,Healthcare,0.2623042038762001,13,29,615,676,61,50.63022713740897,1555
e59694d2-56a5-43b3-883e-593b6a71988f,Commercial,0.038469700565500364,19,30,323,973,650,67.67135371547889,5036
eb838f0a-d4f3-47ab-b065-5dfd9821f5a2,Commercial,0.7858606588806207,43,36,523,1412,889,79.40019258822441,1769
4dee2ba6-5196-4d0f-af4f-05e0e27f4cdd,Healthcare,0.08777956479295346,7,39,344,761,417,24.113531636466142,1573
be0d2d06-a596-447f-8d5d-072ee5b06ae3,Commercial,0.9683181321615227,11,46,164,261,97,86.2204373168682,9705
178a2fcc-e6b0-49ff-8679-3c3cfba0c457,Commercial,0.32617290156162293,32,20,168,318,150,70.99527471840167,9447
4e4294eb-ab08-4e85-b208-6bd8eded6366,Healthcare,0.0328107308829616,7,25,75,174,99,70.38424747572427,2708
c8d25f22-d908-488b-99a5-5e5df7a4177e,Residental,0.5792998452092997,12,39,594,723,129,97.1046482941445,8171
18a83bc9-74b5-44b5-9855-54840823779f,Residental,0.8011076329842112,49,32,517,1293,776,20.99894870774296,6143
683c2e00-75dc-4295-bdf2-cdaa7e58d229,Residental,0.8512151894600914,30,49,583,703,120,46.953455449523766,6904
178002b5-38d3-4790-8e91-3ab67a13d3ac,Residental,0.003344633436235034,24,3,442,541,99,82.68668740178899,5610
dec5a408-88bb-44c7-a5f2-88d9b40eb4c3,Residental,0.9083046098872591,39,3,315,909,594,57.451339338129465,8088
ceb5b07d-0a21-42da-b69d-708604c6274d,Educational,0.40464943651095586,37,8,484,749,265,26.458130873145397,5324
19ff9c37-b09a-46ea-a2c6-616166b7c986,Educational,0.17089178230963653,37,31,720,782,62,25.49925533576506,6238
6f1b51de-23e8-4f78-836f-1479ca134bdb,Residental,0.7012194018293033,9,16,645,996,351,25.57149403782492,4825
3d69a54a-0cb2-4e19-9ebc-8ee3e6299fba,Educational,0.11938867400559616,30,25,208,449,241,52.35714006888804,1635
61514622-0f44-437e-8bc6-3ce429b3d2ff,Educational,0.9760286516230402,37,8,11,50,39,82.36256398621775,9083
6af0ddc9-bf91-4152-a5ec-28628fbc0b03,Educational,0.2541486121804388,30,27,64,496,432,57.301504718540656,1099
2050bd26-2aad-49bb-b44e-e711d48d5399,Residental,0.44728552202989547,7,1,669,1304,635,23.717834859462876,7960
9e084522-61d5-4508-b765-3a7d80224dfb,Healthcare,0.705976930832129,26,11,31,1039,1008,77.2193717647292,3005
1e464371-e39b-4f9b-882c-15c2a149dcfa,Commercial,0.31062058798246095,12,13,579,781,202,47.82592748564102,1041
e317c826-25a0-43ef-8980-77a948790c7f,Healthcare,0.5330794581940276,28,26,516,1272,756,26.609661290750346,5243
5e686692-9cbd-437b-b8ff-e7fdb2f67e24,Commercial,0.4964374042365953,16,25,673,729,56,20.698551422985684,2595
6cc1fe91-0711-4f34-8c02-49d603b5d34c,Educational,0.26458898961738864,27,2,493,818,325,77.38636916638929,4681
dc6bfe63-a316-4bb9-8901-70d4ac5d88e3,Educational,0.7542494780503632,1,43,285,429,144,18.34230659306423,3479
534d1f0c-c767-400e-a3df-9abb89ae577a,Commercial,0.24642784497911008,47,4,604,846,242,30.711595919918903,5825
211f3195-663f-4798-bcbf-45b1df310f13,Commercial,0.21930183138012205,49,16,192,206,14,78.76589863917853,9793
c20c6413-7eae-4414-9920-1181fd78d665,Educational,0.5354121949194125,9,35,290,1270,980,14.297255507869874,3357
ccbc218b-b195-46da-8268-d2033a1788d9,Commercial,0.9498858803208666,46,45,681,1025,344,35.828356762228566,7272
9baecdea-ec5a-4a63-88a5-9ec4e0ad28be,Commercial,0.9652492105160145,10,21,132,362,230,95.93277214939837,6100
34c02f2b-6d22-46b4-a1c7-b484836881f9,Healthcare,0.26944470531138265,19,45,221,1145,924,43.40968836746659,8597
bd0d8843-b7c6-4240-a617-33ea214f39c6,Educational,0.7560561799982035,49,48,401,643,242,39.26737741278924,4359
35c8d8a1-5b11-437f-b06d-72297622daaf,Educational,0.16704658056715926,31,31,94,826,732,31.634768577941582,7940
4ef06f25-1da7-4741-bae9-58307902b621,Educational,0.26304028297837057,21,20,110,458,348,70.41345093635766,3885
0063ba90-d06a-4203-835d-9b8e80f69104,Healthcare,0.9878895034773041,27,1,126,642,516,14.539213984867565,4882
9a98176f-96ee-4e40-8d3a-a3c3b48c3f72,Educational,0.7335612270029885,42,1,492,539,47,77.17867018178636,9586
5d48bb2e-3a8f-40a2-844f-b587e8799215,Healthcare,0.41221244510340616,35,37,583,777,194,68.1739146291521,7338
648572de-4e72-454a-8fde-91b37546587a,Educational,0.3359159300250719,22,20,559,917,358,97.57496615734945,6777
26043006-1d68-498b-9ed7-3b4eed134c12,Residental,0.007773095348029391,6,28,606,1371,765,18.282335302628912,8907
935a0f7d-11a1-4e87-88e3-a4f5ad688b59,Commercial,0.5767102307952678,49,26,60,644,584,13.290617295732801,4852
e94e7f81-21a5-4694-bbf7-977af31684eb,Healthcare,0.18571505463097493,31,24,84,453,369,82.67541410767289,9015
b75c3c5d-836e-4ef1-9062-2b34945b4691,Residental,0.18777537501903252,18,33,342,798,456,28.652441392719876,6571
3985f668-600f-44e8-824c-4724f8c0b58b,Residental,0.4393142228320931,19,5,341,674,333,29.082750082245116,4035
621f0f62-6674-4856-a97c-0b3e953e37a5,Healthcare,0.3495676664598246,38,24,89,1218,1129,52.24382320423681,6497
2ad526be-0c55-4d23-8f86-311b863ffae6,Healthcare,0.8200111724856329,46,14,166,394,228,60.89104884837324,3640
98a2b4ed-2fda-4795-9a92-2981caeb98e8,Educational,0.25387159785390356,23,25,52,406,354,91.95757052076945,6945
e729ea61-b37c-4855-9f48-fd9aa55373f7,Educational,0.5975116123215639,3,39,294,1007,713,11.28257050959643,3228
625fc9a6-d426-4af2-90f4-311452a8d5f1,Healthcare,0.573072218805087,45,34,515,934,419,92.9261050970761,6801
7891b93e-de8e-41fa-9643-355d52d9583f,Educational,0.5133512415646239,5,35,539,1082,543,33.972219647035615,3600
5050bc86-089d-4b89-a73b-aca9a218b637,Educational,0.6805615177120206,33,33,98,1291,1193,98.733579969504,6283
4a9f7168-eaaf-4871-9650-9e0cbdf85912,Commercial,0.38405288876298305,36,45,32,306,274,45.06109283535017,2821
a1e00787-7f6c-4fd3-bac2-44ef742db4b9,Educational,0.982128975721713,41,8,675,863,188,42.02384784236015,4705
33137a08-6b1d-49ad-94fb-33a30cd44d93,Healthcare,0.44010042424779916,4,21,649,830,181,28.772985329321262,7937
1e88986a-9a13-4ea4-b0d2-46a14d67704f,Residental,0.413847329673358,24,6,503,1045,542,10.84694197164817,9111
e7fb1d14-a5b2-44d5-8ef2-e5d12be94853,Educational,0.7797051309993798,34,50,613,1090,477,99.42787743927332,6369
29bb9a29-0dfc-47bc-9e04-ad28dbe69c07,Healthcare,0.5960432635887911,15,12,442,575,133,47.33993358944694,8925
993f8380-7058-4e8e-aee8-9ad83c0c964a,Healthcare,0.882541696853725,30,27,201,363,162,36.845560408743154,1268
14364ae2-2c75-4cac-90d4-f21825953e9c,Residental,0.03703731246102815,14,12,620,1044,424,86.18647679070877,7362
44436c22-f312-48bc-ba4a-e47aa84ca58a,Residental,0.4721158233837761,35,33,332,487,155,84.39265350627564,5449
30440486-52a0-46e3-b210-6b70291445a1,Educational,0.715960149368143,47,10,225,795,570,44.19797863650949,4633
849306cf-6414-49c6-94f7-e09aa14efa64,Healthcare,0.6453662445880444,23,26,423,539,116,66.20969336728432,6803
63a63967-2a2f-4614-949b-5192de2301bd,Commercial,0.4882341132109528,44,27,9,992,983,62.19288812452179,7942
a8855e51-2874-4dee-8d81-c1d8a3b19dde,Residental,0.315010597065737,10,4,485,1088,603,22.986572585023048,4619
4df16559-d79a-410c-8c02-5fab682f6743,Residental,0.32595662946097037,32,7,73,674,601,20.20240375994161,4929
3e6c720c-af3b-4aeb-ba03-f7a40015cf6c,Residental,0.7418608838672287,39,36,247,1271,1024,76.07130449280342,7659
61e4cc65-543d-4c98-8a10-787dd75dc9b4,Educational,0.4140759199077627,48,31,225,1205,980,69.35060492903986,2697
202b59b1-5925-4b5e-8ac9-ecc1295482f5,Commercial,0.7629485781850451,1,8,630,901,271,74.88842425152508,3628
04d60de1-86f9-4055-b182-d8809669c988,Residental,0.09035331978210626,17,19,484,1120,636,50.433252046369354,8362
c50dcff3-e672-4ba0-8168-40bc5aa4ba62,Healthcare,0.20597644658619252,45,6,274,692,418,32.369188635420706,8708
dd7e1bbd-260a-4e7d-9af3-3338e9d80ac5,Commercial,0.5003534689603548,3,38,195,996,801,78.9272833625963,7335
a9b01609-0f94-46b0-8918-96c2bcb3ecfd,Healthcare,0.09792435928861543,7,33,560,750,190,80.84953759223977,9002
17f88da2-ba83-4243-bafb-c369cf43f9dc,Healthcare,0.653311242410581,43,37,484,966,482,70.07411502879651,8113
87cd1fcb-a71a-4239-98f9-49bcf604d39a,Educational,0.08394073573550365,18,39,228,1407,1179,90.0026819203324,6657
09c22435-0c2a-44ee-b807-0ae3271857e3,Residental,0.560552188648494,43,36,495,1002,507,50.42468684838698,8202
2305b8c0-5e5c-448b-a416-eabcffcf6d7a,Healthcare,0.33297279230357346,10,15,543,1304,761,95.95810460241445,2446
7b7879db-fa36-46af-ae10-5b97738099e9,Commercial,0.5471592607286182,2,12,544,753,209,46.657892200143614,5064
98becd01-7ca6-4971-aac3-bf2aa0cb3b95,Educational,0.30674736733803776,41,37,571,769,198,23.513075707528245,4962
3ed86f1e-5bd3-43fc-b103-a640f8fda9ff,Residental,0.6668744284460159,26,46,634,930,296,18.056777630612324,5729
74c57b68-15e6-4ae9-b6be-0af23c7155c5,Healthcare,0.7279566138108012,49,44,138,1118,980,93.85281020359545,9381
f4d8f796-fc96-4b03-b811-5f28f8563c43,Residental,0.5475759641247139,35,28,4,1274,1270,55.28496289155809,8367
0ff2ce81-d8c7-44d1-9723-e76b06de3869,Commercial,0.908128377990857,9,5,571,680,109,16.91589056306299,8386
66484723-13ed-4df3-bb23-9111b9bd29e9,Residental,0.3800984018390502,37,16,603,730,127,60.32594685037242,4767
874bab25-4c06-48e6-894a-7f7c1ec802d6,Commercial,0.6597018954787652,42,30,279,1211,932,59.62749976031699,7237
3a4089fc-3205-4ec1-9e77-2c2b5a8b6d23,Residental,0.5728275007395478,13,11,190,1029,839,94.24403946132753,2099
9e441bf2-ed69-4df4-b0ff-f12a340dbd63,Commercial,0.8932337743190207,26,13,327,1152,825,42.40009666649913,9781
0d290e6e-46b5-4b7c-8db4-cf9b4677914c,Commercial,0.750606395586184,12,45,590,722,132,88.43940916609849,7341
3b78fa4f-8b98-4cb9-aedd-fc5dfa98840e,Healthcare,0.9630667096444194,1,5,166,964,798,90.45773061136408,6854
abf90055-75b1-460a-8830-82f64fa41870,Healthcare,0.6270463082311905,34,50,74,409,335,50.26866450610642,1553
74d4dcc3-cef3-4c9b-8606-309c34f7db4e,Commercial,0.516358684889378,1,47,217,218,1,45.119144180100925,7722
e84ffc6a-a66e-4f4e-a1aa-fa0b0076ce5b,Healthcare,0.7451646476408974,48,21,401,932,531,18.292162795516504,7714
a668ec46-9ef1-4cc0-986f-7a43f7de87ab,Educational,0.6387972660597804,8,2,211,560,349,26.613614162995304,1095
073317a0-fa7f-48ac-b4a4-71a63987a235,Residental,0.13979149265155655,9,49,574,1402,828,96.18748587968273,4727
36d3725a-8ea6-48e5-bdf1-831dd4571043,Residental,0.21323953974854348,30,10,251,625,374,38.683240030564946,4832
df88a247-c21d-4dd2-8821-b2e622e24392,Commercial,0.7528202053364648,38,12,49,53,4,62.01542618624358,6682
460f0c79-a549-48da-9de7-87c56bc89051,Healthcare,0.42937439528571153,23,3,49,1193,1144,63.57511580787544,7721
d09d35dd-8969-4d55-a2f5-fec04f7cb70a,Residental,0.674578386614656,1,30,524,681,157,56.62257244253481,4788
bbc49968-d345-4cbd-a9e5-d304516596e1,Residental,0.15759830268063824,41,40,85,1397,1312,51.70065232577509,3308
b943c710-7bfd-4c7b-83cf-41d1a7754fd4,Educational,0.5365629744908548,21,22,515,520,5,41.12498657537657,9112
70ec1bc2-0d80-434a-8010-778256a0f1f1,Healthcare,0.8728652759756538,26,10,138,1311,1173,59.188956022804916,4029
ecd7188f-f214-4dbd-8367-a632de0c46c8,Educational,0.9158862342348599,34,36,519,1206,687,61.74597704102999,2766
44f3a2c2-a70f-4704-ba45-5b4070decb0d,Educational,0.7864653937245815,12,34,246,290,44,34.40109683725633,7655
c5b8433e-da93-40c5-ae23-885baa851636,Residental,0.175163461411581,1,29,135,747,612,10.334204543603803,8471
c3bd964e-ef5d-424d-b6e6-aeab05e273db,Residental,0.6278140851487011,26,25,218,730,512,48.19259938922034,9872
ec981fb6-9ae9-4d06-b09f-72b8cb936f15,Commercial,0.5405389214509235,1,6,630,664,34,14.036665391619035,5380
7743fe48-cda6-4822-865e-416f2f9703c9,Residental,0.5410481340005832,23,38,539,1048,509,84.41320678997708,5498
d12a1b21-5872-49ad-a87a-c152efe64aec,Educational,0.1850620328031667,4,20,449,1322,873,98.59119374033602,4448
d5d98626-e305-4b39-9960-99df33d9001f,Residental,0.1467491725407093,8,11,70,536,466,75.53397486869409,1061
bc93aa42-adb6-4a8b-aceb-4008942d167a,Commercial,0.4005634054160395,34,43,2,200,198,59.36763987518938,4015
96b67223-4430-4c8c-8c48-b0d1affcd74c,Healthcare,0.8325395437759671,14,10,193,1180,987,47.9172831202047,7855
a33ef884-aed8-404a-8d0d-42e06c912f6c,Educational,0.9210656906704057,38,30,45,568,523,84.98021955370265,5138
aae2cc9d-08ed-4fae-95cd-3992fd07d3f8,Residental,0.37105930266664655,10,22,283,1027,744,19.785818845976607,1141
4713a38e-3ffe-4104-8a38-b56683bd7133,Residental,0.9122737997667294,6,8,365,676,311,97.90542712230618,1403
9d009e38-399e-4b96-ad6e-74c27472c0dc,Healthcare,0.7905528795356966,2,36,24,958,934,98.27044707034459,4172
6f881d9a-c6ed-4e0b-a336-42576119369a,Commercial,0.5105820641786606,46,40,345,679,334,72.6521351713748,9884
d86ef1b6-aeeb-4b4a-aaaa-0fa3480de6f2,Commercial,0.21908330118937858,46,47,288,595,307,15.587804898863702,7540
f3aba28f-2a2f-4a5a-81bb-9a772776fa34,Residental,0.012728310982272784,6,9,152,1019,867,75.61981174176236,1648
d4297039-6c26-4d94-b32b-4ff3a575a759,Educational,0.0701804193547384,50,16,500,1332,832,60.12921388184056,2906
8ca60db1-52d1-43c2-9568-4d6063e80355,Healthcare,0.42955811089710894,18,3,57,1041,984,16.74564551622001,5017
755b5348-3d6d-4855-9c66-3194e07e839e,Residental,0.01743382594001197,28,40,363,1125,762,22.072212988813035,3324
d1ded356-5fc5-4287-9204-ce8f0a4b7272,Educational,0.2873256344433265,2,45,354,526,172,46.20541258419406,6563
eb24f25a-96eb-4ea3-adb3-5c1b41cf1135,Residental,0.23877121182998062,3,25,696,1006,310,82.68759358547499,3634
f9396c0a-a457-44f8-8d6b-0be391585711,Educational,0.14145254032831445,4,12,172,210,38,58.208054706799295,3324
1efab47b-db20-4af1-b061-368f5a22345e,Healthcare,0.06998786714015337,2,32,310,936,626,39.425062851653344,8269
7fbbfce9-4da4-43e6-a39f-3085735ebdc0,Commercial,0.40110259479499066,45,1,620,747,127,74.73132691197516,4206
9061087b-ab77-451c-b3eb-3f07ded91e0d,Educational,0.7649857525814713,24,6,47,617,570,90.12879565351555,1440
599f40bc-6b35-4362-bf5d-2c672623996d,Educational,0.09959671573725004,44,48,709,1310,601,31.602377757024954,1951
0d038cb3-ff55-4308-8393-60ad9af53d74,Residental,0.6958373163509868,25,40,196,969,773,81.96427362443573,8785
bb84e438-289c-4d5a-ae60-0361cace44f1,Healthcare,0.33626343140132287,49,39,86,1112,1026,25.73439029568211,5809
08ca418f-132d-4fc9-b606-b6ed96ad706f,Residental,0.7589108820932903,7,16,345,1169,824,79.17961410131832,7941
6c34c3fc-aeff-4a2d-af70-64702f9ac98c,Residental,0.7437310143484555,11,9,351,820,469,39.335050127491996,4384
a6658097-fce5-4709-803f-ae2a6ad00091,Healthcare,0.4727375689710679,37,19,239,383,144,41.675224251556656,5221
1df693cf-941f-446c-a062-2b2e37044c7b,Healthcare,0.6725591040736932,41,29,502,593,91,40.43135781086616,3098
c1ba3de8-5232-49cb-ac58-52c5f77b03ff,Residental,0.13813231070015575,1,11,583,1125,542,85.36453501899186,8160
56268ea9-8985-4e88-abdf-24fcc0abc5f0,Educational,0.4249301082269975,2,28,315,944,629,10.419604059256722,3008
571ae706-3cd7-411d-8f68-3fb783367afe,Residental,0.4652386645677872,23,12,239,1319,1080,61.1560971459143,6337
27db1242-5b98-4f50-9f21-3cc094030476,Healthcare,0.46398571043034265,1,48,468,564,96,62.80890975842017,6965
b0fafb36-292d-402c-805f-1d959be80a30,Healthcare,0.9540666441156694,46,17,103,593,490,23.079234924701044,5540
2ed8332d-f477-458e-b370-79b762fc8513,Healthcare,0.3460017183202485,20,11,260,748,488,46.14660703503419,6797
4b0caa61-fa43-4829-829d-9330279bf9dc,Educational,0.8461686829739906,45,6,478,1120,642,47.97185761422188,5201
d4f00fa9-9507-42ed-b271-2ea0867f13e8,Commercial,0.115685345103819,33,4,80,490,410,47.04457693351765,8597
eb3be03e-76da-4e01-885d-8278fad80cd7,Residental,0.3289821747682239,18,21,430,1342,912,28.938956014739208,7495
2353df31-2f95-4d58-a242-a5dac88b9af4,Educational,0.7639876037025821,37,47,227,1418,1191,45.526516244974346,3654
b62f854e-9633-4350-b062-224cb9b42771,Educational,0.5028346864633009,2,36,240,711,471,10.047599293431608,3901
3df4bbd0-f8cb-4359-bc0e-c95ec18cf2e4,Healthcare,0.17803734663704918,41,15,173,369,196,38.24413755487558,3673
db11d37f-600b-4f4e-a249-660e098a9217,Educational,0.899354968714138,45,8,350,1029,679,81.4828531087112,9937
aaee6fab-80b5-46e1-91fe-557671353850,Residental,0.914332368283898,39,3,551,1324,773,44.410935806518495,5868
fd6deb96-ad46-4c46-bd21-f5fd118a02da,Educational,0.949058445634595,22,3,129,461,332,49.68986856337976,8701
40310456-a092-4613-9ca7-32284539e68c,Residental,0.7625421388019968,49,9,239,1288,1049,46.22537243077903,6674
12da4af3-34d1-4e25-9902-a4c983b82c17,Residental,0.2025000118893744,18,14,670,709,39,12.870616389877167,5072
7ebc7aea-7519-480c-9a25-cd578b77a3ea,Residental,0.9931646948762836,11,3,69,300,231,32.473353019626146,3174
3babdaf8-101d-4399-8725-52585720916b,Educational,0.11972281041927713,42,36,422,1307,885,64.9859102704527,9534
87ead40e-ca8c-4237-b250-8221ee500f99,Residental,0.6561872924783565,7,8,39,540,501,25.910944937434962,5267
243e3e26-f692-46ef-9d27-192b0ed10bf2,Residental,0.5656294530857497,15,40,592,945,353,80.53280842320127,6574
eaab2a39-5b0f-4788-b030-0150df5ef466,Residental,0.9692734837687415,46,48,112,999,887,17.903519995953143,3853
448ddc92-6ce8-4128-9f33-53db1d25d6d6,Commercial,0.5151860980318077,4,35,334,559,225,82.44154202404917,1422
5647c969-84d8-4b5b-9b8d-9a3d496cd218,Healthcare,0.4417033142821605,35,5,50,1019,969,57.18159771308636,9369
f46b7539-1acd-4bb7-bdf8-05d544e7c96b,Educational,0.94656076079323,18,7,88,1040,952,63.787881086796446,8065
e8cef8e6-8625-4ed7-b654-20cae8bb5546,Commercial,0.8690409863402204,4,37,615,860,245,34.04155190408774,1062
0eb49525-bfcd-4311-bb6d-fb7b194e1db8,Healthcare,0.607987441660446,25,11,457,1175,718,93.85129250633037,5618
0688e98d-5bc1-4a44-b1f3-aefeec94bf7d,Residental,0.6262570099030115,26,14,71,385,314,10.593619010753523,9489
803f1638-a5d5-46f9-aff4-43e0bbf740d7,Residental,0.0810508938435569,34,37,661,661,0,74.88130610266441,6572
37f040a5-4037-4ad9-a112-b31b96694a23,Residental,0.2431387811792799,26,17,198,715,517,49.106146797441426,3837
acac969e-cb83-4f6d-8563-fe8cf78ed8c6,Residental,0.6258208765425701,21,42,396,1337,941,74.4112193997061,9830
f02e169d-615d-497c-a379-59b92e3f6f71,Healthcare,0.33656816709463844,49,10,314,1336,1022,61.88460003082543,9132
caade296-ab61-4b5c-83ab-ca2487c4d4f7,Commercial,0.6063070885757765,42,39,125,722,597,37.07329443964627,4724
c71f97a8-e92d-4504-9275-8350e10fdbaa,Residental,0.36712291565755717,32,20,321,1131,810,24.85534154786952,6950
b9f633b8-241e-4f42-b9f6-01edb6991294,Educational,0.3767870775696769,33,39,530,1105,575,69.45931047962415,5905
d5a91f9d-993b-4a34-b1b6-c152684a5268,Residental,0.9645220871106718,16,22,163,484,321,54.06802218242985,8108
7fcc3faf-7be4-4461-b953-f0d1bc9ffb57,Commercial,0.5500815142698259,37,12,514,1096,582,80.52473112980182,6595
315158c9-c622-43ab-b8df-a4b303ae3f2e,Educational,0.18641316457019408,50,12,324,361,37,25.409605324952004,9014
567bb4be-5117-449b-ae7c-8e12d959a9fa,Healthcare,0.2534758356822564,17,44,508,939,431,23.91935646838253,4828
9f6bc3f6-9e47-49ce-81f6-168cb0fc0f35,Educational,0.2634298599513356,26,5,18,1277,1259,55.99861873187243,9206
28737d58-0966-4bf7-9620-fafc63916923,Commercial,0.27271171361839164,7,45,71,659,588,44.12149504640286,5755
b23ee20d-de04-48b7-9ee3-03db655c9661,Healthcare,0.35655734180602383,40,32,659,901,242,44.13136396866678,3884
a057a333-391c-4b15-bc90-b15316f714e9,Residental,0.4939187225339968,32,2,668,1100,432,22.16267183865074,7807
20a6aa11-e101-40a0-b070-c89d16781ce4,Educational,0.5556212419629228,18,34,190,343,153,93.73351067871214,1156
9b801a66-a070-45ab-907c-7a07ca5851e6,Commercial,0.6750070341921565,26,15,352,1240,888,65.22552336589612,9183
a723b004-b728-43df-b510-7ec440f33d90,Healthcare,0.3524625447901083,6,7,710,1401,691,54.780324941163435,4271
eee835e7-bf1c-4d81-94c3-443611490fbf,Educational,0.1230460986000047,42,21,311,1055,744,17.594259753541674,6202
516cb6e5-a768-4ba7-bdef-6d38aa6f797f,Residental,0.08402590470716842,36,10,461,1031,570,82.30444557942619,6252
a4d19c1b-fe06-40b2-a82b-f8948b5f31f7,Healthcare,0.7116896058680491,50,33,87,480,393,48.2636295169478,8333
a7c2fd88-742b-4c4e-82aa-39526079b1ef,Commercial,0.04993134964508361,20,13,401,928,527,34.58897389464647,3563
34631e9d-0d22-4971-acb8-1080df7a299e,Educational,0.9779906032416648,17,35,158,1051,893,81.23917599757547,4888
458faf0b-f622-486a-bb7a-6ecdb74e827d,Commercial,0.06953628363016617,13,22,492,1233,741,92.32627959773373,2869
00867b90-f5a7-41e5-91ae-71e960b34bd3,Educational,0.044610446360833445,16,20,39,382,343,80.83483122887,4258
2dc07633-226d-4bae-9a8e-14a7a0fd3693,Educational,0.35999990294191664,6,22,571,1166,595,88.46580755250703,2059
bc453eb5-3165-43b2-91da-c38f19bbea58,Commercial,0.6403710518662145,33,29,281,684,403,72.71312959576554,4169
ef271150-fb06-426f-9c5a-82234c3c5582,Residental,0.3870961236771433,46,45,147,421,274,27.95064918436676,1617
ae28e686-046e-419e-a223-41d99e3e9270,Residental,0.14086673064433497,41,25,368,1362,994,57.25272377582003,7803
3600f855-e29a-4b72-b719-441dd53f1aca,Residental,0.9752102668105856,33,24,58,1319,1261,54.71603042066622,2946
0c545de2-f376-4c67-a712-ebd95cf7f472,Healthcare,0.34940314045220455,43,16,23,152,129,90.40893330306835,1699
64d9364e-d2c4-4560-afae-9932f88afeea,Commercial,0.11101709431537699,1,38,114,1338,1224,13.326972717998764,8016
8f51f81d-70bd-476b-a2b8-2d471c9a72bd,Educational,0.25427755436841426,9,4,441,489,48,43.72531234325446,5999
7788e1e4-108c-4467-adc9-934a14798bad,Educational,0.9237600629092086,47,48,687,696,9,13.452890397036224,7661
763b2c98-e015-41fa-b19b-09acc3e4e9f5,Residental,0.5364132758212088,16,18,633,789,156,12.7395147811933,3218
63d7792c-e269-4419-a4c0-750e14ae06df,Healthcare,0.07151249686210837,3,11,545,694,149,83.68597388513393,4745
1dabdd1c-785b-4989-8231-1539f1fe67ab,Educational,0.977734025665664,5,20,606,1031,425,27.186499406895706,7023
e9a1529c-4ef6-4b50-9b32-3ab6b617c7d3,Residental,0.4098886864813531,20,11,521,1328,807,66.90151428594967,8878
a275e92e-e24f-4d23-ac54-2657e758e33b,Commercial,0.9452490576745524,16,23,676,1436,760,33.34410946830404,5294
85a154ac-178b-40de-808a-2625bffd5340,Educational,0.12149339256744496,50,47,539,1402,863,94.37775981025489,7637
d7658292-1bc1-4620-8773-cec55ed9a572,Educational,0.4988807584746131,29,13,568,1106,538,82.29975700528189,2307
74553e1b-764d-4982-8932-4cad8f81b06d,Commercial,0.2662520886370925,38,25,215,1086,871,52.9247190613258,2544
29e3dcc3-d725-496b-9492-e5e6b13585f8,Commercial,0.9044742984347911,40,42,444,1027,583,71.78675947095707,9822
54204a46-bd6f-4d75-b693-23c024428312,Commercial,0.5156781370636089,12,5,537,684,147,46.835904513938665,4409
61252e32-8a69-4af6-9968-a47e7aee8325,Commercial,0.7200165814599151,13,42,115,907,792,26.348354910825634,5695
a182e778-e395-4702-b7f8-3df6c2fb10cf,Commercial,0.15520254393244537,1,3,185,667,482,37.24574563621127,1406
b1ef6c81-508c-4aff-9835-d133b0e56580,Residental,0.16105438134926275,38,15,233,1007,774,85.0277280796083,8116
177e14fd-1207-4dce-aede-5eff396a8f90,Educational,0.45063141827323316,12,5,584,1030,446,56.67410403048504,7926
5c4e771a-2776-408a-afd4-5459c0fd3834,Educational,0.914353601736335,43,21,633,1336,703,44.82913524281091,5639
94900d86-e3ff-43df-94e7-2df726c7f840,Residental,0.7620963302779792,28,14,376,1410,1034,46.141346200946955,7271
531cdaaa-8aee-4daa-b3a5-78d92f26ddfc,Healthcare,0.38487519680689064,47,4,186,312,126,95.09847072518723,5896
7dbb0e2f-93d9-4f11-a61e-e074e88007a1,Commercial,0.29604703097949614,18,13,198,782,584,94.74997402150167,6605
c3b252b5-39d4-4927-9030-c4a34b85df65,Educational,0.8608812801711886,3,12,526,1313,787,88.123419807441,2796
f62b37ac-dc3b-4068-b50d-41741f8ce456,Educational,0.28375176794408663,15,27,662,1400,738,96.53062601763033,6268
08e0b44b-8440-4baa-b46c-9b6c954a41d2,Healthcare,0.2198965392103438,19,42,108,835,727,82.353221862799,7718
431c32ee-9e62-468c-8651-dd76337d1cc0,Educational,0.5942567669829589,7,27,615,904,289,18.19960384359919,7267
3c19540a-91af-451e-8945-b3e785e4f17c,Healthcare,0.1885882076777946,43,24,382,637,255,54.4353234063721,2403
beb74880-6587-423f-a50a-ce30987195db,Educational,0.45817716414847476,19,30,640,769,129,14.695309710467964,9324
41a92c3a-2a9f-407b-820d-be168e8e06e1,Educational,0.794919126380605,12,29,31,1244,1213,74.6620450698324,9706
e418b89d-e280-47af-a731-d3ced1310e91,Healthcare,0.9515750491855519,1,49,7,619,612,20.923372462301927,7024
d21d7afe-59c3-435a-910d-1e921fd9f1be,Educational,0.2543436059607176,44,13,595,1251,656,63.65351117548985,1698
1b47f341-1b05-42ae-a174-18e231449f8f,Residental,0.8443212491922873,13,38,377,695,318,52.40027340098432,1517
a8ebc28d-5c07-48f8-b650-0cace7c65fc5,Educational,0.3827302146745175,11,49,299,573,274,85.94776713756418,4073
deb3a301-13ff-4a9a-9d92-e68fc09fa618,Residental,0.6456120881412037,28,31,458,1106,648,60.477078926198644,8382
524f566b-8d74-4d5b-8e2e-eeb4f9618b15,Educational,0.9485232466138146,6,47,211,488,277,61.73196792230708,8843
6e6ee6f5-f582-418f-b63e-d786273e66a6,Commercial,0.3548056133513148,18,20,199,1066,867,79.50361595654725,3803
d208829c-f300-4df4-b4fc-381a33d630d7,Healthcare,0.7405475712838836,13,47,185,594,409,11.586868030549937,4689
a1c6a260-5322-456f-bcbb-afc3819422d2,Commercial,0.321732730266584,48,30,613,670,57,59.059803165147095,2851
3bec0977-011b-47b6-b702-f3dc7b574a8d,Commercial,0.005971225988408602,35,10,140,340,200,89.72871900065873,7616
b125cb61-8347-414b-b205-ce031a915591,Healthcare,0.488439142272153,9,49,25,867,842,13.648120957462124,4824
2f31c109-fd4e-431f-8c4a-397609c696f2,Residental,0.09166570514108507,30,18,532,1408,876,68.6144327255702,7401
50ef0849-b47a-434d-9d12-d45eeabba4c2,Commercial,0.10541917045608284,41,12,282,987,705,51.10088296229733,4996
12ca745c-a464-444a-9b4c-5726cdaa0431,Residental,0.4563533588147991,21,6,663,918,255,87.2544444009762,4543
2f40f16b-27bc-49c5-80b6-230af8d33f9e,Healthcare,0.6607361204910651,34,37,395,707,312,27.338421846551206,7409
8e1dea96-24c7-4a54-8aa7-8506ad2034ba,Commercial,0.5316852816221538,8,47,122,646,524,18.18567659833922,5058
ab11360f-6b20-46c4-a505-b9fa54dd0250,Residental,0.018188784151239812,25,36,277,597,320,99.97117908176142,8632
eac8a282-79f4-4301-9c51-246d40a9fef9,Educational,0.415689986967518,50,29,115,521,406,57.3005958110931,4070
07260095-6fac-4d5d-b879-9f8b678bac12,Healthcare,0.562036893239658,24,29,240,494,254,54.84408910721885,7622
4de3b9ec-ea48-465b-a77a-d7c7e45b083b,Residental,0.8761516982744627,23,12,119,168,49,86.09923932724676,7124
b1a5874a-f91a-413e-baf9-ed3878dc7d6f,Commercial,0.3600582742921732,1,5,653,1190,537,91.97620000661558,3769
73bd6cc1-b8da-4640-9ed0-ca6f333f09f6,Residental,0.2370857807476433,2,2,518,1370,852,48.233406188915296,3730
ba9e5a45-fd9c-4741-a3e2-c9239a681fe7,Healthcare,0.25745801809234403,24,20,559,1256,697,20.82545369596621,6539
1e6511dd-0a39-4a07-bbc5-f3e6b4ff5951,Commercial,0.26794533498318374,18,15,144,692,548,83.51188646847325,4870
d809318a-210a-400f-8c35-c6c8a0e92c56,Residental,0.34914460663426305,38,47,390,1045,655,22.50341464827349,5346
a1960e77-fe1b-4838-9767-d3437360ed55,Commercial,0.9404718008686139,2,48,13,403,390,68.95591645977085,1367
9043fd80-c9b7-4b10-a7e0-06a421ddd819,Commercial,0.5351996895774099,16,12,316,1005,689,85.26954114123384,7788
ffb6290a-9db4-499b-b6d1-44c43b7c6089,Healthcare,0.8291505519689724,42,15,691,759,68,58.05372583735381,6208
21fa49d4-b664-4548-8ed3-d6b0a351d368,Educational,0.07684013372952714,40,32,74,763,689,30.76602964633211,4438
b0cd65c1-1508-4e53-845c-c8a3d7a41c66,Educational,0.24468877941378797,12,34,408,1187,779,80.09397761058968,4864
c4e58844-2d08-434a-a113-218b8f36a759,Healthcare,0.371470615190187,10,6,375,940,565,86.60292839205147,2095
21b92e90-3bc7-46c5-9816-9ed6c66c91b8,Residental,0.5084330799317183,33,40,356,1088,732,60.663379891084816,1110
9f51a079-ff62-42cb-8453-cd9d6a795f19,Healthcare,0.1741254961535479,39,46,26,895,869,65.8535456844101,2195
56cb213a-93ca-494f-a9b1-772a3c6133df,Healthcare,0.34346508155554123,47,12,181,433,252,65.31589268369365,9543
f9e02dd4-38fe-4de6-b4ce-dd22c4c45dde,Commercial,0.7318739288391958,10,29,698,1119,421,30.793079388329208,9088
1585ffe9-1424-4859-981b-5927eb765330,Residental,0.5086667546794967,2,20,519,921,402,56.92058353838532,1001
4c17c622-1903-40b1-8145-d67f9b6e2ea2,Residental,0.7586159108634432,49,32,376,885,509,86.90610115041657,1831
11a1f8f7-e21e-42ef-9ec3-bfce33f634e7,Commercial,0.6828251228465462,8,11,112,735,623,46.66448691446119,2566
94b481a7-80ae-43d3-a052-385a5298e042,Residental,0.7411881874779442,40,26,531,1166,635,38.8479509638403,2310
a89c5df7-0841-4f17-a974-32b9563cc6d1,Residental,0.2503393111972777,14,27,150,303,153,99.48466745031331,4642
1e510e29-723d-4e1c-947d-02de8ec436d6,Commercial,0.09845296731081643,36,8,612,950,338,75.60232060187144,3005
18a33386-b8cb-43eb-a7ee-cd7a553e4cb7,Residental,0.18693558525436593,7,15,29,207,178,17.073668637606865,6238
d25b462a-2e96-4edd-92bb-22b2821921fe,Healthcare,0.9589612252381728,10,25,108,282,174,34.14892959179183,3198
f6141442-c19e-4dcf-bf5d-34a50637e0d4,Residental,0.8514773343722759,39,15,130,1055,925,58.679683048161145,3459
accf0539-e8ac-448f-be51-8561a612d8fd,Educational,0.5551073623819999,4,18,301,576,275,87.19455002017966,1553
d7b63655-baad-48bf-83c8-8e43c5f96b8b,Healthcare,0.41393030003965214,13,46,478,815,337,50.84838629195073,2460
8fa9c080-5a89-487b-893b-a7533ffb62aa,Residental,0.510976278944799,10,15,60,944,884,80.24417132424593,6473
59b5c291-d1bc-49cf-9bec-ab61f06a8e17,Healthcare,0.36936207437789836,42,22,287,476,189,96.917982518289,8609
4940cb6c-34c2-4d19-a9ac-f0259e537feb,Commercial,0.9882665861789223,22,31,535,566,31,83.42389013800988,2190
c1528758-f6a6-4f52-8e95-3630f60fd392,Healthcare,0.20600126276334885,3,1,311,1060,749,31.990781863008323,3892
5291cf67-6bfa-4728-98c1-87eda6adebfc,Healthcare,0.6234270666363555,34,42,475,1269,794,95.40572980318707,8379
305c85b2-9547-4cb1-bd3d-704c4d021209,Residental,0.3103465789765648,40,13,303,861,558,48.185989627610255,3395
335db9b5-c725-46de-a7bd-ddb50ba6d490,Residental,0.33212773341682955,46,50,636,768,132,63.52184941879345,2030
7387eb59-defd-4edb-9eb9-0f28dd254e22,Residental,0.0009678078971900872,39,26,588,1130,542,31.693324809441034,1049
b209dcfe-7eec-44ad-986b-f523f1e32129,Commercial,0.5924051969902764,33,39,16,922,906,36.167229607373876,7452
336f9f3e-2d3e-4dfd-9e73-c4a013e86bec,Commercial,0.56408774844074,28,31,50,633,583,68.89467478237506,8619
6b3771ef-aaac-4014-8f31-b41f02605477,Commercial,0.08228908185569006,23,4,696,1242,546,14.076535143642014,3771
eb35bd3b-73a1-4e45-928c-4580dc8e9cfb,Residental,0.9793881219467168,21,32,719,1085,366,40.296206867001345,8196
e29334b1-e91e-4cff-84ff-d9569cbc8a9e,Educational,0.07784895212153109,8,27,429,1376,947,75.19200602931429,9614
36a98905-5564-4789-85d4-3d309e4c30b2,Educational,0.8427359353513124,11,42,632,1300,668,26.179286363054707,9093
fea77e15-bdcf-436b-ac14-cc7f23e45e29,Commercial,0.5165776519126403,1,7,565,632,67,75.16254789846391,4436
7fbc12d6-f786-47db-ac0d-625ac2d64f47,Residental,0.582443118803644,39,40,337,1235,898,12.644990600856818,9144
ebf2306d-0105-4776-b9d3-65c2f5b76b36,Commercial,0.5468386666648624,7,8,279,1063,784,69.05644414527433,9632
241da60e-8820-405c-9b5e-b404aaee7e0d,Residental,0.15231613922729703,2,18,282,779,497,34.94279741713373,6668
5f7a7863-db47-4786-8248-0426af7ce8d7,Commercial,0.19200378762084658,13,17,229,322,93,70.09312120791117,2560
a7868d2c-ca86-4eeb-bed1-a208ae99320a,Commercial,0.7639941331775213,31,42,647,1341,694,46.62723307971936,1838
d37646eb-d93b-445b-8555-03cf8b9fe1f3,Commercial,0.09157864128118554,44,39,498,1127,629,34.871827235708,2896
b1a5c2fc-9ff4-4b65-bea0-6b20c86e098b,Commercial,0.8470884233140703,31,50,548,765,217,80.37245293321888,8781
9e015f81-8690-417c-96ff-79b80126a08c,Commercial,0.9996017137349716,12,15,211,852,641,88.6892791663218,9769
7496b6ce-f7fb-446f-bb4f-d33bc90e409e,Commercial,0.5979069736260535,25,45,408,540,132,69.46553792045754,4481
82f1ffba-0c32-4561-b106-d48d14bfcca6,Educational,0.7558937744688041,10,48,197,666,469,37.292626039481746,7918
cc893a22-4ce5-4f44-bcaf-2b032343b9ab,Educational,0.4150641771391246,4,18,35,1435,1400,60.99799868517313,3328
14d7749c-eadb-4d37-aef6-9be339fac1e6,Commercial,0.11246671024762922,37,25,650,670,20,79.8320450137192,3455
18605ee1-b35d-4848-a892-129b92ab6a1f,Residental,0.784507719691494,40,2,698,1435,737,92.77664962040156,3256
08449578-2eb0-43eb-bbad-b9b90b854c62,Educational,0.567630677843823,22,13,645,908,263,36.28943685484817,3722
1774d16c-5642-4300-bdd1-86cf82a2e035,Healthcare,0.2244416299858195,50,20,623,724,101,88.29971371342072,1121
b90dc63d-1287-46aa-bc2c-5b23123892f6,Commercial,0.34568493628204777,13,12,412,849,437,81.63608132258213,3979
c7c826f1-b793-4cfa-b8b8-824ecd0f2fc8,Healthcare,0.18565493998716487,21,26,189,492,303,37.138960618323885,6665
e8f9d8e1-ef7a-40ac-b10a-8c0b20a737fe,Residental,0.27770498488880413,39,50,230,951,721,82.51633286020441,8946
6a98c523-ab4d-45d3-aafd-b366e1adadca,Commercial,0.8818284591561389,26,11,78,531,453,15.903480719405046,8402
29fbe2d9-fe6b-469c-b3cb-cad89bbda42a,Residental,0.7688785976683354,24,49,489,834,345,51.0991298299044,2266
30fef685-187d-4a4e-a465-93cd09ca79ad,Educational,0.22021476896092618,49,27,476,1034,558,37.493962943629896,2607
38581693-c4b7-4fcb-bcaa-98c7255e5056,Commercial,0.29937056890715275,50,5,349,480,131,11.609900414352737,2321
24d96c35-76c0-4c9e-b5ad-4c9e44139e4e,Commercial,0.029227015836004844,22,12,216,625,409,52.4268685051147,2652
ff5e7991-a8a9-4366-941c-e53c7a0d6797,Commercial,0.1416945329590219,11,28,663,1370,707,12.334783973222173,7746
03f4eb77-86c5-40de-91b0-dd11c6d87407,Healthcare,0.7236005148882357,9,33,662,990,328,40.65305865694786,1806
3d757e36-c545-40ff-be61-c5f3c8c48ead,Educational,0.7672982218296512,30,28,119,873,754,65.15141277546397,7265
14efa2a6-e92a-4d29-af90-b10d130ddcb3,Commercial,0.00091268166490166,29,32,309,1323,1014,52.36493464388074,9269
15a69147-b8b0-477c-ad92-6b1610ca1299,Educational,0.1587281799657465,31,44,546,560,14,50.91304404588337,2349
6e50f015-7ff0-43b5-a50c-40b148c7ba0f,Educational,0.6428442222399516,26,40,59,74,15,27.893370824705126,7798
eefe9646-bb80-4170-b5a8-e891ae4995b3,Residental,0.19063149482196873,40,25,650,1051,401,68.43129414281236,3326
a38d3ae5-80fe-40fd-b2a5-43f7d5bf1cd5,Healthcare,0.24256009949088864,33,22,450,1149,699,42.2421866299732,6015
4f48774b-ee54-4856-b3db-98505311ac76,Residental,0.7349918558379315,22,30,395,1373,978,45.21032041964269,9985
e1172eaa-f3b6-4e51-aaf3-33bedf531007,Commercial,0.11846583617418427,6,36,224,673,449,93.20109198985595,7974
c725aa7c-1828-4a00-ac9d-4b84fe7f264d,Healthcare,0.7375949781930702,11,7,218,1374,1156,88.9191369820608,7301
72818b66-904f-444a-ab5b-302aea37c836,Residental,0.979330438153933,17,34,193,1062,869,70.21136846458899,1983
3f25e007-7e31-40f5-8456-25ca81adec3a,Residental,0.23262652196360067,50,45,317,1100,783,41.74007455206572,7181
ba2e3f77-e598-416e-927b-8755aa1f7678,Educational,0.912928827379757,21,11,88,1002,914,47.7740252439736,1804
35c196e5-cacc-4833-b8d8-8d842ed9c866,Healthcare,0.40239504310200747,48,26,473,625,152,60.400571995204864,8662
39794ad1-f36b-4fa4-9888-3a3b5b07649e,Healthcare,0.7660991392992388,33,46,623,1397,774,80.61475627395178,2035
319c1c25-b7d7-408a-8f54-aeb9ba85be3e,Residental,0.5811228371362291,4,47,311,543,232,11.25148723207354,1937
f10de207-8cd9-40f8-a0fe-1765b9b66622,Healthcare,0.14271256217851647,16,2,172,786,614,46.80968682688799,4779
c8f62223-1226-4417-9587-3e06ce20ff8d,Commercial,0.40445241083942185,9,44,266,1401,1135,64.46432019804848,2889
17b27054-dfd6-4c01-8ced-c62903c204a6,Commercial,0.9132911772250375,22,14,566,640,74,57.436064675026984,2776
ffb8820f-5d85-45bd-bb35-449608ff2404,Educational,0.007624529830992932,41,20,597,716,119,27.321967969878536,3446
ea90ea9f-2d24-43d4-9bed-91ff55a48152,Educational,0.6828146329494842,24,28,206,522,316,70.88414528427407,5627
2f249d28-5353-4e73-a7f6-c8e6dda214ca,Commercial,0.5067066590731488,47,13,172,414,242,79.52400235217276,7990
a43ccf5c-3af7-4802-b3c4-83b579fa1723,Residental,0.02364706930555127,32,14,452,1067,615,44.873090186121566,1828
17ebe39c-2b6f-482e-a308-519a8832b9c2,Commercial,0.3853574872035044,20,36,377,912,535,87.93814162304187,5469
413d0cec-6fcb-4b78-b07d-ff023157bea6,Residental,0.4361187457284281,39,25,553,991,438,71.81725866976056,1687
d494045b-fadc-4cc3-acfd-be5fd58b5e92,Commercial,0.14345911312151027,14,9,138,609,471,23.153236826016553,5416
1db4f7cd-0b46-4b38-946c-c5a3402c361a,Commercial,0.05661119030985173,6,30,518,1418,900,93.11518564430607,6788
a68c0f15-2fbd-4168-a08f-7ccbc2316115,Educational,0.9545513951242175,7,49,8,891,883,22.722493697222713,1939
55961c0b-5d91-40d6-af15-073ca83860fa,Educational,0.9313848347228249,7,4,3,889,886,91.15128078151673,8304
ab0bf71f-e0ad-493f-b41a-e1608e380e9c,Healthcare,0.49365009916628755,36,44,357,906,549,67.59459586085262,8588
f67f18b7-b513-4b66-abf1-9bd96e1fa80f,Educational,0.30883927346919327,39,12,691,945,254,40.844292903105305,8094
1d3e02cc-1dcf-4158-8aa5-c77434e43e52,Healthcare,0.2728029031165661,16,49,544,653,109,44.51869142871135,7464
f809081a-ac6b-4d2d-9a3a-7d5cfc5ea4ba,Healthcare,0.30051340827134665,42,23,327,359,32,88.16242577300693,5471
2b5af213-5379-439a-ba5b-6726784d9eb3,Commercial,0.5639337415971732,18,10,87,1112,1025,59.38109416202762,3096
e9704233-a574-4e96-b99c-f85e9de28ccd,Commercial,0.3580201418748895,21,34,351,1273,922,47.260596000380325,4828
9bff913b-c3b3-4239-a727-c02849035df7,Healthcare,0.41187499281398887,1,14,43,706,663,45.840031195078495,8252
616794f7-86bf-46eb-a3b5-bb4f7a2d6999,Educational,0.6684386825801483,46,29,424,434,10,85.83077813701676,5317
29977cc8-2e60-4cd6-8fe5-3ccd9e4dfdaf,Healthcare,0.8716397034510086,13,7,336,1182,846,28.41338216491048,6417
482fb00d-688e-4626-846b-fec97dbba09e,Healthcare,0.8495769688078879,17,41,538,955,417,94.89618313223976,6404
75b6cc4b-6a16-43a8-82d8-a8b2ac60fe93,Healthcare,0.620916858698593,47,6,603,1191,588,68.35198888683124,2367
3645ba01-8920-4e0e-b6b6-2b9b47f3d4ee,Educational,0.4088588622426146,40,7,257,903,646,76.05928261192938,7429
b22dc593-d19f-44ac-957b-71090ff4cfcb,Commercial,0.3713102238091156,43,5,462,682,220,87.8644471778791,8738
f5c1d3b2-1711-44f1-86f7-23f7debc1d9b,Residental,0.42491131861409637,22,6,237,443,206,82.45811165317636,2737
3ed1114f-f390-413a-90fe-245ffe391ad9,Healthcare,0.7190603468850205,28,15,607,872,265,93.40189941080432,5901
7cbc3e6c-ad0f-47a8-a69c-bcdb21424d7f,Healthcare,0.19449772926443964,16,35,525,837,312,75.01066373808807,5912
9921dee5-df7c-4231-9c58-bbb13e95a794,Healthcare,0.25120815565183374,20,24,260,1087,827,32.01368562900464,1662
82736f9b-39c1-4d7c-ba99-de05b5d783c9,Healthcare,0.639056723888422,33,46,409,1173,764,65.87096633234988,6781
aaed36ec-a340-46d7-81a5-016317983670,Healthcare,0.13758227518457133,50,25,680,1023,343,72.77214534651421,6951
8b0d43ac-954c-4ffc-b6e4-54aebd0398ff,Healthcare,0.8194825258593207,31,45,499,825,326,63.36432060910057,9967
c95de14e-6250-4ac9-ad49-96a5c69f1c81,Residental,0.72485233974202,16,36,39,1268,1229,60.915526478321986,9263
9194f8e3-2f6b-4104-83e3-89d0d2a129ce,Commercial,0.8296101716507454,30,24,712,1229,517,36.635846475440644,7697
60600b36-0dd9-4a66-bf11-f90bb2fa67ac,Educational,0.9981945207014755,5,3,586,1377,791,48.397402660331835,5097
a3d6d342-1183-4c6f-b18f-d9c0fce5f922,Healthcare,0.8813297982642871,3,7,228,1109,881,15.87861226024641,4446
144af4d0-0a76-44d8-a331-d1cef14c9249,Healthcare,0.6802519034173699,40,40,570,1020,450,30.000656374670324,6647
b6051766-b579-46fa-93fe-f6bcc61a4b00,Commercial,0.4908541752936445,45,28,349,1067,718,54.19710993813301,4049
3c121e2c-7ff7-4bd4-8171-aeeeb3b6d2d8,Commercial,0.7364013305316709,38,18,354,1051,697,38.19584588487733,4866
38c66fa2-f31c-417c-ab01-20071f418e43,Healthcare,0.8041254373856259,29,43,670,1327,657,77.10876772988424,2258
6bf757a5-9dc4-4d91-aa7b-7a66efb05f2e,Residental,0.7420194923738672,46,4,5,435,430,68.11861186633834,3062
31821e25-f808-45f2-b870-f45dbb77aadb,Residental,0.17312261683556962,32,7,482,1388,906,64.76082809048012,6570
e0406590-c8cd-4c50-89e1-0709718845f1,Commercial,0.38441948433657847,45,23,177,477,300,81.26780028891821,3866
2f84525d-f791-4149-9933-9b8dba27bc02,Educational,0.562223139830006,1,14,292,863,571,49.79733852324997,2016
5736cbf7-293a-43b1-ad53-9c78c0b98aa9,Educational,0.30696419632306327,5,48,134,1163,1029,85.3383467556456,5428
87145c38-b8fd-43eb-916a-d6173f491a68,Commercial,0.44529399935479863,13,37,225,1097,872,49.99158788578537,2995
d446353d-82b2-4efc-b511-2b2a8194c5e1,Educational,0.3239407228736104,23,13,617,1176,559,25.177147514992438,1149
08458970-9e21-4a1a-ad4a-84e446ba1a42,Educational,0.4227378948566257,49,45,374,658,284,83.79012012563942,1118
67e77512-f609-40ef-84ee-641b0c2e1f79,Educational,0.5431989653222992,8,48,513,586,73,12.211889213186979,8781
596e9b19-445f-4524-8cba-654b3ec52186,Commercial,0.27828737041413687,18,50,163,865,702,60.10269794216468,6000
665c8b49-789c-4b69-9539-bd732fd47707,Commercial,0.458027486528396,20,10,137,220,83,27.62953815049338,8282
78185b69-88b1-4389-b544-68448af0d11b,Residental,0.9924523419878255,41,9,707,797,90,11.153702183129871,1802
03f33293-93c1-4dd4-b207-4d1243aea6e0,Educational,0.05952603147299018,18,32,549,1288,739,50.754362885969016,9004
a56d1ed5-7c6e-46c3-9d14-29a92957e29d,Residental,0.5188749929457738,42,33,553,1052,499,38.197992322247586,4368
9c008d12-8f09-44b3-b8b7-d697561c65ea,Commercial,0.36233940003669596,10,16,351,1421,1070,11.157190294021547,8055
345e0be0-172a-49f1-9a69-e8b2f75e8c9f,Residental,0.2560866381660495,16,25,301,602,301,48.8146227834518,3949
6f4e11cf-077e-4570-83fa-3f5944d7ebcd,Educational,0.1734871774647757,44,49,460,1296,836,69.1755772054333,2683
450a34e3-1dd1-4c44-896e-1884593bcddb,Commercial,0.2151457806932141,7,25,249,1439,1190,19.96142014213741,1759
526ab321-61ed-4952-9cd1-f6752e3aba81,Residental,0.24375355123266895,18,17,601,897,296,46.240666690780614,3185
2381c14d-d59c-480b-85a6-8fd55fdc7ad1,Commercial,0.7467371380905713,17,12,308,1134,826,44.50350229436746,5968
70bac3df-59fc-47bf-b3ce-4617ef98ce0e,Residental,0.6459817021934523,13,6,646,1283,637,61.847803522742446,2379
50188f99-13c9-41d0-a02b-a271b947d255,Commercial,0.21707036176397354,1,23,84,904,820,45.00654790314534,3630
da2c6eba-479f-4992-b198-19a7d6ffb07d,Educational,0.025739565224895844,14,40,321,918,597,21.383931850961574,7884
49a6e9fc-6f98-4732-b9e8-06b1edd15774,Educational,0.6057761349450356,41,13,302,950,648,61.40860843006291,9329
10f59e3c-c32f-4ef4-91a2-255b4d89d55f,Healthcare,0.41404327770619176,6,18,516,593,77,71.66126181608485,9422
163326c5-fd71-4554-a8b4-bf737bd903e2,Healthcare,0.3402058552094923,45,26,538,602,64,93.38891234444576,2205
271fd043-fd13-4ee8-b6db-ac3bc2439bcf,Healthcare,0.4400497264197808,31,25,524,787,263,88.01594396399719,8544
478ff75d-59b3-4cff-9a20-d0ed1fc136c4,Healthcare,0.8080988105428436,6,45,336,589,253,60.018444326282776,2347
188f2bfa-52d2-41ff-b729-2d7261c70f71,Healthcare,0.33301359882890647,49,11,456,1246,790,97.38013966765429,8644
cafd2165-c833-40ad-8229-1029b372f5ff,Healthcare,0.05369804386736132,5,10,584,1044,460,21.55620426217849,5249
a5f1d27e-7070-4dd9-bd1c-a31cfe865a2e,Healthcare,0.40667208651213016,35,6,68,1027,959,36.037548739028495,8611
da7cf128-775b-4f79-9f8a-28263ebe55fa,Residental,0.8088389428388587,4,49,77,1003,926,91.03802784055505,5530
2866f3fb-7c91-4cba-af9e-154735145232,Residental,0.187879070819434,8,21,320,341,21,54.31543701512373,7061
64fef705-2a6a-4c68-bf5a-cd4f81206e18,Educational,0.8962790492651747,6,2,616,627,11,97.84533626453975,1869
05fbd8fa-b7cb-4b33-ae12-a2f6f7bdf1ed,Healthcare,0.7257440061490468,46,29,487,695,208,33.17856073338852,2658
99812bfe-eb83-458e-a55a-eeaad7374432,Commercial,0.02777612066176538,50,37,641,706,65,55.727665667045365,3517
9fa6d22e-f2f0-4320-99ba-f426f4c3c0ce,Residental,0.26309177433805075,33,10,434,1029,595,83.7860667623657,4085
d550d98b-39a1-4005-8430-07370ad7dc5f,Healthcare,0.2969440412539529,13,42,168,274,106,55.68715744138481,9875
21ea3372-1671-45ab-84fe-f4fb072b5b0d,Healthcare,0.5730169235863133,26,10,221,1142,921,97.00374164689617,1422
9cde7103-eba6-4a56-93f3-b75daf16f0c8,Educational,0.1254902500443068,39,28,170,996,826,96.39159683593032,3057
0c102c43-e77b-4983-9f15-b8debbcc658d,Healthcare,0.9873198341009641,32,42,180,961,781,91.41651134179232,3094
fad25f83-1a65-4fc6-8338-b5d1d1ea2e9d,Educational,0.3135091669745521,47,31,492,1258,766,61.25484969284869,6998
bf039cca-ccd0-434b-a0e3-3d92d44b158c,Healthcare,0.723803851372255,32,24,383,1156,773,18.109378976878354,6692
5d5a297e-f9b4-42d7-9d2d-437336b92527,Residental,0.5805212692931038,5,18,112,460,348,97.16086530866842,1562
62f4ef63-2e78-4b0a-8bcc-a97c1f051c3b,Healthcare,0.013305070878833702,30,33,650,744,94,47.18693920412226,5153
db452f32-306d-4730-8bb7-211b6e711810,Educational,0.3048822674911469,29,13,575,1125,550,87.22800565584383,7102
62106791-6ae0-4e19-9244-b306c7d98b96,Residental,0.6941190913641747,35,49,595,1346,751,23.28353161915254,8469
35975394-8f79-4fdb-8fc5-c465619713c1,Commercial,0.134693263129137,23,36,400,526,126,53.16901131979618,7396
681af03e-f9ed-4985-9a22-cbd122a2af4f,Healthcare,0.4391436206948286,40,4,123,340,217,67.86227618183824,7833
eb6cde17-c945-438c-b055-b61fefb74b3a,Healthcare,0.6722605512413452,5,17,551,952,401,17.935137522647913,1084
fd8015dd-8b73-430b-92c6-e3abacaa5317,Educational,0.0702911761354883,8,39,468,934,466,38.33947625466029,1515
75af5f9c-1971-4b05-90e6-66280edf50dc,Healthcare,0.048484432571962555,32,48,286,381,95,88.50087795061556,5582
bcb1b96a-e1d4-4f96-9373-c37e7c09f98f,Commercial,0.4653273062030062,44,28,13,316,303,25.730647902127792,2466
8cc5dae2-8ec4-429f-bf59-fc8d85dc6267,Educational,0.41307674169702324,46,40,425,678,253,46.76715193298895,2211
41c6ab3a-5d9d-4508-b79e-1101a14cb378,Educational,0.9161425340151927,8,17,562,773,211,50.26982423853085,5751
69a13e03-279a-479f-8ee8-7184202f4e4e,Educational,0.43281594711293725,11,39,279,1050,771,34.828983363113224,2986
0a41d428-bae9-4346-9cc4-413e75447428,Residental,0.06239632000727069,24,39,183,563,380,79.94135815064544,5830
f9aa5eac-97f7-485e-ac24-192efcf949b4,Educational,0.1510370737457093,48,33,38,521,483,15.639622723369321,5967
706c18aa-1e31-48e4-b5c7-401c6de732d3,Commercial,0.6425692314116368,36,15,653,1157,504,98.02576615204214,9125
d272b7f9-9997-43bc-853e-20fee25a2f9d,Healthcare,0.9471777877335127,30,17,99,808,709,20.057529157676733,1365
a5795420-3bfa-49e9-bdbd-a9b6ff6d50a6,Commercial,0.579395378194673,3,21,533,1069,536,73.25971785841006,5274
e4cf5abe-a841-4665-8944-e902ff90ad5f,Residental,0.43026802170859557,49,16,354,1101,747,48.89131881341052,8354
19bf2737-4b03-4db8-ad03-4712df76596a,Residental,0.39472571269557866,33,28,301,1241,940,28.453954902125858,5512
1cd9b938-2fbe-48dd-8bb4-408ebc1c4f10,Commercial,0.9800424752660498,31,4,122,410,288,28.881984937131246,8534
7e50979a-50f8-4bb0-a35d-9ba3418724fa,Residental,0.6412496339721798,48,16,706,1300,594,48.43933248724243,2811
ea0c971d-c8f4-4b1a-ae17-1f0a941ba03b,Residental,0.15434717976276469,5,3,346,1346,1000,14.122448707208886,4386
2cae60e4-0ca7-4d86-8550-3b86969c8861,Residental,0.5781554489214096,4,1,12,1210,1198,16.50909884687684,8331
39ba8d8b-37cc-4cd3-a018-4d7fcc11cd80,Healthcare,0.40301696402772125,32,27,61,1301,1240,80.5976534440236,6706
26560071-905a-4876-ac16-ff8901c3f7c0,Educational,0.632365850222841,31,27,63,160,97,99.39272426077126,8643
fa4f1841-ae89-4cbe-8829-cc6bae34f67c,Educational,0.8063742676812333,15,14,125,882,757,61.837282974105705,1065
aa7337cd-c60a-414a-8ccf-c143b13f14e3,Commercial,0.09740971693852651,36,45,669,1080,411,63.93216928632547,8314
e919eafc-5b8b-4244-879f-75e333243e8a,Residental,0.8802262671436176,38,27,119,780,661,61.30997491830896,9673
840e0c47-1751-4c40-8a72-693d39cd3cef,Educational,0.19638963267840237,8,33,517,723,206,93.8101093456565,4029
fa837ef2-74b6-45c6-8a85-4f8e0462c248,Educational,0.06799258181395673,6,23,187,218,31,13.797005595343464,5935
c6bd9dd3-d345-4641-9b72-46d4b1ee536e,Healthcare,0.3242293149513945,42,29,93,1255,1162,98.40641601052697,1116
58785773-42f7-47d6-83e4-0bdb6b2c3bb4,Educational,0.48462998878041286,4,21,328,1201,873,59.40836486949627,8069
cdc01d78-f4e6-40fa-a8d9-df7602740468,Commercial,0.6459443182073487,12,3,487,625,138,18.09583845020595,7294
45aa7f36-f87a-40de-947d-d5c641e48248,Educational,0.8863366087307442,34,8,189,1369,1180,97.77645553792279,4205
d1bcc79b-8ac2-4b16-86e6-cf274c378271,Healthcare,0.5531826060340391,36,9,172,717,545,82.59429795483715,5853
1ab01760-d754-4d1c-bd58-5b97cc1e9960,Healthcare,0.5936666276122766,16,43,100,1390,1290,94.68393421299045,2957
225ec94c-98d1-43ec-a345-81cab0af3b54,Healthcare,0.44824912897384506,1,15,487,569,82,64.40010145680648,3785
96ef19b2-0eec-4816-8c94-4216bfc77cb6,Educational,0.7508681680183222,22,43,307,1347,1040,71.99948848160284,8280
db12039e-0529-4f72-820d-40f0400500b5,Commercial,0.8763233009419085,44,17,29,754,725,16.995381012599495,3287
5737af91-f833-47a5-9dcb-0f75813a883b,Residental,0.26241676884201226,46,28,625,1431,806,79.5563628362066,2668
184f2d5a-e39d-4a3d-baf9-cb903b6646c2,Residental,0.035392211578753496,9,23,299,1207,908,74.786844630188,7337
0ef86bae-52c3-4939-8c36-d3d3c3140996,Commercial,0.07268720684179875,49,37,659,1339,680,37.75034196097779,9403
12181bf5-27c8-42f5-b737-5349f52311a7,Residental,0.7253198868044828,39,50,252,1140,888,38.12450512451236,7285
cf01301b-898d-4e26-88c6-0245a5a4dcd6,Residental,0.5008984147395146,16,4,679,1046,367,27.79269815571863,3583
a4ea96c5-e1f7-49d4-9eaa-9421f2ae06bf,Educational,0.2755753861625846,26,39,651,1225,574,32.093224802474026,6217
a08a17dc-663c-4fd4-8652-a943ad87d2be,Residental,0.21634078536815926,27,30,627,1121,494,64.74671498873872,6759
50ad8e8c-e8e1-436d-9946-ddf4d285692a,Healthcare,0.796016624326733,49,14,319,911,592,25.700733645576815,3535
ce58ee76-58fa-45d4-bc30-0ea7d900f818,Commercial,0.865616667649135,5,49,707,846,139,14.078987434559716,8368
69e4c438-0b1e-490a-bb46-74beb912dfd3,Healthcare,0.9075684596719069,37,12,484,1263,779,11.11193704265931,6853
3d68293d-af98-484a-8e4d-0ffc952e8065,Commercial,0.5586405007146087,12,2,184,1377,1193,26.086111590737207,9259
0337fb14-1bdf-48b9-818e-0f35be3fc4b2,Educational,0.960729490914601,45,19,371,610,239,29.19588734857184,8378
b3162a75-830e-497b-b32f-e1ee33582faf,Educational,0.07754230113163452,6,47,708,1279,571,19.69346350906583,6707
ea568b57-d2c3-4bdd-84a0-be03dde5b1ab,Residental,0.8511085707055143,42,35,197,494,297,63.5712435266887,6184
45aa4dbd-46da-43b7-8390-339298d0ac20,Residental,0.24535158577333394,28,39,485,1068,583,75.87873903633982,5960
b2b5658b-cd87-426e-8998-e64c1a115b51,Educational,0.4137591003215414,12,22,520,926,406,47.23250953384448,6891
4d00eec3-e26a-4e9d-b247-ffc450f6a426,Educational,0.9782856999289468,38,19,579,1171,592,42.40886544836469,2910
e3f3e0d6-8a65-4db7-8ac1-8d6274ab4a23,Educational,0.8622718615356353,25,21,632,675,43,25.9816322900071,4383
37155a23-8833-4260-bdeb-f9f44fa6cb11,Commercial,0.5618631537782083,6,32,208,1204,996,23.868039378350826,2422
11d9ac3a-9651-4583-9339-181e90cd2cf3,Residental,0.6232253514148954,18,31,477,621,144,48.13941046465536,3195
148d5b6a-f8f2-47f1-be64-51bb10c95bcb,Educational,0.047515281030668044,41,29,534,581,47,64.81376759156663,9190
4e5b3f63-754e-4bee-a23b-c15d884c1a50,Commercial,0.23585551373125502,39,8,468,908,440,61.72064599904749,3856
3b68375b-96f6-4ba6-a3c5-817a837c9940,Residental,0.4771246044403935,6,30,362,538,176,40.821350401315286,3041
c0296fbe-6157-4b20-b41b-453153bcd52d,Educational,0.985432072969357,12,31,98,927,829,85.62246759405548,4311
9ca2a7a9-99fb-47e9-8841-8ec831f8f0df,Commercial,0.7429089845039574,11,5,447,657,210,59.468288773230356,3623
217e96d5-ef44-4cb0-be47-a0de8fddc548,Educational,0.21740786401737022,22,47,76,1043,967,33.28665211040905,9487
061069e7-bd57-4455-b4e4-f8c8900b0822,Educational,0.04668369354814805,45,14,379,1125,746,81.30611696571364,8183
fdbe95cf-a4b0-48b0-8581-812ebc4a91ad,Healthcare,0.8425583486135527,39,34,11,405,394,54.69099066469859,5098
f739b3f0-503d-439d-bdb7-f91de26bc4d1,Educational,0.38041224546397323,1,41,639,752,113,79.66839026314102,5578
b585efb3-13af-461a-9485-0d7af9112675,Healthcare,0.27712128641978884,43,47,700,1245,545,24.76646145594406,2429
52ad87ba-0a96-4fbd-99b4-7c0d21a34b71,Residental,0.34525394992243874,8,8,570,582,12,17.26855297169398,8846
a25d8f99-bec0-455b-863f-301736787090,Residental,0.345337661110642,3,21,81,169,88,55.04997813002288,7109
f97871a1-2143-4f6b-927d-363f24b62cbd,Healthcare,0.18960682079338698,29,25,567,1014,447,68.64871800954398,2634
5fe35bc1-bb60-4fb2-9110-ae9fcf647cbf,Commercial,0.5333729342163688,21,19,519,1428,909,11.69672481128613,1301
a9b92ba6-cd6a-48d4-8213-39a5d8c4130b,Commercial,0.6036277044835707,20,8,130,964,834,70.28960250566115,2013
80c3e5ee-ba9c-4a39-858d-b3011fc8b8ce,Residental,0.3624050790991534,2,2,672,1002,330,51.18107430415186,7555
83eda163-2592-4887-8f54-252bcbfd29c7,Commercial,0.11240583272662918,12,32,495,1110,615,79.81211006884762,4264
a6ed5408-d876-45b5-81ee-9fa9745bb6a3,Commercial,0.0078249732394009,13,3,549,1100,551,70.10128978228366,7949
b246b8d1-0c67-4863-9f4b-680eaba9dfe1,Healthcare,0.05601982933821681,4,22,20,1311,1291,29.05831952063767,3012
053c7b43-fb4c-4858-877b-e876353eaa91,Educational,0.34515162607693595,2,43,119,943,824,88.85795625680133,3120
6c3ae392-1ea1-42b2-8478-f0154975a190,Residental,0.17531843453871598,11,42,676,1421,745,96.72803499585356,1035
1f6fd121-660a-4dd0-b0a0-e5dbb34b0967,Residental,0.4143766983511663,30,28,588,971,383,35.72196000059432,7277
269a81ed-582b-4d4f-bf94-2b9091c4688c,Healthcare,0.9511078872112908,39,42,10,1057,1047,48.19843144061214,6546
413ef7c9-ec59-436e-a2b3-ceee1128887b,Residental,0.15265589153728198,21,28,59,434,375,84.04738699170282,8084
b965ce0a-14e7-4eff-a64c-bcf851d8ea14,Healthcare,0.8059247402001456,21,11,705,845,140,42.133927847153444,5879
7f87c785-ebac-4e6c-b432-772981bd4086,Residental,0.5047796693753451,36,7,150,155,5,72.57302130793587,6361
90c9c240-624f-4e87-96c7-075fb67869ed,Educational,0.346569678499689,2,13,286,644,358,86.97687164341013,6671
2e205a5a-cc96-471d-ac2e-dfe2afc77b09,Commercial,0.9412147204888127,2,47,35,489,454,95.67948523933617,8239
21020bda-6dad-43f3-98df-4181bc468ae8,Healthcare,0.4973918067461014,13,30,300,987,687,20.441199605721028,7327
f040d58b-2861-4895-82d5-eb1abcf97dd0,Residental,0.6083888225461772,5,44,573,1318,745,35.57341048950114,3358
1ef4e079-397d-464c-97cd-278750e9d209,Healthcare,0.6947006869723474,41,24,478,1320,842,40.99324213393602,2285
94351dfc-c062-4a9a-b5ec-0fce6e96d014,Educational,0.12583062652834354,23,46,22,448,426,61.03027361244757,3125
09fc5a06-16d2-4a51-acf5-75cd210609aa,Residental,0.04965898363385979,29,28,500,1281,781,41.861586368506686,2604
ae01db2c-92c2-48aa-ad7d-9af5819494cd,Residental,0.5523638822709818,48,17,428,624,196,48.75992997790588,6677
7ac5e9ff-b2cd-4c8c-ad40-c2af2f486200,Commercial,0.23208311241947444,46,6,309,833,524,10.355528136474732,7550
579155c2-025c-4343-906f-759741ad98de,Educational,0.7164133014182428,13,11,242,1440,1198,24.845539651802515,6419
26c64092-12c8-403c-a4c6-23b2a36d6d86,Educational,0.6131939173789533,25,5,207,1422,1215,66.26714274261973,3009
a8e57fb1-858d-444d-8074-d4a3228fe984,Commercial,0.6768410653942462,41,9,418,1330,912,77.8953041919231,2602
40af8941-627d-4889-b675-6affbf7384c8,Commercial,0.11994748670829414,13,42,380,879,499,35.19812308810171,7781
4d9fdb57-a665-4b64-aa45-199d86586500,Healthcare,0.2607824275347571,33,40,62,1424,1362,62.79180463712302,1669
4dfe79cb-955c-4f37-9893-fbde43c328b5,Residental,0.36872989338581275,50,15,267,1153,886,30.619768866329032,5253
b6b134d1-d756-46af-be44-8ef102057dab,Healthcare,0.872715062103049,8,35,539,1061,522,43.32062219230422,7108
24392571-c2f0-44a2-9a0a-83e1d112fbeb,Residental,0.5553959089061383,50,48,352,1406,1054,17.623012217961122,9068
676577fc-62e8-4d45-b682-146fb20b4b9b,Residental,0.07484058985762576,23,9,515,1130,615,21.821750472131722,2913
df3b4568-577b-410c-8799-a19515a13eb9,Healthcare,0.2473968910283002,10,14,390,1433,1043,56.25558753704982,8796
aa6efffc-0b00-42ec-a1ad-72db4cbee0e9,Healthcare,0.43198421188579605,21,24,479,506,27,74.96405019721115,3709
180b89a2-b6c9-41da-b213-62f2d1cb8797,Commercial,0.3016795337783321,36,36,198,513,315,54.93439220496928,5927
2299c62a-d751-4e62-a004-1b8e905fe692,Educational,0.9713825202371945,29,36,382,958,576,62.279011821294475,8917
5050003c-6f5f-4133-b221-e76ad27481ef,Residental,0.7715902677523376,17,18,458,770,312,82.19808369589394,2697
6229e912-fa59-47c3-b291-a192ed199295,Residental,0.4131147992948443,23,20,399,738,339,73.8523053672983,3473
d7a383ec-ec2a-4af2-855e-dfd3238ac068,Educational,0.5914679378411792,6,44,65,796,731,40.61835857539431,9188
0de9a779-8ba8-486c-9faf-3db7c0ee7882,Healthcare,0.22018026292145465,45,35,324,563,239,25.194000771494107,4108
c7f615c7-2a92-4f6d-bdc8-4bb820938a48,Commercial,0.545315260662031,39,31,519,953,434,97.15356517945378,8202
3a1057ef-d582-4916-a37c-58ead1beee5d,Residental,0.8586887216303702,27,20,709,775,66,66.2947204469737,5591
40ed49db-29c5-430d-896d-a7cd77205c2f,Commercial,0.8263886922194759,22,20,25,457,432,28.80947979772709,8390
9b952c49-226f-4f61-a037-501e61c5d931,Residental,0.015605148331363061,21,28,289,1317,1028,91.39017252464711,2345
60dc6b0f-c494-4495-86d4-4b044177a165,Educational,0.2095653701173309,20,19,577,701,124,93.70158719428095,9658
d30d9940-9ece-47fc-9c6c-8ededb837783,Commercial,0.7585497887108649,8,6,319,790,471,74.87281664349314,3279
5ae1e3b5-7f35-45c0-b2a0-9bda96aee1fd,Commercial,0.7446062402643967,20,25,563,657,94,74.81679287195198,6821
58ae3687-103e-4aae-a521-db1fd33cda52,Commercial,0.130907716243991,19,35,309,402,93,92.3865515115697,5734
0384d84e-646d-4ce4-8106-368d01c40077,Educational,0.44067900037677643,16,27,215,968,753,88.78065113016686,4120
0e05dcd6-b790-4bb1-b398-3a7e7c56dc83,Healthcare,0.5909416459049189,40,34,533,1100,567,41.69445756820273,3111
6565f14a-c21e-48ff-a313-bbbdb11479c5,Residental,0.7916050249430938,18,38,441,780,339,81.22315373409734,5025
1e318bdc-5db8-4906-8173-7231215ef4fd,Educational,0.33961082029292033,16,27,433,1051,618,26.6175596790919,6650
f070e1d5-5c74-429e-ae25-d4bcd770352c,Residental,0.0975166353455501,50,30,699,1320,621,41.87294593323159,6967
6b8e68e1-bbe7-4717-8605-7838df9bdc01,Educational,0.3194599278500533,49,13,437,1282,845,57.008456142151445,5218
5e3ff551-41be-48fe-b3df-5168f8e156bd,Residental,0.26096825368038234,13,4,675,1303,628,49.80370124748807,7170
5334ffa2-9bef-4910-b57b-ca55413772fe,Residental,0.08113341873385582,3,28,165,1147,982,15.949473927378417,9117
ea928c31-9469-4803-b453-0989833da475,Healthcare,0.9319151462146585,32,4,421,925,504,52.58413428889822,5517
9c07399d-3435-40e2-a45d-84c5f13587f2,Healthcare,0.07746163839296993,38,16,266,1290,1024,20.631680196436108,5707
0179f138-4032-4a50-b625-025fbfe91577,Educational,0.3451780260785471,29,4,23,1115,1092,25.283194854914377,2103
d2964d5f-3e6a-40ab-8d90-34f01e2f1bd5,Healthcare,0.9982138865736736,36,42,511,740,229,60.253346482410024,2720
cced1f0d-e453-4d1b-bb3e-6a04e895a152,Educational,0.21028780083604492,50,47,130,905,775,19.703076510730607,1011
09e7a5c9-41fa-463f-875a-a6d56d9bb083,Residental,0.04142936330837299,24,24,444,1200,756,39.77339709623568,8766
54dbeb06-6492-4f90-ae05-cdda6906b4c8,Healthcare,0.586013321368259,45,9,59,71,12,11.133899499119337,7094
05bfa8df-7cce-4e06-88b1-b7b42a7cdd2e,Residental,0.3260809116970498,8,10,71,1036,965,14.741444476154996,9208
e4edc930-9be8-428a-89d0-198d8386bfae,Commercial,0.8647885877981047,2,50,257,281,24,61.71580705060379,3242
251560ce-966f-4021-a0b1-189446ab18a0,Residental,0.6678153319209347,13,10,467,1366,899,96.50896210739126,9959
e41b3d3b-a96c-4fb3-a328-be72686eca8c,Educational,0.5359988656086914,20,25,202,917,715,64.98813004492717,4070
3ebfe05d-9071-4f51-9672-34ebc84f3622,Educational,0.08846284856615316,18,16,299,1130,831,27.45613422366727,2913
b453b6a9-29be-48ff-869b-d29b11c377cc,Residental,0.4209658437481417,42,49,382,523,141,11.863943865878001,6577
0d549151-feb7-4ba1-a255-9ea94f70e72a,Healthcare,0.1181509099447835,37,16,164,458,294,46.021512683735864,2978
b7d9e927-c7c9-43df-b5a1-a1aee78dd2e4,Residental,0.6956546498121159,27,23,116,324,208,92.39739969451345,1439
c89f5bac-8611-492e-a341-42078dafa582,Healthcare,0.40634206732068456,46,9,253,1053,800,82.01401560441424,7583
54e3b5b3-38a4-4135-9e65-24b96a5e940a,Residental,0.8050728837795644,1,15,55,599,544,74.42648570347899,8594
f429675b-8077-4b56-8e7e-1e2fae24b5f1,Commercial,0.379954024955356,9,4,29,1239,1210,54.10862779291359,7749
b75d4c1a-8b33-4295-b59d-cdeb5bcbf492,Commercial,0.884856291780656,10,35,163,792,629,15.427074173218198,6378
253fc2ca-fa4e-433d-a3f1-0b7ac81aaaf5,Educational,0.7630413965354265,42,37,436,1346,910,45.749042721095606,1461
c901bb1e-86f5-4083-89cb-20a73c12efe8,Residental,0.4420995787770511,48,47,153,665,512,48.96923631917344,2076
e87a1a94-059a-4d4d-9d28-65cbac5fea6a,Educational,0.6533231233439215,32,40,689,914,225,21.61485383503522,2491
1cc2cd80-833a-4e9b-8b2c-a89aea41b412,Educational,0.07908480739942814,13,40,204,1081,877,33.46208426835602,5874
2406f710-e6b7-4550-ac28-51ec892f18cf,Healthcare,0.7146726927504734,38,44,43,1237,1194,40.064864716751636,7927
8ea2a4f2-6a04-4427-82c8-4be7ad7831ee,Healthcare,0.3505245268342203,39,10,579,1078,499,51.49550038993043,3778
b364c562-a54f-4dcd-a41c-fb633b5da464,Healthcare,0.63625847179345,25,36,524,904,380,13.18308587438738,3502
a8fba6f3-b914-461a-b4dc-7f590c01ef24,Residental,0.6403564430575274,18,25,188,673,485,14.057461620940241,8309
64892bf9-2980-40eb-a61c-40ba9da93a17,Commercial,0.5972306485890616,45,33,402,712,310,30.913165277523472,2478
aeb6dd1f-e8a4-4417-a506-91a397dcddab,Healthcare,0.621244604891138,24,33,64,237,173,73.11177024053501,9606
907c6d8d-030b-47ca-bd48-85a4bcab6b19,Commercial,0.4946578087215383,2,36,468,1178,710,30.001120704743997,2556
0bb022ea-62bf-4bf2-b412-44822fb2bdc7,Healthcare,0.8268854956783063,34,21,429,581,152,23.40595125999918,7730
9ea4602c-0644-4b79-ac2d-1fc0daa7ef0c,Educational,0.7390899333648627,30,30,511,928,417,16.93176001009414,5903
a82cb219-9747-43a2-86c0-5ccb0b25e535,Residental,0.3372333283123108,25,39,382,1128,746,12.823112052980473,2275
41a6bed1-e778-4e66-b47a-da1eb08218ef,Healthcare,0.08593901160167838,44,4,491,565,74,10.002624482490981,4150
bcc3c9cd-405b-4d68-8764-4e24166a2036,Healthcare,0.20471099125530645,3,2,549,581,32,23.151606130236775,7997
e2b3d56e-6d21-4ac0-a666-ca2d8baa7fdd,Commercial,0.6391244610844706,33,36,574,602,28,11.713882972016593,8700
4efde290-b37d-42d9-bd96-bebb08346b56,Commercial,0.5739141888442251,9,38,605,718,113,80.66657232053684,1863
18a2d73f-bcef-44fd-9442-320e250b6cea,Educational,0.6586367925499816,37,14,181,667,486,40.75960150609348,8629
10935088-1f02-49c7-820d-c0e854229aa0,Healthcare,0.6597369433062548,29,22,5,570,565,81.88653217314929,1532
50c1cc6c-b4f7-49bb-81a7-5e88a201e7b5,Educational,0.6271914277282845,1,36,634,1177,543,97.16502547350491,4402
2e07244c-e12c-45c6-b80d-f31abcd7064d,Healthcare,0.5948855451804389,48,34,170,987,817,72.1971095384747,8612
b3cfdecf-d9fb-41a1-aa8e-afb3c872b859,Healthcare,0.900827889446902,20,49,651,1361,710,93.57208864356816,8794
aee6c4a6-2ba4-4dca-bbba-4c528fc8fc0c,Commercial,0.3700027459691023,6,16,75,502,427,26.82770285294732,3241
3568b856-9e95-498c-8394-f91f4ebd1577,Educational,0.4718907256789273,42,16,553,1114,561,45.79828602020178,2456
d32da8a2-9f33-421b-87a5-37dc945f794b,Commercial,0.06500686676783063,43,4,86,919,833,37.03807985289156,9090
c0e9fd32-881b-430b-91a3-d362a945831f,Residental,0.7186410271912118,46,43,13,622,609,36.66631119723189,5259
12603e2f-4996-4022-b9c1-2a19736db295,Healthcare,0.14905280725733683,35,48,413,619,206,26.102264387336856,4192
a1949ad9-fcc6-4cdc-9485-c64e8bb1f305,Healthcare,0.5269645856422143,41,47,115,445,330,86.9296096608579,8539
bfe7e679-c227-4c62-a1b5-8dfb0e4815ce,Residental,0.11038203592002727,4,27,358,559,201,82.84074713797078,2824
38afa788-e152-40ed-8103-4fb714002487,Educational,0.15707999273920892,31,45,224,460,236,74.1679332494626,8705
af2aa188-f20c-4468-b2e5-6d349ec2508e,Residental,0.4140699460302181,22,35,657,865,208,24.815504311113685,8568
7af4a030-853a-46af-9970-734c36110766,Commercial,0.5193993414181616,23,1,246,1171,925,87.01152216113127,4207
37ead73e-0bae-42df-9424-5c2c3aa6bef8,Educational,0.5293093366597418,12,33,677,1409,732,18.404848701983262,4467
e40f8601-b842-4a0b-9ba0-610501b83e62,Residental,0.9073324235660828,6,7,535,1251,716,89.15560349388917,2916
866ed811-8a3d-4716-bdcb-9bd1d042194a,Residental,0.4615041152690984,25,19,257,1191,934,82.3853632814104,7131
a24478bd-d7bd-423e-a8bd-b208eda4e8c6,Educational,0.6982124832214136,9,38,118,676,558,61.90383780751294,2380
869e4518-181e-4e26-858f-e2f962cf325d,Educational,0.18825531763307324,38,45,184,344,160,17.043413501975987,7358
b16c9160-b448-4067-aaec-9b256e5c7412,Educational,0.24172905970620873,6,17,529,621,92,61.491306440281,8258
6ac4d555-7c29-4a99-863d-0a1880c24906,Residental,0.15135256833626254,21,1,339,361,22,72.5346157023814,3022
ac676328-0858-456b-a6ee-da10fa1ff295,Commercial,0.20671746662669688,13,34,146,891,745,75.39473291509724,6365
48886363-d23d-4847-9641-f1844c8e6b27,Healthcare,0.8191015355590336,31,47,392,545,153,14.40130431886795,3599
00704373-568e-4200-975b-5adde8aaf351,Healthcare,0.6413342431400116,45,12,229,262,33,42.99610080680711,3823
46a9c555-50c2-43f1-aee7-85236e5dd92a,Educational,0.7475956113877132,22,42,160,458,298,66.80848644084332,1694
fb110a87-1322-40ae-99e6-2e2c9ce4f48e,Commercial,0.363745438974044,23,23,669,791,122,76.69488308512688,7306
604b416b-7fe3-4959-9f65-39f214f49a69,Residental,0.8337394580509004,35,27,368,662,294,99.81541880946614,9504
a1d46c70-615c-4727-8c83-68ba0f47c9fb,Educational,0.28350851151268797,26,34,95,383,288,47.67304110519497,2893
4f92d73c-8a51-4e82-8b7c-baa4fe65e07a,Commercial,0.4784231698149386,20,35,278,813,535,26.414637160890216,3236
abe50968-565b-4daa-9d78-52bd4f0d5da9,Healthcare,0.5815309383043933,7,47,155,580,425,39.35822184772459,3161
b49fe0f9-c44b-4480-ae59-74b1a18bd0af,Healthcare,0.508740948894024,17,34,155,1340,1185,37.7388037309216,7155
0a039062-3d3d-42dd-b60c-07296287a7a8,Residental,0.4062050948414869,32,39,645,1344,699,42.56751294155684,1286
854ef187-5915-4563-953b-42c40f5e9208,Commercial,0.7049711082191138,38,47,509,1027,518,82.4290146041946,6272
20abb28d-90cf-42c1-8ab4-57f93f28d9a3,Residental,0.040055514988123986,34,13,340,1409,1069,99.36912461404137,2582
21eeb52d-8f0a-4e31-8149-2ef97094dc98,Healthcare,0.47476582904948794,23,24,334,752,418,12.792430890085628,2988
c61d0065-ab03-44c9-9c90-9627019d51a5,Healthcare,0.04115786155712009,24,43,205,1165,960,49.96251946128293,1154
1cf7ae44-cee8-4a4e-bf4d-1ce211d9724a,Residental,0.40750303680179145,19,46,285,1389,1104,16.17178512475231,2335
f7213d85-2b35-4f58-bfc3-32fe4d9bbfb8,Residental,0.2462524116715774,22,33,270,327,57,12.163268688243596,4176
44f202a1-bc7c-45b9-be9c-22005618bb14,Residental,0.47196770403083654,34,4,608,1423,815,88.62532696996385,8784
b2b6a6f8-d7e0-4d9e-89a5-a449a6865745,Healthcare,0.22293056327728422,17,42,519,888,369,98.49666035064479,4784
1e9dc3d8-6003-45e7-9c29-2ecb18ccb6f3,Commercial,0.844441958226701,24,32,114,551,437,59.516904813870454,9948
db1a72a4-bd3a-48f1-ab97-93242769cef6,Residental,0.013485935694835693,46,26,530,1281,751,72.8347125406351,1366
713cb560-a7e0-4688-bd38-a2cc8d1730c4,Healthcare,0.1378145577862736,3,26,643,1005,362,28.6559084217783,9114
6d2a277a-548e-4402-818d-63a9761fc638,Commercial,0.2637977975648206,33,42,346,699,353,54.25850839518756,8608
cb2eeac7-873a-4cb0-9f7d-b6e0a94e73b8,Residental,0.4465421735327262,41,26,398,457,59,26.812784150638688,7675
13cc7100-2d9b-4192-9528-5842b89997db,Residental,0.8090301073243995,19,34,581,880,299,97.18361708056605,1269
c7fe155b-6132-43d3-a3db-2ac7833fb49a,Educational,0.5635958461596077,31,38,534,1421,887,42.324264506509984,7462
ae28c82f-b56e-47bd-873c-46b15dde2e17,Commercial,0.8357731928152091,7,37,506,841,335,86.89008644551379,2501
de8b58cb-f111-44f5-995f-91b2de536bde,Commercial,0.7193455713095086,1,31,204,1385,1181,19.091399638516833,5733
9399eb40-eb69-4132-bbda-0f557c19d59d,Healthcare,0.6180090547822003,48,3,84,738,654,26.554977351604464,4323
0b5b69d0-eaa6-41d9-8aac-8d8fdf52772b,Commercial,0.06532824537990223,4,47,630,688,58,15.783547304341443,2764
37f090d3-7c89-4fef-b29e-27a07b9aed82,Commercial,0.3989394606471417,2,46,261,774,513,72.9425108099979,5096
21e83504-67c7-417b-afda-3f25387dc106,Commercial,0.49029771633451336,13,1,250,630,380,28.20533060973371,5223
4fde672a-b143-49f1-8cbc-c4628575198b,Healthcare,0.22354394584778914,33,14,374,1282,908,54.5715707909102,6114
93793b58-bd04-477d-922d-db077dc696c6,Educational,0.7486291618720494,9,32,283,558,275,21.119153618112023,1977
7f21925f-84e5-48f5-8473-c969b68e96f8,Residental,0.05219567497956379,3,22,370,1123,753,75.90360153128107,9841
479d10a8-9c5b-48e0-bb88-dfc527d05999,Commercial,0.20320660662586132,46,5,93,1372,1279,91.86443799715057,5396
c0c811d2-a58f-4443-8e38-d65f50ec9a40,Commercial,0.3173612505308401,8,31,67,492,425,34.436004466669466,6777
96e5af8e-2d88-460a-a349-4736572243bb,Educational,0.9692545767410043,31,42,168,467,299,27.214589108935815,8475
b6dcf2c2-d691-4537-89d7-c2a41ba191a0,Educational,0.05545833478332074,49,6,41,777,736,79.22638274271304,1739
56181b56-6d4f-4289-8acd-985428d690b6,Educational,0.04120798699021966,43,31,513,551,38,81.84473881466315,3486
ee1d7ccd-cc62-4c74-980a-9d388eaa5556,Commercial,0.5896091461634574,15,49,175,1416,1241,48.14212888673644,8963
7fd7f8e1-682e-4c58-9fb3-0456425db248,Commercial,0.40880359167541047,37,46,161,251,90,82.43971953045268,4831
4233b3b6-a3ea-45b1-ac40-484a5878f4bf,Commercial,0.829662093178551,33,45,686,973,287,16.736503255624996,3333
ecbc4a6d-d491-41a8-a862-2e46b2cd3fa0,Educational,0.7302740268101954,26,2,130,498,368,14.692382611110098,5051
b0fbf954-e6b2-4800-a1cf-71adb20ff033,Educational,0.7457999616075913,20,39,452,1092,640,56.68199867410867,2390
b20e94ba-afb7-4343-91f7-291a33535a33,Educational,0.2128732365984889,40,33,274,408,134,31.82942003314989,5685
a4faa9e3-a50b-411f-9bfd-0077693935f5,Healthcare,0.7073808994840545,8,50,547,1240,693,51.86018557695972,5232
6ffe866f-811f-4fb3-8c63-68602bf35626,Healthcare,0.7174402994668132,10,47,72,616,544,18.87518518968919,5886
7b783a2e-a403-48f7-a169-c50b30c996c9,Residental,0.8312867288891687,22,40,85,982,897,73.20652110070144,2987
862e5d4b-85ba-48f3-ace9-b76131d522fa,Healthcare,0.8633437892217822,22,35,300,1038,738,87.0760207268261,5479
ce03bd35-9011-4e46-bd71-101964e0af0f,Commercial,0.4444824588278672,43,45,128,728,600,25.130502563385114,1271
59dc0f77-56ec-40e2-a07d-fcfaaa896c72,Healthcare,0.7836805740439976,34,38,708,1069,361,20.26535728618348,6026
6f1f7663-3224-4fff-981a-8ca4b9bb9b9c,Commercial,0.8236919901735125,42,26,671,930,259,52.643973217588005,3711
c1ae16e4-7d6e-40f3-ab28-17796fc763aa,Healthcare,0.839895450429075,33,12,656,666,10,98.94334117537745,7654
a4793e8f-6347-4a0c-9d5b-07d2a1625687,Educational,0.19640227332353577,12,26,614,1017,403,69.65437795767849,6056
e5040660-273f-444a-a2ba-eea756bf9620,Healthcare,0.6068409027993428,34,39,718,763,45,65.01252164218323,6968
cb12495c-795b-425c-9043-8fb0cc2669f4,Residental,0.4586061042457118,39,8,337,480,143,20.230478183553075,8860
c6e960a0-d23c-4f05-8a2b-a906a7054d92,Healthcare,0.28618637897717336,21,11,228,570,342,71.59244441147565,3477
8c7f6710-3623-4695-8389-8490d10211ae,Commercial,0.4559165595661263,6,44,520,700,180,51.63944024594929,3070
62278ce2-f6f2-40de-b989-26396f70700a,Educational,0.9181216323842194,7,8,378,556,178,39.25338467764102,3334
9f1c6701-a247-4edc-beff-1b6fc11a56d2,Commercial,0.23031415539924616,18,16,146,246,100,66.30043667077564,1095
32c90d0c-e67f-4f84-973e-7603f3a21766,Educational,0.15240236532539742,45,12,329,734,405,24.81411740134725,8205
1a4e7e34-eb49-41b3-8c4c-164cfc5e64c0,Healthcare,0.8210187505954402,34,48,33,651,618,68.64140233546503,7453
41962195-8e11-49b4-8cb8-5e4a9f20ca2e,Educational,0.2186696318065554,6,47,387,929,542,40.877701061819735,6543
dbba00b5-b787-450f-851e-5249f8633bca,Commercial,0.8080619988749921,38,47,340,1253,913,64.80035614196939,7938
83643b65-822f-4d95-8f0f-7ddf20701ad0,Educational,0.15564020854302274,38,28,557,1220,663,13.654741683105948,4650
916ed620-0090-41f3-bf28-e43e2e88b8cf,Residental,0.4491666040340212,42,44,627,1094,467,64.31505107865631,5851
8472d23f-8684-4718-8956-75a35a31d7e8,Educational,0.7161182442467612,34,42,75,120,45,35.870108778635284,4050
f4416807-4d63-4996-8135-c5e61ea35858,Commercial,0.8060268407422428,19,22,712,1255,543,45.17974193989504,2734
cabf2fa8-715a-467f-a0da-2f11713222f9,Commercial,0.906424466695133,17,27,296,310,14,55.98415267453714,4244
1619dbe5-af0b-43bf-b94c-f5514ec46ec8,Residental,0.3614645908693003,48,5,435,1008,573,20.406890907068625,1565
33a014f2-451e-4d41-bbfb-49a51bcac275,Residental,0.7006633483871342,37,35,603,1415,812,31.777155087885742,6868
3f4ba73d-fe19-4dd1-b1ee-bcd9e90d18ab,Educational,0.20364020517103232,40,19,489,917,428,59.6997456069611,2544
d8abc0ba-32ef-406c-84fe-44423354ebb7,Healthcare,0.06163308167360648,27,14,400,715,315,33.163439895843354,1334
ccff4f5b-8e29-47ff-8048-3b9c24512612,Commercial,0.2803132723528623,23,30,460,699,239,13.336535343025691,8308
f453dc71-f728-4953-834b-9062e4c7330f,Healthcare,0.17000391363807366,17,31,487,1122,635,65.18975110544383,7903
cb3e8f2f-cef3-4ec5-ac5e-ece6aa8d367e,Commercial,0.1533488620011072,33,29,267,1380,1113,38.823851603089224,6860
2a3d6c05-5d21-46b5-a9e9-b0d887889659,Healthcare,0.13456614661822064,49,47,147,739,592,77.63962105700139,4134
656780e2-83c0-4a7f-b144-91589e71b3d0,Healthcare,0.22930823869633232,50,32,571,1359,788,67.35730474818693,8242
9801872a-9bde-4984-ab43-e362b9bd3f41,Commercial,0.364148298370756,13,31,589,666,77,88.91671378465807,6471
1e459a0e-c0d2-4116-9930-965fc88c40cd,Commercial,0.5622411075669039,5,47,210,1252,1042,86.93525378474656,6581
eb340f1d-05de-4ea4-a7ac-4724a3676484,Commercial,0.08964035302214413,50,46,704,1069,365,11.937873331867614,1752
8a6702f6-3822-4d50-be24-53d528525b3c,Commercial,0.24427887397936232,15,47,431,1099,668,71.26220621065886,6455
004bbc39-9b5f-40f6-94a5-9755ff47c739,Educational,0.42079317081072587,25,43,41,336,295,89.59649091558221,3414
fa40a8ff-f0fc-42ac-bfac-57aa447d38a4,Commercial,0.12745105497737164,28,29,383,996,613,39.29087492884513,5838
77e8994a-871f-4427-9280-00daf4032678,Commercial,0.13439776347858134,47,2,479,933,454,56.61813094494696,6066
62e94973-0021-4dc6-abe9-1397e88477f9,Commercial,0.06491063665923258,20,41,422,1383,961,17.162513636745853,8814
640dd8f6-d573-4e71-9659-0ee77c374654,Educational,0.9474620731531627,32,26,11,49,38,42.70305430322603,4975
7f323087-aecb-4b0d-92fd-aab2388e62d8,Healthcare,0.5781098812517952,33,48,680,960,280,81.89497224386999,3778
78fc175d-a70f-40d1-8f3d-9a09b441dc00,Commercial,0.9262464784925551,36,5,622,688,66,18.0533969772409,5605
7a76827b-a08e-43dc-99e4-002899068357,Healthcare,0.923320597085258,30,38,111,507,396,53.85312549372894,2409
5705657c-e882-4adb-9f3b-72be87844695,Educational,0.36696740123054605,34,21,431,605,174,92.86720459204304,9975
07a95358-f28f-4113-bb4f-7fe8e8d56fd5,Commercial,0.27090742169774307,2,45,104,187,83,81.78625254336355,2791
b5c541a4-9d05-479d-901d-93c9d5a077f0,Commercial,0.08626641686599723,31,37,242,1394,1152,26.16701544347046,1314
33db1c93-bfeb-4177-8b32-e8a001dd00d3,Commercial,0.6424235847795754,24,28,524,1352,828,56.471289886802474,6809
f4a7f9b6-2dea-4e55-93ac-35c8d789fb4b,Educational,0.18410051166803887,20,31,488,649,161,86.17375445232189,4741
6ea697d6-63ca-4130-a1e2-9d4bdca20259,Commercial,0.30400260329638484,36,1,600,1397,797,94.69826119436448,9007
09bfed40-1007-4225-a8e1-76cade948004,Commercial,0.3044815396964611,46,19,710,1212,502,21.544999325828897,6322
2cef5cb5-2b48-4e67-aaf0-811e52942881,Healthcare,0.5682941869739301,22,8,38,1247,1209,20.49642648176404,8380
5b147334-9050-4e21-b522-b8bfb56564de,Commercial,0.16892808040030305,6,49,304,1369,1065,13.258013705413035,7487
7cd6bb28-47c8-495e-a439-c479bfbaa07f,Educational,0.040885712986032385,27,50,510,621,111,40.271167599037824,5478
c8fa6999-0778-4ed5-9e38-9fbdf2b1b18c,Commercial,0.7532135089342268,29,38,166,243,77,53.2500365061203,8550
f514c539-eb7a-40ae-9911-06b8a17110af,Residental,0.9641166875580337,17,22,95,1423,1328,46.223761095143594,1197
059d21bb-896f-44bb-9d49-0e67ca18157d,Commercial,0.2599976258841048,15,22,541,1398,857,30.761159785330577,6224
904e9412-bf36-45b7-b21b-f3e6d2c303a6,Educational,0.030489073455129634,42,38,118,679,561,73.18215301103287,8408
3c3efa89-c074-4b65-be83-53463dbea6e7,Healthcare,0.5428544570757983,20,21,325,855,530,35.8177062803247,5768
e472c3ab-8855-4b47-85bc-fbbef754ba3d,Educational,0.4638811420684833,24,45,155,170,15,28.25201191922085,9468
2424d2e0-1596-42fb-896e-bb2de7535e00,Commercial,0.5677493639497025,13,21,413,1203,790,74.42564405860328,6368
71f70ef7-5b24-46cb-8021-2c60eb4baac0,Healthcare,0.7921686872411906,13,26,490,1334,844,84.76754868297749,1869
4c6ec874-80e1-4eac-b1df-91edde21df2a,Commercial,0.7321277816590199,4,1,354,1342,988,53.72249384043338,1514
7edf441b-06dc-4d14-a6f3-a9a018102845,Healthcare,0.3951212068207315,39,31,275,386,111,96.68650850083846,4229
ffff602c-a4db-4990-a06e-0aad6e4379ad,Commercial,0.5761460406197685,43,3,235,359,124,81.2524012424174,2869
675f8afb-cef9-4b64-ac25-d3e7ad083575,Commercial,0.07190679765018437,29,25,511,1092,581,90.85173661735247,5453
8a3f0559-6f3b-49e1-8b35-65afa2e5efa8,Commercial,0.5158356326055875,11,46,534,801,267,91.86150176227902,9238
dfb1f5e2-5a77-4c7f-9c15-ed3eec3e8546,Commercial,0.9494065076413214,2,20,533,1044,511,31.546500953867003,4900
62622dc9-18e3-48fe-86c8-64819b13573d,Educational,0.5100372353003202,13,39,369,514,145,15.203804634168407,8575
73dd91a9-59c1-4188-83a9-5f859e27c32d,Healthcare,0.42738179865099435,42,38,81,525,444,81.93494234949368,5257
d066ed50-6cbc-4ac7-a3a9-8e4014a28ec0,Educational,0.2950061703339306,19,2,392,445,53,99.15632173601884,7028
b61eceef-d830-4b9f-aac1-a693c1d7c31e,Healthcare,0.38710477054359216,9,30,84,896,812,96.38256003890429,1026
0c337f9e-54ac-447d-bbae-4b44f5b50a90,Commercial,0.5260447314511862,37,45,122,1359,1237,14.55123269837065,1620
6f53713d-7a29-402e-b1be-a57b77601eef,Educational,0.6147786035638181,40,13,50,1392,1342,56.598217273079015,1647
30b86ca2-0fd5-4b15-8872-96864cc163c5,Educational,0.7209572186326817,6,13,658,843,185,90.16558820482483,4320
60cda3da-c04a-4b73-beda-a92798b8eaf1,Commercial,0.2463873517816736,38,17,156,1430,1274,87.05749148261422,1725
4746576f-3dcb-45ae-ab1f-1ca5a73337fa,Residental,0.10505301610210782,20,4,17,148,131,29.070284237229984,5709
071f5184-ade3-41d3-a6ad-6280486a9e1a,Commercial,0.005400258963138782,35,11,16,1325,1309,91.32844563396273,5802
06a06b9d-6673-4c92-b55e-7f7ff23aa784,Educational,0.46132729411046525,5,8,642,1282,640,51.02736312043862,1352
e86f6e41-a620-43ef-a18a-d90b5369d964,Commercial,0.1871000849343465,28,11,582,797,215,97.8667492696127,1130
8512f85b-16de-4283-b0da-f7506f855fcc,Commercial,0.3194951992938668,48,11,378,1242,864,61.79875892468731,4321
cc01c3ee-cf26-4f0f-a714-6476a103b22a,Educational,0.7317747131996619,2,6,683,1170,487,23.49750746810422,1415
a9c2b3bc-2ed3-41fd-ae17-656db5fbd562,Healthcare,0.18394085093189438,50,1,315,975,660,83.32818426700595,3287
e11d6bf1-dada-40cc-a280-817d2c470b59,Educational,0.06287094860050646,28,17,323,1304,981,77.42428685799895,5484
5115ca58-d67a-4cf4-9bfc-30a1c8712db1,Healthcare,0.5390063396053508,24,10,77,551,474,73.5074298733197,8610
7d45473f-322d-47e8-b24b-b307c89e2e72,Healthcare,0.6617687675678171,10,41,713,734,21,22.151810887687276,5344
0eac3ac8-8de2-4df2-a4b7-c0c391562e75,Healthcare,0.08051352004947165,2,16,629,911,282,29.117302427348612,1887
4e46d294-ac7d-4c31-9ae3-31bcba01d3d9,Educational,0.6387875184520534,42,31,572,1076,504,17.76878968386584,4777
845c2006-4022-49e6-b8c7-e915b6b48ead,Commercial,0.08769790255229304,27,44,668,1333,665,64.62958055877934,1956
3b0ccb1a-df3c-469a-b747-4386651528dd,Healthcare,0.726989661507034,38,29,647,941,294,36.03423736064262,8103
7d8d78bd-9ba0-43c4-8202-db1264d6c9b4,Commercial,0.9461039999224377,7,23,212,266,54,44.98665156487311,8864
4f30cd50-1614-4072-8c23-60f517ad8336,Healthcare,0.23645903559488735,44,35,460,583,123,81.44288438970354,2149
558d91c1-1b8f-4737-ba85-5daee2a83b1c,Residental,0.16253811481430835,10,9,482,571,89,68.87528190743717,3554
16f29a84-4f2c-48c3-9a4e-43cd93fe3659,Residental,0.6920530961063136,35,31,666,811,145,83.91660690387728,6254
c01b5113-ba6d-4191-961f-7f9f2250398b,Residental,0.6530388018484233,50,4,428,518,90,54.733639486230565,9618
e335abe0-7688-4ab8-9eb9-c933b62eb4cc,Healthcare,0.10112713747296509,34,39,441,691,250,35.1175175253002,2210
d8de668c-ff7f-4d2c-b09e-cd20039820ce,Commercial,0.3724903202711547,32,16,618,830,212,72.48225815804871,2382
37e33b0d-05dd-4478-ab80-e9c03b1fbb8b,Residental,0.7326029361745616,7,25,178,1278,1100,26.8413955820171,1017
54c94d71-5c09-44b5-938d-d0ff8a1f7088,Educational,0.1670655158338672,6,43,686,784,98,27.16940657511788,1587
d08cad70-7463-4bef-a36c-3e5e0fa73025,Residental,0.3768773422753313,25,13,641,642,1,87.28025265191019,7356
7869aa39-6e09-4044-93b7-3549a55e9b81,Commercial,0.6291611419080807,45,44,467,1174,707,46.47075784280048,1484
6c7a2938-eb8b-4f6a-900d-eaf505834d22,Residental,0.6597950607156036,44,22,470,1031,561,40.0734181809689,6552
4b1a54bc-83a8-4bc8-a2e3-eeb9a1fc0ee2,Educational,0.45014110572630484,31,26,371,658,287,17.2211219484887,5983
1531496a-d213-4729-8f5d-f640017e3a62,Healthcare,0.6773730032347907,8,20,174,935,761,38.098821442188154,4204
90b0daf1-0c30-46f9-9a86-60fbbcbd76e2,Healthcare,0.6720599674761519,43,15,482,571,89,52.18839988143462,2842
59321b96-9a10-4d0f-b5ff-e4ad928dc0f3,Educational,0.35403541356459567,23,35,250,1088,838,95.53124568822518,5568
31d0be10-b11e-402e-8309-8e74fe62ae63,Educational,0.8563314734405192,45,22,521,595,74,75.8458887203571,1022
447943c2-1223-45cb-991d-b3c92e343aaf,Educational,0.6397696402676935,35,19,584,1344,760,27.618494620454847,3178
283211c1-3682-44a3-a8f2-eabef169c429,Educational,0.5631580143233327,28,4,147,1259,1112,10.987802109657006,5204
132f179b-1d50-4311-a100-a178dacfc490,Healthcare,0.6143273798508572,16,36,453,597,144,69.84680662769625,3086
ad1ee647-7c88-47aa-a21f-45588d638d08,Residental,0.32947533933705553,16,31,114,1318,1204,88.55177608774551,2926
8e5d5965-a043-4907-9512-c768a736993d,Healthcare,0.1708499345861756,48,12,396,971,575,66.80515560236617,1761
6e49743d-0a8d-496e-9bbe-4c1a5a21b22f,Healthcare,0.024053229471038495,7,5,320,1286,966,24.31762689780089,9410
e18f494b-390c-4ea3-acd8-b25779d191b9,Commercial,0.8312495147567447,39,43,162,1374,1212,98.79481826256064,8654
7c334596-346b-4b0c-93a4-b2ed016fec11,Residental,0.9187846471619837,12,30,229,764,535,36.66696248087135,7008
dd55c188-8a43-48c5-a56c-10fb7e855819,Educational,0.06248544403337375,6,27,684,1003,319,12.486771125181537,4097
6eb393ae-f608-4b5a-bc97-21e613d2bdb6,Commercial,0.1477855086285198,22,48,65,247,182,13.118959968533728,1794
dae397c3-9c7f-489a-8942-d22725f5c27d,Residental,0.006977383134827209,2,29,704,963,259,31.930471256172368,7201
2b24afbb-dc40-45cf-9d13-fd629c633684,Educational,0.6732723427884522,38,37,653,1372,719,22.891157016798342,9039
7cb6e892-54a2-40f4-afea-97fb5c617047,Commercial,0.7218966605943723,13,46,67,105,38,56.98521976642964,3595
9f4be6ee-0953-4bc3-a27a-ef8e5bd180ab,Commercial,0.9021024718378534,25,36,459,1334,875,41.761692759634556,5681
ed878822-0e63-4b6f-ab39-39e7d57377f6,Residental,0.42916764542250085,20,50,491,970,479,79.01705029860142,6517
2e66e90a-fc99-42c2-8237-b854c3e99050,Healthcare,0.019047104906175116,31,42,462,1422,960,17.97993885635871,2407
5157ae4b-648a-4d44-a770-eb3e84acaba7,Residental,0.8905054112658859,47,43,550,1094,544,21.08168547335437,6344
22f284eb-7f51-459a-9017-ce86d2f82726,Commercial,0.8547477649545591,14,23,615,830,215,66.80233797219537,6873
03620516-476b-44ea-9315-3e777ce1fb53,Residental,0.09352765453603751,37,23,319,958,639,53.916371328109825,5103
15f62e0c-1244-4e8f-8d1e-421453ba4f5e,Educational,0.5098515104657784,49,47,547,1367,820,77.32497113169838,1109
8d2a5c0e-a0ab-4f8f-8377-93c2788b3e44,Healthcare,0.09052655799292508,4,24,262,409,147,64.95684707080045,5953
921cc52f-8f1d-4f48-9467-3acae841c485,Residental,0.9405999287323348,24,9,702,1396,694,87.57162448509288,7245
f9d2208b-1f08-4989-861c-c0168b0382ad,Residental,0.30254401802824504,49,39,60,1320,1260,47.05613074440381,2763
8fcbeaec-175e-4368-a0b7-3d50c084724f,Commercial,0.863389866265483,10,41,568,883,315,50.38402520937493,1745
1eb0ca5c-0753-4f59-8713-baa2d620596b,Educational,0.19225247483933272,11,9,422,578,156,16.00314758381379,7521
7ba37cd4-edbb-461c-9eff-dbc9025a20b4,Educational,0.9824855160724472,5,47,679,879,200,23.20764800822672,5790
ba24c56a-41bb-4d71-ba64-73e78f0c5dcd,Educational,0.5641459295463584,34,6,338,857,519,83.31236925756255,6982
18ce13bc-8964-410b-893d-ceb02bcbaff1,Residental,0.0340608242584719,10,27,517,725,208,77.41226802710096,5876
226d6ce1-3889-4d3a-acc9-ff6c3c48a7d1,Commercial,0.7631304119410626,49,46,359,455,96,94.8685555119257,4796
c6bcf012-ec6f-4c2e-8929-2ccdd653a372,Educational,0.64741232075694,29,3,515,1245,730,35.13705849419895,8477
c76f094e-3fbb-47f9-997b-5fef234cfb35,Educational,0.8384833233922808,35,49,42,693,651,27.92923913063135,7344
01ff6977-d171-46c6-a9cb-173a54a19732,Educational,0.5179235965505182,8,50,185,878,693,38.39142072415757,6672
97751985-6604-4aa2-9e48-50d3e8052554,Healthcare,0.3150283161726539,2,37,577,1429,852,75.97343454841563,7542
0d393898-4897-4cbb-a32e-665ed01fdc98,Commercial,0.8942021070464736,34,38,559,1075,516,15.756506130353277,6328
986d5d00-48c3-4da5-ac0c-5585266b3799,Educational,0.15217028651762388,28,10,490,1172,682,28.074340844221897,5071
b6838e9d-f56a-4482-b296-b919b0562cd5,Healthcare,0.43150599158367176,21,37,32,594,562,95.15412503577389,9957
1c136281-9103-48ee-9229-1f921ae8b669,Healthcare,0.35175926734740115,42,14,614,952,338,15.47128192541901,2634
aa828154-5a65-4435-bfbd-44169421bf89,Educational,0.3721804726803375,49,4,374,959,585,56.41824057723234,4778
c485a469-9b85-45ca-b3db-5490f3a2a762,Educational,0.17889273469377842,31,29,203,652,449,44.80286171479649,8082
b7a2e4a9-3b73-4a40-9462-f9f9947f2bb8,Commercial,0.9128850683961632,4,22,492,828,336,68.40155004849623,2504
53b91c1a-27f0-434b-9774-c35a04957d3a,Commercial,0.8541156682405165,31,10,619,1173,554,54.006823422193705,2369
63d17055-894e-4d81-b57f-ecc4c2fc3448,Commercial,0.7576263506149754,30,41,118,1121,1003,97.64563173029353,6653
ae37ca72-cfe6-49fe-abc3-16a1b139f10f,Educational,0.0178731597271351,26,40,652,1155,503,28.641767256573115,8338
24e95f5f-fe99-412f-8b80-bdb1aef53d32,Healthcare,0.5798447441738537,47,13,539,847,308,68.58719579474042,6212
cbedacfe-b7a3-4851-99b7-45dc04605c4b,Commercial,0.7355018931184945,48,25,579,712,133,15.157900473937506,7899
7f711aed-9b47-46bc-880a-460cf7fff246,Commercial,0.7238484435367731,11,6,234,793,559,54.05893115720136,9962
d72eae22-cbf0-42eb-9e73-047a163aed1d,Commercial,0.7963924592253343,49,46,126,254,128,13.882661509394364,5968
0e2520ea-caee-4ec0-b0b8-13f8a97b173f,Residental,0.3234246827944416,12,35,716,1329,613,75.71030217367449,4532
a6bf9f82-76e5-4341-b760-8561223110dc,Residental,0.6936590534784817,13,24,387,1217,830,41.66672464639245,4777
c6ebc72c-2cbb-4917-81ac-308052a45ceb,Healthcare,0.2276500112100951,20,15,599,844,245,42.50256289972197,2133
2e6d559e-a939-4b13-a901-6f5788312c8b,Residental,0.9784299856449025,15,25,67,739,672,20.05433209823218,8955
6d82f693-698c-4458-bb1d-7cc12eb771f3,Educational,0.5710282210192025,42,13,506,1200,694,46.63400465296907,2467
a341816b-8d78-460d-a7da-9c04eed65dd3,Healthcare,0.06935938630967187,50,10,440,1110,670,43.86790201167933,6065
67c4f20b-7cc3-4585-b1f4-304a70507783,Educational,0.12827788832509934,11,33,710,920,210,72.2247373449755,3109
2cf4bc2d-d587-4368-a3f5-9ccb4666a354,Educational,0.674530169526383,50,15,443,1263,820,12.478437279298278,3245
fdc97043-ad92-4543-81f9-e7c69e80bed8,Commercial,0.551535834098256,9,26,647,1379,732,93.39595290631559,1769
da762b13-6364-4be5-890e-a7e6a33bd816,Residental,0.269489898109595,13,34,438,1233,795,53.09253671134229,6207
df5ab5f3-393f-4c34-b823-29ff7bd81043,Residental,0.5043206018551181,11,6,290,1092,802,48.73803313418473,4189
29c3439a-6a52-4fb4-bae9-a132a5862540,Healthcare,0.5674623515523812,48,45,446,900,454,58.35970235941226,9279
154915b3-0243-4784-9ebc-27e5effce2b8,Healthcare,0.8132803850107886,11,45,129,381,252,16.704598754299056,1953
eff87d3c-cbe8-402c-8d52-dfe7985c719b,Commercial,0.034994693888966366,3,29,538,776,238,11.907419968727108,5738
dd4bb4ab-3ad3-426d-8308-508c05f49181,Commercial,0.03490424090126987,23,10,41,349,308,73.97351102144029,2090
8f6c02e8-5d38-40d4-9367-39810e174416,Educational,0.22201755406645818,10,41,635,696,61,65.20432520321643,6904
21702304-0f4d-4fc5-80af-05024c205dba,Commercial,0.09840552885199172,30,47,615,959,344,45.72516685211347,7940
20189380-339f-40bc-9e44-7a7a34d9e8fa,Healthcare,0.5027625410123512,50,15,246,302,56,66.85320630098627,1473
57f1c735-e12b-4199-9473-bd7df06cabac,Educational,0.1458539764210044,32,8,185,1296,1111,73.86717991572837,3657
f519cafb-6bb6-4f32-8b3e-cebceae77f6b,Residental,0.2576973332661102,36,8,305,1421,1116,86.89735033283438,7735
244820fc-fab1-4a97-b29d-ecaecebf7523,Healthcare,0.7750753073118715,35,6,524,1280,756,68.09959683594694,1550
32f2e169-d494-4677-8a34-c1d9ba7838e2,Residental,0.6459028193513753,30,34,695,1289,594,23.81989795872376,8421
d3a7bd8a-a830-4938-b543-cd8022646e58,Educational,0.3161093147134626,24,39,92,351,259,18.24350513733198,1926
065186b9-87bd-4bd7-9fdc-2a9f7c39628b,Educational,0.16607826839632545,23,46,116,427,311,48.8894715442388,1083
e1ae7d54-4cf5-4a1e-b040-79dccc35209b,Educational,0.587440028443725,12,1,509,1268,759,49.713734666272686,9381
941af806-2521-4b99-bec6-2fbc695091d7,Residental,0.44216120617034516,9,21,339,1292,953,57.52128840737184,8929
ac99a669-bc02-436b-a2f4-4c2a763c1484,Residental,0.15036533175037514,5,13,8,149,141,65.36764981831331,9667
71f7790b-2ae3-4639-9f98-8f92882078f6,Commercial,0.6482005324938361,3,6,359,552,193,45.601083626969576,5280
b38d870e-8ec9-4f6b-8e88-c1b9567e348d,Commercial,0.03634339529000641,20,36,696,791,95,80.96843114208704,9933
5be61c6c-f06a-4c17-8659-dbd54d62c1ab,Commercial,0.84009202237552,25,49,100,220,120,77.42531283964942,7884
746b90b7-981d-4e72-b57a-55ffb911bd10,Educational,0.939744426071247,11,30,224,816,592,96.1888914130053,6037
1734d16e-9f26-4e82-aa1a-11d534c1dab3,Educational,0.09551323399668465,41,49,527,1313,786,36.44281800434487,6001
b945603a-6139-4e8a-b8de-620c9b872de6,Educational,0.8786877499364902,28,3,701,804,103,65.79873238548298,2608
fde6be24-59aa-4399-ae5d-9e8d72a9068e,Healthcare,0.6802126299590188,44,36,315,821,506,33.61909245301629,8159
1c57350b-d4fe-408d-8abc-ec1fa9d0a8b8,Educational,0.9107201440787064,8,40,321,1282,961,34.85498874824762,5537
2a51d408-e116-4220-8fba-0b920dff2ccd,Commercial,0.32337719593634173,16,29,528,786,258,95.2818996951631,4037
ecd33cb2-668f-4896-9717-bac2a9ce7ede,Healthcare,0.7564429763013903,9,38,285,1018,733,14.307924140474194,1419
ff8f3a90-1ff8-43fd-99e9-91567facfea2,Educational,0.5040746405153683,16,42,669,875,206,87.33920453572678,3823
b25ef2f5-9973-4a0b-a064-0edbed1b9a7d,Residental,0.36485151229452495,44,16,75,762,687,44.90065386832266,9765
393081c2-6b56-4f46-930f-e07e1ff05faa,Educational,0.929141450464988,4,48,189,1009,820,59.5804191256638,1451
a662c33c-c7f8-4df0-966e-80ca5a764a74,Educational,0.39529080995332233,4,17,540,1205,665,64.42903175102636,3487
ef99494f-356c-4058-ae9f-83a80223870d,Residental,0.05225846353627428,5,43,166,1211,1045,69.4523560480927,6208
9d9b5061-bfd1-4e53-bdd7-e2e9d5362963,Healthcare,0.955359278118548,35,36,475,567,92,28.83762196498288,6412
1171f9ae-3523-4e54-9f8b-1068a6b2d3de,Commercial,0.44037559877668575,19,13,408,838,430,73.28246095525415,7809
68a574a9-d6b2-495c-8bd6-9957955c63d6,Healthcare,0.38942351795646524,26,15,536,983,447,11.234464487908626,4046
7e1faf9b-d62d-4b32-bfce-e3804aa4adde,Residental,0.8965957440392225,9,9,54,1111,1057,37.49767963871935,1835
462b6636-3c2f-47eb-9ecd-f3f8d656c92e,Educational,0.3257609276767741,44,32,599,1116,517,74.00658834367292,4195
f3ec3646-7225-4e67-bda0-092012930d59,Educational,0.32319198141863414,24,44,656,1055,399,38.592963169532155,5093
774d376d-734c-467a-9331-ba84b9a071c8,Educational,0.9282818204604182,29,10,1,604,603,46.14137241224288,7747
75eb19da-3bcd-4c73-9b05-78effe0228c5,Commercial,0.0594010388174776,22,26,527,623,96,20.93437244904707,3918
0c8d1031-55cb-42dd-a364-6ce68f6104c2,Residental,0.8051883976704048,30,45,714,1207,493,91.61880920081741,8463
051fbc8e-2e82-4139-bca1-f47238c5bb03,Residental,0.7444820990439488,3,27,451,1355,904,27.835240718539357,2853
4a5e311e-2f5e-4dfa-850d-64d451ee8269,Educational,0.5912100363869441,42,5,226,236,10,10.39947227006625,5379
f316b862-d1ad-4830-9afa-933afbbb0f4c,Residental,0.7357060943781804,21,15,558,1368,810,76.78211556533313,7335
9ffdf824-8666-41ba-a90f-fc01052abbeb,Commercial,0.8497465427766029,46,14,289,1103,814,94.40646418254029,6478
d34481cc-0c5c-41bd-b2ca-c968fc409104,Commercial,0.3576133908234663,17,10,517,517,0,47.742438831920474,6838
030e21c5-aa49-4f41-b132-04a39a3e52a0,Healthcare,0.05675616272285,26,2,196,1381,1185,79.36536410109731,7763
146f8e62-5204-4e84-a5e5-1a623dd71d7a,Commercial,0.662169778009094,7,12,319,403,84,26.5418029964292,4871
28389837-4d91-4734-8692-08e56f886ed4,Healthcare,0.18781414262775276,9,41,580,629,49,24.01079256428307,8715
0de54a52-5ed0-49bf-9073-86fdf5387f52,Commercial,0.4237164974789903,47,28,556,1062,506,14.42571967491915,1173
9364d09d-a161-445f-b400-e00bc8e9d217,Healthcare,0.3313253476222521,27,1,140,1081,941,11.794091767481646,5355
5db8f487-4feb-4af1-b2c2-a2945a53b9ce,Commercial,0.8845411029016422,44,18,144,982,838,10.83827047245165,2992
1caeabac-7760-4e35-b4a3-7a25f59ccd48,Educational,0.965622736342884,43,42,639,1431,792,32.78287024704127,4311
03e1ddb6-e864-4ddf-97b9-61c849237472,Residental,0.705112880832693,36,49,180,1233,1053,45.9607846798718,8307
3090089b-e7c3-4bc6-824c-4f50ed6c6e77,Commercial,0.8773277015558895,21,45,566,912,346,37.22884215854224,5466
61b250cd-f173-40b2-a3a0-2ba18d9cd1bd,Healthcare,0.8196161125868426,23,44,446,1319,873,15.497335857303728,1395
48a52a0b-046f-4fdd-8964-32f323dbef79,Residental,0.13704009649598303,15,37,529,1318,789,39.94348302202576,8611
abc66fac-fb84-4a3f-873f-42393a4a0d03,Residental,0.915312705236723,28,34,131,489,358,44.85690214571511,8228
1f88035b-fe7d-4d92-a99a-8c1eb89c36b7,Residental,0.16368487697291523,42,36,277,1073,796,85.16241580055804,5938
4b785c36-82fa-4758-a964-7dd4fa6063c0,Residental,0.8250978653597804,40,28,89,515,426,24.99808904034496,7412
de1fdcd7-f488-4720-9b56-bab3754a2f14,Residental,0.2059008323674829,47,25,669,790,121,11.652238975170773,7269
795f0086-8aa9-4b14-a78a-1b45fc84f521,Educational,0.604520309287408,28,37,122,1187,1065,16.846207140640047,7236
98bc69b4-75c4-4783-9ada-240348361ed4,Commercial,0.057871498588857206,10,29,147,585,438,71.25604830099486,7359
51b0791a-28e3-41ee-acdc-18feb0bc62d7,Residental,0.9030995669638905,19,26,377,919,542,14.275935584693567,8955
2d0a0494-7af3-46f5-bfaf-ee9666a5ff18,Residental,0.7823744784296444,43,28,275,464,189,97.56636048376514,3383
3e3e2b83-b169-4a65-8e5f-75fa87531077,Commercial,0.6589391540254358,27,39,485,1051,566,80.67304478388074,3257
d2a60c33-788d-470b-b1c1-b4018f7e91a4,Residental,0.46171637474524396,27,27,311,346,35,98.15724643658248,4329
88eed6c3-8f9d-453b-9b88-c063fcbecc31,Commercial,0.928972534213513,22,26,344,517,173,58.865276205712,2459
a7ee5dd1-f135-4f95-a7a7-23c27df4b22f,Educational,0.4870307423479855,25,19,247,1124,877,51.964852719411525,7119
7571e608-0d1e-4abd-b47b-ebb7ea361ab2,Healthcare,0.8597870578720646,43,41,444,841,397,21.022459603484396,7235
b9d97fcf-46a5-4b5b-b3bc-cd1b96951076,Commercial,0.8531355476045461,21,23,203,1254,1051,85.95340273139678,6493
a5504817-18e3-4c50-8e9a-0971dfae8779,Residental,0.4572503161152699,33,42,431,1269,838,21.346689046940902,7557
13257046-30a8-4ca0-a13a-d5a225414083,Commercial,0.4559856906146442,4,8,632,737,105,93.93662523003323,8723
1d3911d0-91de-42f6-9483-442c64c409cb,Residental,0.476903309196234,31,13,491,713,222,28.064822401201745,3089
6f203175-2644-4f61-9ccf-1a1200b7b85e,Commercial,0.3379615461680783,40,39,232,701,469,30.62311888678707,9995
98e483e7-7c05-474f-8dd0-eec9baefbb42,Commercial,0.22334205968449405,27,46,177,908,731,96.79882079516155,7257
40bc872f-97b3-412e-9a6a-730a668c3e15,Healthcare,0.6329434076386856,44,35,412,824,412,55.1047944295562,5596
35c870dc-bb0a-4544-8ded-fd17298502d8,Healthcare,0.38634023554069075,5,16,26,1313,1287,42.104761996840246,1706
8db6925d-b246-4081-b5fd-57c020fb90d2,Healthcare,0.9073804247820378,10,39,664,1378,714,22.777582866949366,9010
4dc64139-aa89-47df-840e-27bbb9e11cf4,Educational,0.09794564630055003,2,14,354,1272,918,23.83911046789362,2915
e3883e3c-c429-4b6f-aab3-a9a518f3837c,Educational,0.7530420661311682,7,26,13,210,197,47.05259809289321,8673
e15b1561-b428-4b1c-b359-b6166c5bf8f3,Healthcare,0.7484525268237949,29,16,410,464,54,54.676080521377145,6538
dd0e4359-2727-4fbe-9487-b89f49917894,Educational,0.31468540742132,20,34,332,486,154,54.10438062441999,3016
4e23e2a9-3826-47bb-96c5-a351a471f803,Commercial,0.15561168077838694,45,13,352,966,614,78.19142476233097,6696
655997a6-ff3d-47d4-b1a6-27e06af14aca,Educational,0.26387072318863425,10,50,365,1133,768,24.41776994057368,4183
b2c5cda1-4681-491b-8b59-206eedf02f6f,Healthcare,0.5744899742563749,42,3,541,1397,856,14.010196711397812,5603
b43b2a4b-a1bf-4b92-9b77-e91bd06e5259,Residental,0.8263186419796443,41,43,661,1154,493,39.00533290676941,1284
c63b5b73-26a2-4ba0-8f20-149b3acd37fb,Commercial,0.416442966131767,31,22,589,1396,807,30.999147712922223,6513
37e1be2b-31ac-48af-9e6c-9a01eaca5299,Commercial,0.12219023040262667,1,33,670,1281,611,78.33429333261472,7302
d83081e8-6277-4bb1-abd4-401ce8200353,Educational,0.8437945635879052,37,41,608,1204,596,73.9586333973497,4739
b5436b8a-674e-408a-a997-9841eac78134,Residental,0.8653703451531745,4,7,610,1025,415,82.70077323307731,4608
30f93ba4-8837-4ba5-996c-26724e234e9e,Commercial,0.01895292252342129,25,31,551,814,263,56.628283973256195,9192
60e9256d-dc9c-40df-97d9-391532408c15,Residental,0.3506334618065561,1,50,524,607,83,10.341011747857992,5181
d7616d55-a71f-4dc3-a373-ddd01828dbb5,Commercial,0.6466725457927051,24,30,216,1267,1051,99.13535067704018,5493
9dee6030-509b-4519-8a6f-b5e1e2f36f8d,Healthcare,0.00022857639652873463,41,44,230,1276,1046,82.56653512921176,2469
a3162e15-bd68-4ba9-bff9-cc6e765302de,Healthcare,0.9910936675178357,12,34,482,783,301,69.72290270387472,1898
205be807-6eac-4d54-8115-855de05a4b1a,Educational,0.8613589857976018,23,5,402,759,357,25.065856562876263,3728
bf691337-8027-4374-ac26-8f9ac522ca00,Commercial,0.29796542337626986,15,11,384,1015,631,55.78470051396419,8447
5ae27cbb-1cb3-4ccd-bbf8-c241631deaad,Healthcare,0.044138659387517376,40,37,90,119,29,23.68711844024467,2073
ac8e0137-3dea-43ef-ae47-e294813689a5,Educational,0.6643335993914152,11,49,564,1121,557,77.8431113146157,4770
e820d088-cd8a-435d-96ad-964866817f84,Commercial,0.563711640058859,48,8,370,687,317,19.345324851244865,4973
3846e3e1-8368-4b13-a4ee-79171b9b069f,Commercial,0.06738987281120523,35,42,44,135,91,46.81856280860979,5211
ec7dc575-420b-4811-afbc-455ca0d6790f,Healthcare,0.6090968489365639,21,27,106,773,667,48.377763092896,2372
adbc8afe-5855-4e26-ac91-6c9eae8782dc,Educational,0.16866953839421017,29,44,104,1401,1297,30.995349023359267,3073
66a80487-7b58-4db9-83c2-8b17192e8a6a,Educational,0.37322433552031964,46,4,716,1244,528,35.627557982351874,6242
17605678-e2bd-4462-ac0b-2efa1c92eca7,Educational,0.703408411958542,34,39,347,766,419,62.527329198828966,3013
d804e863-b528-479a-8ac9-4f8d582d3f45,Educational,0.13071655333056198,10,37,55,1176,1121,10.67261327603765,2011
f035a91d-b818-4e45-992d-c49b89566e22,Educational,0.48984264054695326,40,23,523,877,354,56.956605417704694,7328
8c3458f7-422c-42ae-8eec-31bdb18cb911,Residental,0.4344930237919813,6,34,426,1319,893,28.723582525006837,3660
d972f5d1-2e16-4571-922a-7fcea477996f,Commercial,0.263860072872935,19,14,31,736,705,46.86114408132841,9467
c4248d49-f8a4-41bd-963e-506fc6492e68,Residental,0.24696563877331512,31,34,164,795,631,38.097148724089706,6576
c66ca9da-e40a-4f03-8c20-ec640e6b118a,Educational,0.11304782994105056,8,43,680,945,265,71.23764829375438,7869
b93e5823-f40d-44aa-8c29-5e024cb4965b,Healthcare,0.3160706054977406,42,31,296,1097,801,17.414879519705455,7181
0ac2b5a4-5259-419f-9fa5-232c5be403d9,Residental,0.05568635651733411,24,47,614,640,26,95.99243210791558,4971
e512483e-ae4b-4555-8cc0-3923002d4876,Educational,0.5886391772159439,14,45,716,1414,698,16.643548701480356,9359
8bcb875f-1f2f-49e2-bade-e40995ce568f,Healthcare,0.7921275908893538,11,1,373,467,94,67.35578246890424,3581
3b0dc748-c965-4177-829d-a5c75b5969d7,Commercial,0.6170996558492211,17,23,210,773,563,86.52945887938841,5132
0fe2316c-0e9a-4629-9592-454f9c6a7019,Residental,0.8585098047429915,47,6,536,890,354,48.732840917816596,1559
f858d2a2-ad98-4942-a807-9aed6dc5a93e,Residental,0.08476710925105191,33,31,543,1370,827,54.55603158780469,9844
f2a0147a-c3ca-42d5-a581-1bcd809a1d85,Educational,0.18998767449917886,4,11,301,863,562,95.35539425641724,7778
193ce074-d02a-4b93-ad33-91e319ebe17c,Commercial,0.38099335548812796,26,6,445,1202,757,61.58756672394602,1178
bff6c751-a13a-41ab-be09-6027f9d01939,Educational,0.5264035756708872,20,48,187,250,63,42.74834700206886,1743
bf893d5e-7dca-4b53-9fbe-f617b5a4a441,Commercial,0.07334635146988755,7,39,439,1187,748,55.38069224370126,1007
8d2c4a56-f7f5-4c5d-8ab2-3b98519500b0,Healthcare,0.3508949548377067,27,49,409,648,239,34.23952120857078,3413
fd388d7a-7183-4ec1-8c5c-f98c66847200,Educational,0.4008510202096587,37,35,401,1309,908,30.679824636752283,3376
7dd3ac5c-9cb0-47db-92b2-0e6f11af00b9,Healthcare,0.08175842723758975,10,25,600,1125,525,68.42734316124107,6260
3a3ff845-a976-4419-885a-77a522af3860,Residental,0.9889479623713208,32,9,598,666,68,40.52399286724591,3822
55a049b1-3aef-44a5-825d-1ed5ba806dd5,Healthcare,0.34290821823047624,39,40,293,450,157,52.1288022167101,9650
40d0dfb5-69b3-4496-a815-818f7cfcdded,Residental,0.9151799692406055,22,1,533,553,20,76.6736390645334,5605
026d7f2e-616f-43a6-8601-082db3b0d42a,Residental,0.3806623749768556,18,5,272,373,101,93.40973313513578,8393
ce4a1bbf-cec5-4c03-958e-86b4eef234df,Commercial,0.7603364802586507,37,27,176,352,176,48.37927469199437,2026
a467e0fa-5d25-45bc-bdab-34d9e514d764,Commercial,0.7713102528103474,9,10,298,516,218,31.46750209611932,3404
9d6a218c-dab2-41b8-88fc-0aea9c09fe21,Residental,0.13682697872403404,49,36,668,974,306,76.63671803110614,4191
7b6fd72e-9aa5-4f95-8921-a8d1c0970453,Healthcare,0.4978551203213911,26,20,354,608,254,63.69373971644367,3098
eb4d9fdc-3226-40d2-92d8-f239a8020379,Commercial,0.3109420810138507,28,16,358,790,432,28.08597598172422,9098
1e9b1755-6c01-4002-9c89-41d9952daff3,Educational,0.44741517616772886,36,6,263,474,211,69.76330373321122,9163
9427cd58-7fd4-4d86-9459-8b261bbe04f3,Healthcare,0.26070508024580186,15,44,638,1368,730,76.88824311273908,7969
97e14b60-57b0-4976-9d17-040f5f4b3cd2,Educational,0.02142984127346903,6,44,95,305,210,34.59500154614288,2469
d7fbd917-2e32-4013-8084-f4509c94b4b1,Educational,0.33988994093581204,50,46,249,670,421,59.55863868204085,4901
78adc156-8e11-41eb-88cf-c57ba3c6de27,Educational,0.32466413903141766,24,44,375,786,411,31.949230048014584,9833
a9f1c480-8886-489f-8abb-2077865665f4,Healthcare,0.7342093564069013,15,46,525,627,102,14.501761162876228,3090
1d4b0e5b-e47e-44bb-b0da-bf30fe878ae1,Healthcare,0.6613778874422325,27,13,234,716,482,63.22796353688495,5556
689efc1d-65e2-437d-a043-f4aa5057d5af,Commercial,0.33906548768512024,28,1,492,599,107,65.74329281595142,3862
978d0ba6-deb6-4128-972a-1a73b687ec70,Healthcare,0.43227854805694377,31,26,679,1360,681,76.60839722814357,8038
94bbac8e-7e4a-440d-9057-8877e67853b2,Commercial,0.21231033334927052,1,30,100,1120,1020,73.5885473952631,5967
54ec4491-7e38-446c-aaa8-e746d8d8d44b,Commercial,0.4579071408389811,25,2,613,1316,703,52.79793498141334,6937
c8f80566-2a1c-4c98-9e86-670d9974dae3,Educational,0.7025244642377084,11,47,36,53,17,90.75379108192999,9859
951e8e97-fe70-421f-8d2c-e50ab0964302,Commercial,0.8780253725304707,49,48,339,797,458,36.50879594324538,6732
191c9020-817f-4be8-b982-313e7b974ba0,Healthcare,0.9486467480948478,12,8,307,426,119,53.02068347509403,2628
fdbb3416-aa72-4a4b-8bb1-7ef1013155e4,Commercial,0.4728465371259346,12,10,310,499,189,18.355273223185705,4608
565c3e05-add7-4318-b91c-7d5b23a17170,Healthcare,0.2911032212644369,1,42,321,507,186,87.36052015186195,5730
cf22b7d2-5c0c-4ce4-81d1-dcde0cf2afb7,Commercial,0.3242797413789045,32,4,688,765,77,20.685389674990553,9586
bde9e125-9e9a-4e4d-b7a9-58a8f7d9da43,Residental,0.6662397391739008,24,10,122,1055,933,27.200788121743088,8359
7ce0f9cd-1d06-4ecf-ad85-34c8c0568fff,Educational,0.05388781483153138,36,39,592,661,69,35.70447090203763,5370
c614eac6-240d-4625-b606-9a434383a3ca,Residental,0.6610651741700903,50,21,272,425,153,96.04788700205964,2173
a8c44feb-4e4f-491d-97c3-3be72d89dca6,Educational,0.43713004139966216,32,17,335,1113,778,40.66172012234989,6907
4e86833c-a759-4743-b205-b28dbb8f2092,Healthcare,0.09255127761168724,38,5,274,479,205,64.14080303072141,6716
d1ff8bb1-237a-4d71-9cb3-b5dd0ee6c26d,Commercial,0.31656070833950634,49,32,349,976,627,62.77096836413642,5029
d5a03901-ddef-48bc-9b0e-a8a3cf8df30e,Healthcare,0.9939064746906112,12,2,86,584,498,61.705060115945194,3519
2fe55157-2aaa-450c-b5f5-09664f9bf2b0,Healthcare,0.543825324604636,19,25,633,1409,776,15.897606245907399,2219
1b2aaf4d-0e76-4f50-9b10-0b5c5b6ae9b6,Residental,0.06053330281302671,2,30,335,572,237,80.16703336944926,9828
3bd53ed2-997f-43c1-bb61-b2db315763a4,Healthcare,0.31951260687115024,21,24,8,390,382,67.83539421587602,6901
1cfc8bbc-a8b5-4d5d-87aa-f91df2f2e861,Healthcare,0.5698504468509518,20,5,274,1223,949,34.747337293414446,2663
9842173b-043c-4ee4-8ce3-7879bdd0587b,Commercial,0.2618292391857979,39,20,42,870,828,12.11225661701987,3374
c6940044-d388-41e8-bcdc-80d3c5646495,Educational,0.3595883126158843,28,41,479,512,33,89.1639374565812,2674
fbc8f8c1-a8c4-471b-95bd-799b824802b4,Educational,0.6264715323918264,1,15,207,338,131,37.695140896811594,8672
fe30957e-8733-4284-a7d4-ea68d5bce085,Commercial,0.49859438591733274,16,17,420,697,277,16.38571662848493,4773
5549a04e-a56b-4c5c-85d5-373c768c033f,Commercial,0.00788068324697766,17,50,110,689,579,29.901025577264058,9428
b8daf010-ec18-4229-ba02-a399fae395b5,Commercial,0.8816333353068495,32,2,565,581,16,70.41915250968731,5313
84305c8a-618a-4374-bac2-206afc23d7f0,Healthcare,0.4295369829150617,8,15,278,928,650,87.43802539904925,6800
ea2ba3d5-a90b-4a56-a7c5-961c27438bbe,Educational,0.6941153502426212,50,49,690,1080,390,63.079789962649635,4013
5f5f7e56-e6de-4dcb-bb83-afd176dddeea,Healthcare,0.9707706133005111,24,19,482,910,428,50.61457316716024,5230
28c26fc2-ee3e-4a00-b33b-d639354547d1,Educational,0.028319544829479515,39,47,218,991,773,46.606530687493155,9047
23d796cd-0e7d-4b16-ab41-141addb9ff95,Residental,0.005278825899822315,33,50,632,1099,467,18.406202799101536,9781
dc5d8b03-2128-463e-bce5-7fdf7c381243,Healthcare,0.6699459789661403,3,47,358,1057,699,72.66320671375959,7984
d102f288-4a3e-4161-bc6f-d7a990bc0a18,Residental,0.1516431654675795,16,7,181,673,492,83.80070201262038,3375
056cf5f7-4d05-4934-a041-dc58f12ab698,Healthcare,0.23148953280228945,23,23,173,1088,915,97.09763609896011,9614
80a28e4a-af0f-4f2d-9866-18ec2804c988,Residental,0.7468597701173203,18,11,243,614,371,57.77025946942677,1697
589239d5-df65-457e-8032-658bde5a0251,Educational,0.17161987053869565,41,6,683,954,271,12.619732821244108,9054
1116fa50-f597-4610-ad66-c1accd1275d4,Healthcare,0.05458116927327605,10,36,8,507,499,88.16503793308584,7773
94783e7c-9cb2-4b9d-8063-13a2cb0653e3,Healthcare,0.25193341026629923,37,7,288,347,59,28.76605911423892,3647
fbb16aa0-6fdc-4384-bbb4-611791eeb8bc,Commercial,0.2878065543360203,17,1,127,871,744,81.56890446408273,2878
e885fb75-0a70-40d9-b14d-4293fe07890e,Healthcare,0.5648032147989067,34,16,338,361,23,32.52546900675526,7729
864bd4a5-8c96-40e5-8772-cc9a4f514050,Commercial,0.5430874889272532,8,29,665,770,105,87.48300556039817,8176
7244098d-bc73-49d2-b360-896f8cbdd9c8,Healthcare,0.17230380295976522,5,40,458,886,428,60.95892858039644,9317
77f011ba-ed5d-49a9-94e8-4dd54e2aa278,Educational,0.24605196485342018,43,44,279,1110,831,37.87565820288968,2583
4a4a4c6b-36b2-4921-9c7b-30c127f4f48c,Commercial,0.8687909420303019,13,25,612,936,324,41.08761305147156,5408
05e90e71-31fc-4d7c-acee-a756a119e5ca,Residental,0.6356419078577306,19,4,327,407,80,83.56531765127407,2486
7e437612-7fc5-4889-9098-a894b3caafcf,Healthcare,0.8215926637251326,3,19,719,990,271,34.04486781266614,3827
5dbee29d-71ed-4e30-b604-b7a7598db418,Commercial,0.2373767206700258,1,14,507,596,89,72.98018517623403,9109
7453d70d-c83d-4d48-b811-4cd95c914cb5,Healthcare,0.7224745203950648,32,9,428,1411,983,60.4143189849422,4633
824290db-f779-4b1e-a21a-60d7c7b04df7,Healthcare,0.6628106355747799,8,38,234,582,348,82.81424744644721,8433
a9c54ae1-5697-4c61-828e-77e901fb27c8,Educational,0.5832492403692667,17,47,309,1252,943,34.291449389576414,1154
f29e6c49-d92a-472d-96c6-d52c7197ecfe,Educational,0.31561471584031253,26,23,60,1108,1048,90.3365342133549,1343
5f522fb5-6e06-4df7-9f71-0fb1ff4bd846,Healthcare,0.28024678804470304,31,49,73,514,441,50.231034284148855,7154
75d83ddd-75e0-47d6-804f-363428a69783,Residental,0.11027931221869902,7,28,216,539,323,11.181361170684193,9758
2e82a491-34f9-456f-a2fe-f8b9c061c50b,Healthcare,0.18349641330371824,49,49,524,1042,518,30.870992788378977,9220
5ad834bb-6b8d-45b2-ae62-2211df2b912e,Residental,0.45320502651093497,27,48,160,254,94,98.67304454467559,2822
0d929a82-e865-4d9d-a174-bbfa948306bb,Residental,0.41466315335184467,12,7,232,959,727,64.97064505121932,5016
0559ebdb-2257-4971-bc35-05901e0479b2,Residental,0.5600618766000522,3,8,153,573,420,61.26466588165331,7057
4619b895-8619-482b-b73b-1b499849df47,Commercial,0.7546770171748816,39,1,441,636,195,81.1997225933415,3630
0b9a7941-86e4-4297-8ade-63aeafe17fcb,Educational,0.7753019085433124,28,14,691,1280,589,20.047030393796433,6057
bae68e36-1330-4692-87d1-25a747a827a4,Residental,0.6171321111886734,41,19,22,1187,1165,17.742412902574443,9995
f16be75c-f738-4eb9-9eab-ea7cacd72fc0,Commercial,0.8425869845326628,40,22,324,903,579,62.378134426805524,4929
16c5c685-326d-4784-8d13-85b28b405d06,Residental,0.8391792317054709,49,10,338,1313,975,94.40330029538929,9717
6cee0a15-bad1-4818-861a-1e35c2349d67,Educational,0.4383522534021994,17,36,322,1217,895,44.82997297598814,9741
d7669219-f503-4398-ac93-a903a7f96de7,Educational,0.7293371194468604,26,11,9,1044,1035,93.60124670700283,1989
8cc0c0fa-a7d9-4ede-9e98-4655b335e0ca,Healthcare,0.5784551731531583,3,39,573,615,42,35.30837311363564,8717
cc5897a9-3b03-49cc-aeda-090ddccd723d,Residental,0.027648997085853222,8,18,321,1377,1056,68.32778382972319,1293
7bc643bd-02fd-4cfb-81a2-20cf27ead84e,Residental,0.8564209892920023,32,3,345,1093,748,54.23050786846261,6615
605fdefe-9521-4364-a1a3-1fb37a2f6555,Educational,0.06405091635752647,5,3,564,740,176,66.61013788499666,4522
cf6dad6e-08f5-4a3e-b3e6-7c11b17a1c7d,Residental,0.1113939337542047,21,21,581,931,350,85.38452843333779,2371
fc2d9fab-6d9c-4400-bef1-07727bac008b,Educational,0.5968165382079414,12,36,617,1037,420,78.97401011825802,3987
9c7c2574-b610-4d03-99c5-eea5de8035ca,Healthcare,0.8282065872494709,6,5,114,1132,1018,74.65817623811854,8971
3458b3b7-e0a8-44d7-a3de-ee3b6964450c,Healthcare,0.4405518579405254,47,20,695,1019,324,80.25302219402947,9518
4dc84975-7aed-4549-8028-12fc12b194a0,Residental,0.914159053245761,40,27,274,602,328,57.46655747055164,2638
85a0d4bd-50e9-4cfe-8152-445f62b66f20,Healthcare,0.8348639004581894,5,10,147,844,697,19.105512920565307,6218
84ebe4ba-7ea7-4e17-a425-c66d2fba974d,Healthcare,0.4326870751656099,13,1,406,601,195,35.30768290600494,8068
6f88f87b-6efb-4e76-8fec-8fe34f4a39f2,Residental,0.6009278171403653,11,7,370,1364,994,76.21343757868621,2358
be6e6490-47cb-44b7-839f-663291716356,Healthcare,0.0014260316939773698,46,29,706,1427,721,50.350962701783196,7165
8481b9f2-8954-40e3-a7eb-d55f5f94caec,Healthcare,0.973269233830204,36,26,678,719,41,77.33178307573581,4503
3badbbf2-87b7-403b-b14d-00d9f7051c90,Educational,0.44555658909065066,5,37,604,1273,669,29.15988528222674,1345
8f1fe6e1-b29b-47cd-96bf-c3954ab17127,Educational,0.16566742742897866,28,17,602,1250,648,31.509939757409263,8707
31b7da5a-ee33-4da3-b6a0-eba86321eff9,Educational,0.20451057617580037,20,45,535,1229,694,15.730300423379841,3427
79ef5e21-6b06-496a-be70-469333118b6d,Educational,0.728001397744193,28,15,455,1419,964,49.434863083991495,3457
f222d541-78b3-4ec8-91da-bdab6a9bd41e,Residental,0.10788059810810935,14,27,581,773,192,21.768172724208632,1834
8cf04ef6-0804-4f36-bd42-88703bf7ce8b,Healthcare,0.6472571952829715,31,3,83,216,133,49.34976750239335,4784
3c78267e-28f1-419f-a485-11a060bc447e,Residental,0.42701533936625957,38,42,185,332,147,10.698600379272934,1343
c012d30e-80a1-4005-b97d-8661eecb4e8e,Educational,0.4570883383782782,13,7,75,776,701,34.05237649734755,1957
21d4f4af-36f5-41d3-a550-9e981640dac1,Residental,0.42009055050545363,8,43,501,1012,511,72.53092540666219,2791
2a496fe5-daa7-4e47-8f5c-42ee788132ea,Educational,0.6417624371973614,30,23,128,504,376,63.54231702422397,8906
f5fee649-9ce1-4926-a8ee-6b29c54a610e,Healthcare,0.579268848954312,18,25,175,994,819,88.92568853386732,9840
02f7516a-ad6c-4b8d-bc97-e047b4e96fef,Educational,0.2406840865726243,11,36,320,1000,680,86.79983346232945,3814
d45c5dd3-4183-4253-bfa3-af74ab5e05a3,Residental,0.7286293340578048,8,12,86,684,598,93.5973261865085,5955
a734a6f3-a233-4b59-87c8-3ce3a6166b4b,Commercial,0.45348092650914673,23,46,234,545,311,22.62491066015842,4312
ebc4be7e-fe4e-4a1b-9560-34d17e6fb589,Commercial,0.8910487065194064,13,16,3,469,466,53.74954464885721,5542
8e7b5ece-7333-4c6e-a448-a0379d0f4982,Educational,0.9934497984287946,3,28,299,1280,981,71.24832139308413,9045
2e13ec5b-eb54-4db8-9a62-6d269db1ce10,Healthcare,0.03494221177773971,26,27,508,1352,844,13.220841093244903,4548
cf01680b-203d-4b9b-af6f-75c8f404abc1,Residental,0.010918453402296247,15,30,275,1262,987,73.80765391483857,5520
addaa450-b520-4016-baf5-7e81c0f26543,Educational,0.1804222331465244,45,5,28,1118,1090,45.4966917773779,8672
45df9827-d0c2-454d-babd-b6fb5f195be2,Commercial,0.16192213965188795,22,36,79,125,46,66.66268674420212,8743
e59df266-63db-40cf-a728-26474a231fa5,Commercial,0.6469744093349701,12,9,78,318,240,60.49942747553812,6430
ca172254-73d7-4058-993a-448918136447,Healthcare,0.016419528685061024,32,12,93,381,288,36.618776256730314,8606
b5c868fa-e4ce-4153-9429-7ea5460e89ac,Healthcare,0.6271581820022757,34,33,287,404,117,73.1396135009329,3544
b1cd5c36-8d87-440e-abf0-f00558ba84ea,Residental,0.06023230057098328,14,9,88,120,32,27.624788859946406,8974
fd3a86bc-ae33-4b5d-a35f-b604b642e733,Commercial,0.8776754556399162,10,46,392,874,482,83.88935187167634,3349
1110fa10-3ee3-476e-ae68-4e92a692ccf7,Commercial,0.5726349530896936,5,35,699,752,53,57.440050446638914,9467
e999272a-ec89-47af-9f35-0afb8612f4db,Commercial,0.4872361834498742,46,2,271,1130,859,86.33483051348101,6311
443196ca-ff87-4c8f-ac07-a9d1a3a5b0d6,Commercial,0.05478379101542319,36,26,375,1250,875,73.15193788989632,8396
789b79a3-8df4-409a-8d4b-ffd7ce074a60,Residental,0.22348036505514002,48,41,669,1396,727,60.03580922037097,7193
17644af3-a4e7-4df5-a3bb-c280d21da041,Educational,0.8484952360205658,8,20,81,340,259,12.443456344351475,1078
3549bbf9-14c7-4d3c-8e21-4f501319c709,Educational,0.9014114861282001,7,15,527,772,245,62.45071648096386,1466
0d4a93f5-9c31-4b81-93fc-2107831bf3aa,Healthcare,0.37757132278790084,8,6,330,1375,1045,31.101738240120394,6393
82b4824f-5101-4db2-ab5e-5252d3a2239f,Healthcare,0.2920082974506253,46,14,21,273,252,72.76765094754462,4523
6f80dfc0-34c3-4d20-a222-ad2fb5853e3d,Residental,0.11119159619159369,16,33,669,1406,737,11.562624365174404,9338
9b9dc16a-d98d-4d72-8b98-3d057dd58fa8,Healthcare,0.8264030325798749,30,50,378,869,491,34.53148124727109,9270
c213d5dc-8563-4af7-b1f6-2660d43d6786,Healthcare,0.924237010840298,7,22,339,1384,1045,59.752842348364936,8828
f18ffb65-e456-499f-b0c9-bbe31101abd5,Residental,0.9096961484876582,24,36,26,789,763,29.304907798029674,8731
5f242910-cf37-4fc2-97d1-0a2276ecbab6,Educational,0.6798393217472375,21,45,114,1221,1107,24.968244655586357,9163
d63591c4-b2df-4be8-a87a-0333a41bb314,Educational,0.6935810657684632,44,23,260,1109,849,65.09778255036028,7425
8894bd1f-f67e-4d23-a396-ee23cb36d58d,Educational,0.7496025828655548,5,37,335,814,479,97.32130823464936,7844
7f45ca1e-c3c5-4fc9-9c85-ad922983b2d3,Healthcare,0.08405858013807721,9,45,157,424,267,92.88051811572495,6042
d7493801-0c05-44b8-a6b4-723f221a7d07,Residental,0.45815410284744806,50,48,86,384,298,80.02252619197053,1484
ea38fa43-b174-4230-9b99-e3d49aa9f77a,Residental,0.14095808425195322,42,16,299,851,552,23.404311934055336,4082
68d2a0ad-8951-4d61-863f-c81eb10de41b,Commercial,0.6457564048498252,7,30,343,472,129,95.63831275744187,2897
19316967-dffe-4f91-b0d3-6459a9b6c61d,Educational,0.6768904932440628,47,49,407,1202,795,49.47444704169704,8451
6f40cb23-76c9-4e16-ba06-1e6ba3b26ef1,Educational,0.6836368384920746,19,23,416,1303,887,30.555245825075232,2048
e70b43b5-baac-4ef0-a0c2-7d56a07f99df,Residental,0.39031323989405287,43,34,511,1317,806,52.4506381396426,1481
6e272545-26e4-4c6a-b4b3-2b59516a86ab,Healthcare,0.9120381824535003,44,45,494,563,69,53.1392204708902,1232
39cdf70e-66c4-4840-8516-d582cc3863d0,Residental,0.6086737479946034,33,9,221,756,535,53.47109242116123,6979
95456b72-591e-44e1-a154-1877aecb2596,Commercial,0.9360817980117189,1,37,376,972,596,57.16906206742398,2872
b1c465aa-08b0-4c32-a266-09b3c957a8cc,Residental,0.019166669621313415,28,49,81,1236,1155,84.06524915452765,4048
6696fd2a-49ec-4d82-93f7-c5e9533e89cf,Educational,0.38003035908117,50,17,546,1111,565,85.95693467500838,6557
b4e301f1-a1fc-4ca8-b5b9-c1b1f5a4d841,Educational,0.9750682592535332,24,23,108,1280,1172,87.76572038739289,9304
552f94db-d20e-4541-869a-e62fb8504ed2,Residental,0.6407235777261898,1,32,391,1225,834,71.1491886735227,4953
b2a50ebd-4769-44c7-bfe2-85adc88b3ce5,Residental,0.8742174843714512,16,25,574,1343,769,55.66069275878643,6425
609fe9a8-db98-4bde-99b6-c9e9b6954f7a,Healthcare,0.14808810480757006,24,5,655,1293,638,22.781348115347996,6555
f6a84178-124b-473a-abd0-e0bfd2658c7d,Healthcare,0.8878301627155851,46,35,124,1306,1182,87.825531828279,3969
136e10de-c99e-4804-b381-0c96ddb443f2,Commercial,0.6101293350301206,7,48,481,790,309,25.60524518095432,2954
ed456c3a-3349-4f61-8b66-599857f6dca4,Residental,0.2541843770597211,34,38,351,1299,948,75.37196866564692,5080
3f1e98af-f5c7-47de-8071-de3a10225af0,Residental,0.4864818064423799,48,9,355,1186,831,46.421406707457315,6057
9eeb0140-7555-4edc-9a17-032bb3802bf7,Educational,0.6149726853699232,8,45,568,658,90,88.15348312188358,2819
c7682ad4-05c2-4420-8427-ee6ae89fc02e,Residental,0.4819437459379654,38,11,117,393,276,49.28669958628399,9505
1da7c4ca-5850-4fa9-aafc-18f59322a75b,Residental,0.19017658365509638,31,15,71,173,102,43.38351534951117,1481
459f2314-b2f6-4918-b4ca-bcac6bae43ee,Healthcare,0.2347815492846267,10,19,544,1014,470,32.47262476552207,8240
7d091e1f-156e-4dca-9ae8-c161dff2a5e4,Educational,0.786911187574588,14,3,250,1076,826,38.500107643410566,8354
86c2366b-e6fd-4c38-b6c4-d4ed2e0ea549,Educational,0.22124942923184088,1,33,248,460,212,16.400902670482743,4122
e2965647-54c1-4889-a29b-b762b69c1d2a,Commercial,0.18800151536294518,13,29,264,1311,1047,80.02676130293098,8848
e47a337c-ec77-4c8b-9820-2c2fc89d2c53,Commercial,0.3786202044707626,23,37,342,552,210,28.900528936729152,1064
f928c554-129a-47f0-8778-1ff16ca18428,Commercial,0.3629320776295384,47,13,631,1412,781,13.435826087105932,7183
233c8ae8-60b0-4106-823e-ab57f52ac531,Healthcare,0.2773927018482347,10,2,116,481,365,98.05065877402507,8754
e8b89035-707e-4207-946e-443e74a28386,Educational,0.8723461364583589,28,16,40,74,34,46.810829540325315,7466
49dacaaa-c15a-4d5e-885d-bb21e4f5d23f,Healthcare,0.34995105065738175,16,37,143,395,252,11.540978034964294,5336
c29f3a96-69c5-46e5-8b10-fde30f22c0ce,Commercial,0.1893404965509501,36,50,511,992,481,76.35409647360665,8865
ab552a16-a24e-4353-9b4e-41e0b33aecbf,Educational,0.23722827315615258,35,19,301,464,163,44.90621472429841,2927
bb778bfd-fd0e-47df-a476-a207dde69154,Healthcare,0.7464748608376418,29,14,125,607,482,73.34430424957259,1696
79401b1c-d326-4309-a670-2a9501a99a20,Residental,0.3448431412454849,8,38,704,789,85,54.60878454658043,9513
4a009704-f72d-467f-9c4f-d4180462f99a,Commercial,0.4365704619287608,11,28,520,1297,777,66.94446406677648,8267
ec7de186-ee4d-4a86-9506-839fc6fe37f8,Educational,0.24787898273414788,19,7,344,1053,709,95.78692508627674,5395
324ae287-1453-4e0d-8d8e-91f808255c30,Residental,0.8611878625160898,49,6,423,611,188,15.181433388659578,9053
f5fc87e2-31da-4518-b005-013b3a3cfe65,Educational,0.5695306392490583,34,37,344,1129,785,60.58911002581262,8589
a4197274-c8b3-4715-99c8-a668cf91a95d,Healthcare,0.8017706785658081,9,11,625,1119,494,28.425263406462143,4863
1e787fe8-e7f4-4760-bb82-8c44a0e4391f,Educational,0.21225886351383338,11,9,12,1072,1060,35.01307392409491,7513
4c403ff6-bdae-48c5-8380-2a84258322f2,Residental,0.533009009076936,36,46,587,906,319,65.35807986301906,6040
9a6baa62-30e7-42b0-92c8-cbafeb778525,Commercial,0.7306286232768678,27,2,19,1054,1035,73.20078860479273,8680
5ec6ed80-efd5-457d-80ce-8defb90179e6,Commercial,0.07167262393146123,38,29,702,1424,722,65.8614179763915,6961
3da484f3-a218-4da1-be69-7252b3ef0c53,Educational,0.8774801167206058,41,5,446,909,463,38.64255232097058,7551
769eeec2-c3f3-469e-a94e-9e361317b35d,Commercial,0.2597048068192519,35,46,175,1067,892,37.012998089803936,9315
56958bd8-1a08-4411-8bf5-e37718c97222,Residental,0.1862492729309878,36,39,109,834,725,90.42661074930867,6635
8986d73a-d6b8-4db6-aedf-4dd9ff3f9b5e,Residental,0.2568306512141264,8,11,201,335,134,47.87827398123872,1184
a4e3c9f9-3c4e-4014-be51-7a2708488752,Residental,0.6631281547561096,12,48,558,736,178,55.15450416289668,1552
5f9b6adb-6d64-4858-bf4c-0e9b2d9d1d55,Educational,0.8231935133651801,6,35,26,1072,1046,67.99978572988199,5172
d1c93a65-24da-4a8c-aecd-b7e6d6d951fa,Healthcare,0.9456389757944254,50,20,677,1149,472,72.60733450893504,2741
b6fd420d-ba5a-451b-ac60-d5e5704ff26c,Commercial,0.620211515643564,17,26,178,815,637,80.73902985460576,8848
56a59ec4-a48c-4854-bc75-b19e1eb90d23,Residental,0.3152155117245381,39,1,676,1120,444,28.19207927783509,5004
ad9efd75-7a26-46cc-9d67-4df7e2c5f6ea,Educational,0.8609334701364576,11,24,199,673,474,77.02789712967676,9931
4b1f9d65-8771-4023-b4c2-a3fcf45895e5,Healthcare,0.5155247385365416,7,28,492,962,470,49.196545119340385,5488
ef0b3fa2-6391-4416-aabd-9286b28d1c40,Residental,0.5531612537780605,30,10,407,654,247,74.69797396264394,7781
988d13b9-6367-43db-9c91-f7621082bd9f,Healthcare,0.26618474822154603,26,45,86,711,625,13.073503057053571,3142
5e6efae0-8167-4c5b-972d-f0adb8348cc5,Healthcare,0.47715282627383515,24,7,285,1011,726,64.36189594887583,7359
7f08138c-d255-45bf-85ac-a4bfe6231287,Healthcare,0.3287660272720997,8,36,158,1391,1233,32.17403783253165,4287
b5502ca2-e1c6-422b-a196-a91ae210865c,Residental,0.12030321991781845,35,21,621,1400,779,80.23049005174309,2547
8fdb2d87-ecf3-4724-9afb-bfea527dc184,Healthcare,0.9283073575178263,29,36,671,1353,682,78.55797123092576,8331
c1116b1f-bbad-4817-8675-3dca81dbc310,Educational,0.24569957804274312,10,14,532,1109,577,14.095139062475493,2672
3cf90890-0e9a-413d-a71d-7e2ee8d66c7c,Healthcare,0.7260365092571116,41,5,666,836,170,14.58162712305544,3763
568f7343-4556-41ed-91be-90c92a44bf74,Healthcare,0.11763296332665418,1,45,100,1187,1087,39.13279162097533,1495
66a647a3-c2ff-493a-8bcf-b078db5ea528,Commercial,0.018340278701514445,16,24,454,986,532,85.98645085120401,4840
828c60a1-fe8b-47f1-9a8d-ca78e50c4bfe,Residental,0.4813446084253019,31,2,240,370,130,72.14628070806414,9847
c56d36c8-eff0-47d9-9629-aec8efa680bc,Residental,0.29414711101957935,48,29,482,741,259,81.55420756508126,8117
5eedbe49-1c0b-4911-9389-1b1508927f1c,Educational,0.9477826195249351,23,44,455,901,446,45.154034307551576,6567
1330ddb1-0cb1-4df4-8a6e-471b02f3390d,Educational,0.04364193717341802,17,17,324,1397,1073,75.19571331482425,5768
b6dca7d2-9f01-43d5-94c8-f08d87c7d9a4,Commercial,0.572787998171785,30,7,562,886,324,76.84500388770162,1299
ecae3021-3e5a-4e64-98ab-2d5de201691d,Educational,0.046194515325454155,36,6,435,1045,610,93.10938815931003,5705
5ffce089-816a-4883-a838-c8839e9de116,Residental,0.40784203800491403,43,3,379,931,552,40.994972882497635,2383
3afe5bd3-0f99-44da-b40a-93876aa7dacd,Healthcare,0.7658239823613969,22,12,419,1248,829,58.354022662496966,2583
4e112d75-3cfc-40e4-9cf8-1ed5f3090b3a,Educational,0.6488541564704121,29,42,627,1068,441,47.006202461776105,6047
5b541e74-2699-4f03-a4d1-bfe1d4401ac4,Healthcare,0.48031563555867074,4,39,36,261,225,10.81138787796897,5528
c459e14b-0dc8-439a-824f-f64bc039be3a,Commercial,0.440909501358023,17,50,346,1215,869,66.22466890428836,7193
01775553-1d5f-4a72-a1c9-6b96aa313965,Healthcare,0.04190361217017491,45,24,158,928,770,78.8447256820063,7863
f73a0a66-df76-4d89-a5c2-ca424ed13535,Healthcare,0.8778896899770617,32,32,170,1198,1028,56.77678113710193,2577
85facabf-11bb-49b7-abe6-8b18197e2b1b,Commercial,0.8464331037807727,39,19,409,1333,924,12.389295902379473,4946
93bce645-4486-4e57-a0f4-6e96a9b54986,Residental,0.03900932123872769,10,32,706,937,231,54.910567857150234,9297
9049bb5e-857f-4c3d-ad1b-cc1b2ba4b854,Healthcare,0.1044957915499326,20,47,215,864,649,30.37987195118115,4809
43d265c3-40b2-4dcf-b6bd-766f72974f69,Commercial,0.759684036569196,50,31,620,1332,712,71.58837597688088,5603
a228691c-07b4-4ed0-9750-1993be8819a5,Healthcare,0.48582112956520496,21,28,399,1369,970,97.21186720617628,1682
8fbe4296-b60e-4367-a532-c64aad38bcaa,Residental,0.5971212377257021,46,11,575,885,310,66.6269875908103,8830
a89f7d08-8090-49a4-bbea-3b27e31584ee,Commercial,0.6977361990193824,42,29,85,163,78,85.22326035813197,1403
e92fe20e-e9c5-4d5d-8c0d-ac41f8e3126e,Residental,0.22163101047822464,32,9,19,1168,1149,52.02356027626291,7573
4925b135-53b2-462a-9b84-70293530d71a,Educational,0.5923844783176216,36,36,322,1397,1075,66.27194118604407,4042
59438197-adce-477f-896c-b1f360fd1eb3,Residental,0.8110743807026405,2,32,712,1409,697,47.38616476476234,7177
a9a3c653-ba24-4ae4-9ecb-e6b76d458566,Residental,0.6817191146456889,5,10,75,512,437,24.53716094030788,9189
139522fc-27f9-4a89-adcc-1239d23a4866,Residental,0.6620920255699759,38,27,397,830,433,71.60637315071023,4362
c3663ff9-87cb-4fec-a75a-fbc2c596f8ca,Commercial,0.964917689770125,37,27,587,587,0,41.353757855973384,8143
05947af5-0578-435b-9bff-3c6964fdaec6,Commercial,0.6411046322707449,21,21,122,609,487,56.51876767833144,7230
3a992aea-68d2-419a-89f8-a1fa6aae35c5,Healthcare,0.5141242452275131,14,7,556,1277,721,98.88428606361379,3042
29ca76db-e5e6-4a5f-a19f-40f68564d021,Healthcare,0.08650820174561813,44,45,192,596,404,68.63158594245135,3116
1dad8636-ab1e-40a7-9798-94df529e14d9,Residental,0.38989335590366825,15,31,456,780,324,17.22932728914703,2116
8c2b447f-dd61-4ea3-b001-43aaa0d1b527,Commercial,0.516587035397983,23,3,304,1387,1083,45.54945905823946,1830
7f59f470-7942-4ba9-baf9-b31dc8d0a8c1,Commercial,0.7466210467217562,40,23,407,1048,641,15.966171602997338,5944
b768368c-1ed2-4130-a1df-f64f992de7b6,Commercial,0.47786268149325994,48,33,514,1065,551,61.54184761918853,6170
618ef7d8-ecc6-49da-b6d4-eef6fc366866,Healthcare,0.588109294072181,29,8,70,1413,1343,45.27287318779117,7805
6aa78f68-f2de-4616-82dc-7051c84f4830,Educational,0.4483723365644916,9,8,627,1179,552,19.472965219169033,7930
f44e5811-f6e1-4590-9ae8-08abc688269e,Commercial,0.6029483939644442,5,38,418,423,5,77.55910844712609,4149
5333fb01-09cb-492c-81c1-f7556019b66f,Commercial,0.28781479964523415,29,9,336,1133,797,30.025458257678867,3341
bcf5489a-316e-4ccc-8752-1c7a8b0225b5,Healthcare,0.6252531982973577,42,36,13,1380,1367,21.04844928515996,1315
3aa765e4-e467-42f1-b98e-ac94f4ec20a1,Educational,0.9950016562860015,32,18,396,853,457,50.25338590440328,4294
5549e928-5aa7-47c0-8961-92f458617ee1,Commercial,0.26075584504161675,14,15,658,1340,682,22.39897270194021,8758
b5f938aa-6a25-4bab-918a-c8ed0a467fe6,Educational,0.7172732155447633,15,39,227,977,750,66.13035609247514,3237
306a3aad-8939-46dd-81e6-afd82d4e373c,Healthcare,0.6449725005576291,7,23,257,411,154,75.09547269434005,9021
9753bb1b-6a83-4391-bfeb-0c1240eac804,Healthcare,0.7523147304349898,9,18,36,473,437,70.16010087556432,7301
6a577192-f423-468b-af7d-a94163dd781a,Residental,0.9595390267013288,27,7,596,762,166,10.809658821454546,2647
4006b8df-115c-4670-85eb-9b078887e0dd,Educational,0.06712071613764137,5,48,585,1132,547,52.216325435777236,3097
18a3c197-cacc-4e1f-bbea-5e76b7fbff3f,Residental,6.688616751360232e-05,28,33,266,1348,1082,78.75532838345418,1308
851ef41f-c875-4785-bb78-08f67ff310d4,Educational,0.46965175672807835,30,17,492,1310,818,77.65749914802291,8069
34b2a2da-2fab-4d0b-9629-f53cfba11853,Healthcare,0.26315131483347787,22,16,5,925,920,32.70470296477295,8373
f0f66eab-e62e-4278-8e72-83dfd2d8c71d,Residental,0.13194349251599558,31,31,717,1216,499,13.991531565533236,6426
ec450548-5ac8-4802-a092-93e5a0ef67a8,Residental,0.5094494566761947,9,41,492,1014,522,93.75486263278754,3372
a66e4cf1-870e-4590-985f-431393c3f5a6,Healthcare,0.42125397021738464,24,27,661,1124,463,42.19791188163606,1149
781a401b-aa2c-45ba-b38e-6e28b6caa2c2,Commercial,0.2966339186009278,23,30,188,1406,1218,76.1611818113612,7955
e385da2c-615c-467a-9b94-4056f27ba08f,Educational,0.9396497445189087,28,4,247,728,481,26.351359171746058,1324
e2840923-1b2a-4bf2-98d8-921e40c9e669,Commercial,0.915777760361113,8,16,620,1086,466,67.2988760301086,1231
16f1f4fe-a720-4d08-b975-1ecc7438d87c,Residental,0.0001421821210765284,21,29,529,965,436,64.56045058913732,8943
e856012b-553a-46a0-a64e-ae33e2daf259,Residental,0.6687748463077864,20,10,650,1035,385,74.61328881321973,4203
5a08d25e-1e39-4737-b6a0-0a79558c8603,Residental,0.013792107908123685,45,31,26,699,673,62.230465840101616,8154
d8885b1e-892a-4671-8214-cdef5185ea98,Educational,0.30382124549475265,7,39,351,1278,927,51.11942683607968,4061
9b624315-8634-4aba-9095-cbba4599ccce,Residental,0.15141305389060378,47,42,39,160,121,84.47516988491077,8499
f592f130-b857-44fa-ab0a-77f426c60449,Commercial,0.8537919254103826,42,25,130,1041,911,68.61187394971583,9677
b0d5534d-46f1-4618-bd5a-242325287614,Educational,0.5938867788743023,27,33,633,705,72,90.42491063620736,2116
cb2b3c73-db6f-41f1-a4a3-428e397f4c43,Commercial,0.6860757371608807,1,15,447,871,424,47.539757044961284,3843
6ae03284-ec72-4c54-9eb1-9d9152aee4e6,Residental,0.3915165402709444,21,30,107,257,150,90.24576520870679,9585
73bde9b4-4477-474d-b8fb-401368822137,Healthcare,0.4528403710205977,47,33,331,1239,908,48.62950724005173,2609
61be70e9-343b-48b5-82a0-c59edf8ff592,Educational,0.1882257146946027,24,17,587,1055,468,85.81212589738382,2441
e595c2f5-3d80-43f4-b768-2e312e83cb6c,Commercial,0.49459519921911144,14,16,521,695,174,84.44822515800786,4155
1db61ee2-d7e6-4756-bfb1-be9f93028a4e,Healthcare,0.23647416905790186,7,21,598,1401,803,31.488763208374234,7031
bbf14f22-c6b4-43cd-ac4a-428ae9b94371,Educational,0.9301790827429712,50,17,260,747,487,96.21403747264903,8140
9dd0d30d-03a3-4588-b6ec-f58261ad1e63,Residental,0.3849731442863479,3,23,276,879,603,14.967566368478131,2474
1b99cf9b-c3ee-491c-81df-a1a80ef78fc1,Healthcare,0.6525768613643677,46,3,329,441,112,59.87198482080488,7013
f96b9e23-e08d-47f9-92ac-9ec71e8e924b,Healthcare,0.04824555184857726,35,16,628,1268,640,22.304055548818894,3632
9dbde5db-7d29-402e-8a4d-559535fae926,Commercial,0.2548479516644222,15,49,261,705,444,12.019895929125756,8550
352fc72f-d6f7-4261-b7f3-853a8b97c312,Educational,0.5763991583058222,22,15,566,1339,773,31.612283319190187,1013
84b464a5-8892-4621-91d9-6e16ac4f77c2,Healthcare,0.470329823128411,7,11,216,1376,1160,59.766731428784276,6090
04660658-96b2-4ae3-b745-c6efcab58463,Commercial,0.07771166988468414,37,48,292,1012,720,97.3888427069667,2387
460cb703-2c8d-40e7-9ae5-e151e03eba0f,Educational,0.7575256799009162,35,41,253,885,632,78.42919205895292,3813
d847a44d-b46c-4e2d-a947-e2204f6a4b1c,Healthcare,0.6753133690318879,17,49,252,1298,1046,16.072719382495606,9602
c47e8f3d-486f-4e36-bc00-33ef6757fd9d,Commercial,0.6091250526382548,33,36,420,926,506,81.96615813549026,2260
a0081d8e-2969-4d03-a5b6-89f57998555a,Healthcare,0.9544766242749999,18,25,216,306,90,26.104949504784294,9445
70c36f8d-3d4b-40af-b541-15342bd9d8ba,Residental,0.37107968131623414,7,42,414,1240,826,74.89381740484299,3117
92933417-423d-45c5-adb4-d27b3fd3ae15,Residental,0.5702995733277668,42,45,659,966,307,60.517148120041696,1539
f11dcc4a-4533-47a5-8828-c25a789d44e6,Educational,0.49872987053884865,38,34,496,685,189,22.066833168646852,5682
f12c8687-aea2-4a8f-ae33-5316df0fdbc0,Healthcare,0.14770675439337144,34,2,312,359,47,41.2448568401562,1194
16ed9427-1ce3-49e2-991d-bfb7cfa8c080,Residental,0.541142912990284,50,42,632,889,257,30.221359162441924,1002
b3f10a24-f0e2-423f-af65-ee801357c5c7,Residental,0.1989510602026192,40,34,439,1024,585,70.06528618613902,3468
e3f3d061-bace-4df4-89f5-a64477d62be5,Healthcare,0.06305230525567018,17,46,369,840,471,51.5161786021844,2317
e9f9aab9-995b-4324-b39d-38a216f7de6c,Educational,0.46130050845735315,39,33,266,514,248,48.76161680804983,7762
2ac5f214-2c2e-4550-8327-7daf30053082,Healthcare,0.06487158873759058,40,24,456,550,94,85.2013815497663,1029
157f6bd9-8f23-4c1a-b719-4c2434e8cb1d,Commercial,0.3846647761020092,38,36,614,787,173,68.02843901727888,2778
f21d9d6a-f8fa-494c-9dc6-332b1e8ad1df,Healthcare,0.808726919023687,46,1,276,1178,902,52.072697146742776,1058
6dbb39a8-a913-4172-926f-83e0480a11f8,Educational,0.5590082902620577,48,12,214,266,52,85.85936715277882,6388
528de97b-69c7-4e1b-9ee4-dab4d51b8dbd,Commercial,0.9771676114766958,46,48,704,1299,595,22.400470269737692,9158
e00f2eff-eba8-4f56-8fcb-f6f2f6d94ef8,Healthcare,0.628610367567605,15,32,149,438,289,26.67371977133464,8225
1fc435d0-f2eb-4b0b-97f7-bf76293fed5c,Commercial,0.3134326793954735,37,20,688,1419,731,33.39138710081918,4745
172335f2-71a4-432e-8ebf-f769973f1a79,Healthcare,0.7277150252481223,50,19,675,1387,712,76.3520367961113,1091
3b42618a-57aa-4239-954e-b8f23363fa20,Educational,0.43389603783852737,13,22,434,942,508,10.056057611846471,1518
c4a9e656-09ee-4b0c-ab34-227b584ba964,Educational,0.6428933355003492,42,22,516,783,267,68.84120221301592,4149
55b8c479-b382-4852-92a4-a112a21a5bd2,Residental,0.8187547872964679,26,16,256,1111,855,53.119488699515365,9346
2df6178c-66e3-4332-9613-7b4b8fa645dc,Residental,0.5980908438234609,33,41,115,327,212,50.933975516803,8316
6cdb1b3c-d9cd-42bf-b296-4ac0364f7a9f,Residental,0.7959841630859834,17,13,295,299,4,91.71715179802024,5091
012d6387-c6ca-49c8-ac1c-d323b3ce2e8f,Commercial,0.5777863403470832,8,21,522,1266,744,65.1443057682551,1783
2bbeea3d-d538-484a-bbb5-46c7f3414257,Healthcare,0.8520094948247345,6,33,244,734,490,34.99881531328182,6108
40cf6a33-845c-4213-8f1c-2b0467102ec8,Healthcare,0.35131663420634407,23,19,706,1360,654,21.143064414220838,4570
a3192e7d-c480-4c6c-b54a-e39852cc5ede,Commercial,0.31420902908131754,4,28,708,1000,292,76.5423222676377,7699
741a73c1-a38d-4945-b623-ec485153c882,Residental,0.49707789716235595,50,30,437,1036,599,30.84455993768842,3880
64c7cbc0-f272-40e4-a2d8-0159cc90cf7d,Healthcare,0.23694770351377092,47,4,267,836,569,52.66753820798009,8220
19885a85-e9a5-419c-924d-f83c85d02ffc,Commercial,0.23654478387722888,15,39,514,1110,596,89.77080889905744,8350
55422aa2-a9c0-4576-a808-2d55bf0e5e05,Commercial,0.5353911528024293,5,15,5,874,869,45.182717027763864,3089
1935f247-3f5b-43d3-8652-a884cbfab09c,Commercial,0.3600476076334024,42,22,358,1222,864,36.921975947364075,1734
4b69fd06-ff00-4261-9503-3c0d75ef3fde,Commercial,0.09803326564972148,36,33,288,1113,825,62.63864867877192,9034
e305e3f5-1a5c-4f59-b834-a3d7f3387da7,Educational,0.7037022158823988,46,4,354,594,240,43.00357389979424,2099
d7a6cd20-d469-49ff-ae24-15ebbee9ea24,Residental,0.07214598907482483,18,18,583,1341,758,68.88670920395829,6761
7eec147b-3fb1-4538-bc50-cb59a0fa8352,Commercial,0.8656649415371998,25,7,475,1023,548,48.8492820862508,5544
8e81fce9-d602-4a2c-97e7-42d8a688c32d,Residental,0.7330676268919933,21,9,478,899,421,69.46499259260236,9430
5dc0d2fc-0a69-415d-98a7-424a6c872e29,Commercial,0.7885069525330947,6,33,441,620,179,49.36552283253868,4365
b082270c-a3eb-40a6-a0be-246c2c9df1e6,Commercial,0.9292799349694543,35,50,578,655,77,83.20814372277421,7653
d87aa382-7c0d-41c5-9275-15a060967493,Healthcare,0.9942369132311032,44,4,565,839,274,52.20254539393326,7537
8a560e9b-1e4b-4ec7-90fe-3911ea8b2120,Residental,0.8195101585022313,34,11,88,1002,914,28.655248342414833,2162
a8800cab-6c67-478f-8fd2-d119cd6ebc30,Commercial,0.2969964718247773,19,40,43,719,676,83.07653918666388,1792
a94865cc-d21b-4efc-afd5-7b5fbf40947f,Healthcare,0.6319544995949987,19,40,710,1167,457,18.4651480547247,7036
b08fac1a-669e-4ebb-b76a-f7de070e12a6,Healthcare,0.7318623677570097,40,38,542,943,401,26.44328375794336,6155
05264680-d27a-4b58-8c4a-d13698520540,Commercial,0.6544177647910284,31,32,477,1154,677,91.81193232423422,3334
b44c1c7b-3ab8-498d-9489-c87162ff22c5,Educational,0.33949456015874013,1,27,73,160,87,46.70040040124724,3082
070bc4f2-42fe-457e-8aad-50fb0371a770,Educational,0.8706488998290568,1,32,508,593,85,55.500111705080805,3922
e5762cab-da2b-4fb6-8e2c-ad0a281c78e5,Educational,0.5543860318560072,47,23,356,503,147,59.06959680480643,3831
17089045-4ee9-40ce-b275-1e4c170d0cd2,Commercial,0.9515160404478031,16,39,137,218,81,38.35521086025271,7090
017093fb-9679-42ed-b31d-5d07b3a34db7,Healthcare,0.17381041264156183,1,29,118,291,173,11.108870949619089,3551
a7a69146-b69e-483b-8ff5-8bdd593e72b4,Residental,0.9261352363236056,41,22,70,956,886,13.042626241613341,7646
092fd949-dfbc-43b3-aa5f-1e8d498aaa56,Educational,0.7495903475474456,19,43,261,868,607,92.08256972379412,6418
b777219e-b0c5-40b9-9544-96857f7b1c60,Healthcare,0.26372490509864266,30,34,166,267,101,92.95307058144418,1532
5d72584a-6e82-40e7-8faa-27e8b86f4deb,Educational,0.9938197094482849,20,6,698,1280,582,46.932444211918,2876
8109ae35-97ef-4441-8eba-a3eb33864a63,Healthcare,0.32219063196183606,26,40,46,496,450,61.22518205858148,1402
4ada7beb-c6bc-4ba2-96af-db8f1e9572ce,Residental,0.6562488993705493,26,24,560,595,35,75.27800438850412,4561
6c5e0101-b1bb-4d02-8d19-37d37f3bdefa,Educational,0.3763908137289752,4,15,644,1243,599,54.50034680649368,3289
8ed1ad1c-2a1a-4029-842f-6c62ff4038e7,Healthcare,0.6372636549778301,9,48,33,540,507,32.47906790767118,8877
e4b53929-c2c2-4c55-8ebc-f8039e22717d,Commercial,0.8723539060765573,32,8,209,1271,1062,76.1585859307502,8785
a6e1bc51-ecc8-4cf1-81b6-594f91e117f3,Educational,0.28268137799237825,7,26,333,804,471,52.29804155026053,5287
1c9a9ae4-25f0-4f47-b759-8b44720d5c83,Residental,0.36108068196176135,11,11,643,1364,721,33.8506251363758,6339
744bc59f-98ae-43ff-bb27-2521b5b5e43d,Educational,0.3234824873219353,44,38,715,814,99,63.11624184356914,3219
552f2b18-fe13-444e-9c70-efb37cda57d3,Educational,0.7213784846985386,17,48,101,270,169,68.09133284970605,5643
e4adc73f-a0cb-4445-bd1a-46671c1a74b2,Educational,0.033366182475801476,10,8,39,857,818,97.32987969614362,3960
f7f6a5b1-d18a-485d-937d-aae38e82a47a,Commercial,0.4404172375982647,31,34,44,406,362,95.33433485677614,4669
dc8c03dc-68a2-4f6d-8acb-292ebd7fa463,Residental,0.7097621124619481,2,7,466,1427,961,34.523480518938186,5478
580631c0-a8c3-45f8-a8b3-676a93900631,Commercial,0.5213587979605419,11,35,91,494,403,76.63738395348463,2767
ea16eff2-8e39-45ff-a31b-78c0547c8d23,Commercial,0.788908640972919,20,12,238,664,426,38.28887414009293,7885
ac7409b4-b1f0-4397-9e2c-d08d5c803323,Residental,0.9289546215042782,8,40,62,90,28,82.20741905681395,6527
b6f82b2d-7703-495f-bc13-2a42edcdcec4,Commercial,0.46006825960825715,47,45,241,673,432,63.02014166528039,9262
02a14063-124f-460e-ae7b-925bc14c5bfe,Educational,0.685187805155688,25,50,667,1319,652,39.84094781057665,2282
64387b2e-6432-45f3-ad59-d4a390931de3,Educational,0.9407064794852944,19,32,455,800,345,97.59725417052505,5447
baebdbd5-15be-4a84-85fe-943355be41bc,Healthcare,0.5033504063736924,10,7,389,1180,791,32.71832112890985,5994
b064ed4f-9abc-4f13-beee-9c2f54efd0c3,Residental,0.3379875831521363,26,23,395,1435,1040,74.25697193218427,7930
08288f9b-ac29-4182-b3da-3aa37f19c0af,Commercial,0.42123467555995775,5,6,103,480,377,45.918892099199994,7845
c1c5261b-71c5-4c8b-9556-eaefe96dadb5,Educational,0.7475501210313427,26,9,654,764,110,91.27976289110745,6145
c3e0b9be-41f0-4492-b032-08de132edb76,Educational,0.7663147765620814,1,49,499,921,422,61.60081288444807,9327
684c4124-a87a-427a-b522-0e0c906602b7,Residental,0.46667481927849297,48,43,535,892,357,35.89796718648875,3252
635e12b1-aa0c-4902-98ff-aec27c3b5a7b,Commercial,0.8934081289924907,7,6,48,1431,1383,93.42688476230246,8963
a0f362da-d596-4ce6-ac40-615b094299f5,Educational,0.6420407762476026,45,39,18,364,346,35.989259495063266,2426
31550dc5-2071-4221-89ca-c094b1037815,Commercial,0.9833246816431246,11,25,652,1255,603,99.59534303332103,1088
ec7841bf-1ef4-46f5-b205-843e91c5095d,Educational,0.899166290191776,48,16,433,1024,591,63.085724421442585,6036
15ddfbf3-79bc-42fc-8a57-8d51a997e34d,Commercial,0.6045483511503792,40,46,402,722,320,26.88214598383042,4178
f0b4145a-a6cf-42fd-836e-be7dea88e08f,Commercial,0.5249980661492331,5,9,80,296,216,38.261555878757285,6087
b6ef4e55-21b1-4f12-9063-b12c22c7caf7,Residental,0.6594256573867999,32,42,623,1347,724,83.54698282501455,4823
20f4fc31-6a26-4dae-abb2-a9cdcd9ee0d3,Commercial,0.5610091861027997,46,10,397,539,142,26.398945121076373,2554
a339a537-c774-4305-9167-0f2bf519492b,Educational,0.500989142610767,44,41,553,916,363,18.96743217553358,8984
406c3413-c7d5-4b33-ada5-cbe386faefaa,Educational,0.08375709333903247,45,15,690,1261,571,61.63989731914782,3774
207de389-fa12-427c-b54e-a29f67fc0700,Educational,0.8842688272161924,35,49,350,490,140,88.86112808257508,1121
53819417-b0bf-4cd6-9a87-ec90d6db18b0,Commercial,0.4044755749014447,9,23,532,982,450,82.6247702511586,3849
39657d60-6a85-4fd9-a821-9543e43ae7c0,Residental,0.686875950544694,18,23,653,1197,544,83.3678700826026,7523
782e49c8-7edc-4528-bf4c-d567ba79d2d4,Healthcare,0.21991327335109834,25,17,228,1087,859,58.05325934714999,2786
2b665b46-fbbe-4efe-9a30-a7608ecc6341,Educational,0.35922506158172796,15,30,442,1323,881,87.01192089459668,1040
11777d19-b692-4c39-9a4a-c7c23467f630,Commercial,0.37204292545605966,13,24,7,294,287,13.732503495365568,8824
a5cb294c-3590-4d41-89a7-6677d1bf961b,Educational,0.6734832178727483,31,25,211,1261,1050,72.63025893667705,7890
2be886c7-8767-452b-a04a-324be37a8c1d,Commercial,0.4689135727373832,10,36,243,380,137,82.67921221150782,2210
0b57306e-a457-4e60-a56c-26552c775e43,Healthcare,0.723912612972948,27,50,482,992,510,40.9076721648341,4420
488e5d76-75b7-42ee-93e4-dc6fe59f206c,Commercial,0.5235166159440784,22,44,1,577,576,14.967502237852823,5197
74a2e142-b3fd-4b9f-8d99-76f3eaeb4c0d,Residental,0.9726809609380116,49,16,155,1032,877,34.37972600973971,1673
12751a60-6e40-48d2-ae7e-a31b2cf06d93,Commercial,0.8956234198964592,46,17,358,1045,687,51.47965611543931,6950
f4036185-e825-4a57-98ee-a7d3272dc39e,Healthcare,0.1360312886836471,3,2,629,1248,619,78.39606123198658,9627
3140ce5f-ec28-4553-90ff-14dfc4a2f61a,Residental,0.8608181927578349,49,32,393,586,193,64.24390617668575,5873
bae90187-3639-4d5a-bdc6-95510f84d793,Residental,0.8411656561551372,34,27,281,1083,802,11.492177829205563,8843
c0dfe9c9-02c5-4d0d-a105-46cc657c05f9,Healthcare,0.011955713488424169,39,47,203,312,109,44.40104677761982,6710
3be9210b-8fa2-4af8-92f9-e831fd80fe1d,Healthcare,0.6741436987033099,7,22,405,1072,667,52.88198816526671,1907
af1be7f5-5c5a-43f3-a833-79577446fac3,Residental,0.1836810025837361,19,40,570,765,195,51.21411230357932,1703
6c6332e9-c466-4172-b6ad-d0941dc727fc,Commercial,0.6664639411559421,30,8,328,722,394,57.83098112251016,1696
f67d83e6-1d26-44a4-b67a-b3cc3df3113e,Residental,0.5899476382096047,4,33,337,927,590,35.58505332485632,7203
278f8df1-a140-409c-8fc9-bca0a15e9e19,Healthcare,0.6384336723107259,48,14,14,1408,1394,58.141477879884,5584
8cdd0271-9fb6-4863-9578-3174949e8e86,Commercial,0.9911684497345145,3,40,289,418,129,34.25252902368416,4666
fc3649a8-e6ce-4f77-91e9-4ebbd482a2bc,Healthcare,0.8804871339595555,3,47,29,370,341,57.249103007590044,7004
897f6a1e-c6e5-496b-8238-1c3db7f322aa,Commercial,0.8895808064268146,26,48,635,1433,798,35.24894858957866,6077
b41e3006-01f4-47a3-a04e-c5d4a95459bb,Commercial,0.09156689438773191,1,28,113,1243,1130,79.54948540475618,6368
90e57b6b-4d02-44f7-82ae-4d63087612dc,Commercial,0.1929288719299458,34,27,302,1221,919,33.203744591977646,9517
70c0098e-6c2b-46a6-a22c-8cc21a60a89c,Commercial,0.9126166805584792,24,17,441,609,168,72.24658998560228,5402
c3dc0c64-9957-4dc1-8867-f6f9bd66ea98,Residental,0.9957697424179424,49,17,618,649,31,85.38696914770563,2103
cd6df85a-d92d-41f6-8f9a-3a6e55d556f8,Healthcare,0.15274116539169136,1,47,398,1372,974,37.97264460254665,7164
5c047a60-2f19-4e68-aa0f-07f23ea844bb,Educational,0.007018267533023148,8,27,412,634,222,26.530471081986757,6067
4c21233c-7586-4d89-a394-dfddbf994b65,Healthcare,0.7131979253515826,17,26,661,1298,637,49.645017210863706,4140
de9bab9c-7fa0-40a6-849c-8cbdcff70703,Residental,0.01865476266374133,27,47,549,878,329,55.92850861648634,6911
491f61c8-c7cf-4da2-bada-6988b68ab0ed,Commercial,0.38415402249117847,32,8,58,1071,1013,14.698092742978758,5440
26628b96-042f-447a-9857-ff557ac7e050,Healthcare,0.32889506783089406,49,46,703,1393,690,68.87982351016635,7002
aaf630a5-94d5-4b77-b48b-53d77961536b,Commercial,0.6247206308823114,12,50,373,1330,957,30.222349468655327,6539
f2601cb0-13af-4d50-8e2a-b2efde1fd866,Healthcare,0.6583655141123494,24,22,656,856,200,44.19323145699876,7349
0405ab74-2bc4-4228-9aa4-fa6e5027a3a5,Residental,0.732124173556275,33,9,588,842,254,93.90618562131819,6017
01760180-ad54-4e5c-ba1e-60d770f10c5e,Residental,0.3912114727222721,3,15,158,537,379,43.91988676013018,4214
0b16352f-ab47-41d5-80ce-32bfef81ebcf,Healthcare,0.26290577472295107,35,24,488,1251,763,39.67917414620968,9118
2f9058e4-1811-4335-b2a8-bf05ee813119,Residental,0.9362385190857524,47,23,565,789,224,22.27276965885015,4407
abfc0c27-e98b-4b2c-911d-c9331134ed0f,Commercial,0.7673600191120968,1,29,327,1193,866,41.11343897861613,4930
173ea9f5-d36c-4356-82c0-c7f57f14977a,Residental,0.18945376892597388,14,26,68,362,294,43.90297930716106,2421
c765964f-e08e-44c9-bbd9-2475e81f5234,Residental,0.7084146015264952,50,25,80,376,296,71.60075226898635,5906
05c4d18f-e407-498b-ab33-22fd99e83100,Educational,0.17728888344608262,34,28,420,686,266,19.4160392600587,8712
a749fe91-b474-4d99-947e-06b422156881,Healthcare,0.7720186089773088,26,8,526,1179,653,31.865054802498257,3443
6aa72945-2a3e-4cf7-afeb-9790dfd0d5fa,Healthcare,0.39479406413638074,27,26,405,1097,692,49.90834790754326,4846
1b03ef80-4b0d-4467-bfe5-fcdb83884b31,Healthcare,0.765444848228577,19,45,712,1348,636,59.49311298724368,9648
c18c6bb5-2393-4259-bbdf-18e922e27ca3,Healthcare,0.3426872805763119,34,48,18,1147,1129,80.15353669270607,4624
72abb1a9-7f63-4871-ac16-292bc4fc6fb6,Residental,0.5549985006538836,7,37,508,1279,771,53.55460339802142,6783
1b677d32-3b05-4ff5-959c-d3a7ec6e36e5,Healthcare,0.561051486031913,16,44,552,1237,685,18.945215294307708,4783
d15f0815-92bb-47be-9258-eaa7294af06f,Educational,0.67365832359207,25,17,470,1154,684,45.3835895617157,7678
93e7ee1d-a068-44f7-8aa5-3f4ef7e90033,Commercial,0.2266434662766269,25,6,472,617,145,78.26703104539617,3119
74e6bfeb-88de-4dbc-a9dd-b95bb73dc612,Healthcare,0.267936354540132,49,1,553,1289,736,41.31296112525706,3363
ef42394c-fcb1-4787-b383-b43ff313385b,Educational,0.774824826731762,8,18,117,172,55,81.3985452641645,6707
28b04490-8b57-423f-8d17-cd7bf22dde7f,Commercial,0.2019962262086138,14,40,378,1043,665,26.14626565948544,9618
36f99971-9f3f-495d-bc35-5001fca91bba,Commercial,0.3416599291547576,21,32,277,918,641,56.29894410672233,8565
e087773f-0763-4763-973a-568231ef9eea,Residental,0.44021834141252536,30,14,448,1281,833,21.624713498515952,7286
62245da3-afb4-415f-97be-059669e21886,Residental,0.5708268597622809,19,2,220,282,62,17.960415762628976,5470
1d9e19a6-12a5-4612-a4e2-a0c937c1025e,Residental,0.42748339585540085,5,20,157,955,798,77.26947648741908,2397
a2ba6597-0b1a-4273-b39e-a3f4b80c84c5,Educational,0.33514332462416907,20,42,500,1058,558,40.14253684588567,2774
95d14341-95ad-4c47-a3ca-e624b1a22109,Residental,0.2722640525720883,47,33,613,1105,492,61.72270007131867,8818
07d86ea2-a925-4bc6-954a-1fba0785369e,Commercial,0.5216851624114156,38,36,224,435,211,63.40223190760062,5968
89516a82-e695-4add-95d3-a51ef784f27a,Educational,0.44823529353108715,29,27,285,1010,725,81.61108119196052,4337
e91aefaa-4fa2-4f54-a7a2-8ad4c9def2f7,Healthcare,0.05855828887682746,16,13,179,662,483,26.67301303541919,6839
84949ddd-f608-42df-bd5e-d9a4d7e9fdfe,Commercial,0.139504913537987,26,6,97,1082,985,66.39856350616975,4294
be3d5512-a28e-4500-ab17-6f4195d210fd,Healthcare,0.9601630864192371,34,11,437,1002,565,56.71159789379426,2487
4c90c142-ad5b-4d33-9fc5-427e342ce0c6,Residental,0.5393224022809904,6,46,663,883,220,22.80225277707028,9444
368d831e-1eb4-480d-b106-e04a9f8d2478,Residental,0.5864957178968883,27,42,404,970,566,29.41054933261248,6149
6df17ec8-e994-405e-8caa-12f56e62f4ce,Educational,0.24485089178521469,8,25,376,964,588,61.71690269057978,2685
e10dfa9f-c988-4f76-9be3-5e5399740b45,Healthcare,0.646513738943271,18,28,18,23,5,13.499678970948565,8468
05be0700-96d4-4050-bf84-4631ebc724bd,Healthcare,0.995780451252543,20,36,244,1323,1079,11.365536120481309,7645
d3ee81e1-f735-431a-955f-efcc6268c608,Commercial,0.5246069240279699,42,2,539,951,412,13.709992966490969,8015
21351545-9015-418c-b7b1-d3d336c16507,Residental,0.6510339747909741,35,8,651,1379,728,67.29862175875262,6646
d83d65c5-5c21-4d59-9eea-ac4426522685,Healthcare,0.6931297290964469,27,37,147,985,838,32.12211540328712,1855
925b8355-7b2a-4899-b440-cc86f93d3789,Educational,0.5934482396173754,24,21,509,1413,904,49.00612857338006,4167
7f512637-e2a7-43b1-90d8-fd253abe0b1f,Educational,0.32618253891960103,15,50,548,961,413,20.11761659740953,2205
57d7b747-b04f-476f-b0ce-22e6723f225b,Educational,0.38087001843345747,13,8,219,1346,1127,26.40665286062085,5830
8c99df31-1f10-428c-a146-348328b09791,Residental,0.8015214589001384,12,30,476,1122,646,73.42033838026333,2752
b16312a9-37b7-4311-9f8d-620a4ed88a51,Commercial,0.834913068510496,19,3,647,1030,383,43.68802054474295,7714
07a01e02-9bb1-495e-8bbf-5db4ffa019ba,Educational,0.2958294584834791,12,21,274,1266,992,82.52650560638328,3750
baa8fcd7-a041-415f-a426-af885ee05e61,Educational,0.9975462120991847,34,29,392,1084,692,21.760417762024897,3953
b99010fb-c001-4f0d-adc8-bf515982011a,Commercial,0.7233825779491139,36,44,560,963,403,37.17316878306615,3383
74e6410f-cf03-4736-8eeb-cdfe103ef138,Educational,0.45493690947093757,4,40,573,1165,592,45.53985513256315,1477
c6cddae7-19ec-4936-9759-ce1b79835891,Educational,0.9009076733999493,31,23,247,621,374,56.97265352350269,5375
3707ee0f-7a52-423d-9372-6eb10b48e81b,Commercial,0.8800420747396894,13,6,553,676,123,49.3889724118727,6862
199f4998-1722-4eaa-9d3e-6b14e77c5e35,Educational,0.5126201072751828,48,45,29,1045,1016,40.70194787905466,4809
91ee1325-2b91-4b19-8baa-ef24f64fd768,Healthcare,0.34438574875014927,45,49,577,1305,728,96.50103373430387,8083
a6dffb48-af14-4f5c-a9e8-32e7c86aa8f5,Commercial,0.7175970276088298,47,49,86,333,247,13.7533184391447,6781
221a92fa-4add-4e9e-a6cf-cb316b7c95a9,Healthcare,0.06400480639540707,37,20,658,1218,560,21.40170106411706,5697
c29e0244-3b74-4f81-b64b-f5b8c095cbdb,Educational,0.31926184167583904,10,11,107,875,768,95.73161301068015,6973
d806c5b4-9e09-4e5c-9c67-35ed2ce26248,Residental,0.43774520608525413,6,23,536,1148,612,85.0960502348114,9845
a906b40a-0fbe-4590-9a42-cd8a32c9daed,Healthcare,0.8971749439552364,27,7,689,709,20,63.05506832017976,5062
4ac15262-9a32-49d4-8386-b69d0b753a67,Commercial,0.7886154468658012,46,10,564,570,6,15.294481419923036,9727
25671c76-474e-4356-b427-75da90a00c82,Healthcare,0.47511707561214256,40,12,188,683,495,22.026457600096624,2365
bb3e1db8-e53d-4114-ac80-761fd8083d94,Commercial,0.8418103957992328,12,26,676,1036,360,46.19716091530222,7799
0e3cacb4-bab0-4701-8b00-8494cfe364d7,Commercial,0.13450387320717117,2,46,619,1275,656,52.43575373210207,6843
05cbd9bc-d4f7-4396-b976-3ace342163d3,Educational,0.49607602705691767,26,27,38,1107,1069,99.21974672177281,7485
db056abb-8ff8-477c-b2ce-af76d868a2b0,Healthcare,0.9873020914518815,18,8,125,143,18,99.00916703199994,8270
64fd9f97-5083-4624-8f13-abd3288d1479,Residental,0.8935446142214832,30,5,414,501,87,77.61457645738642,4187
b24e5f91-8c61-427a-b1c6-4a894e1fc2cc,Commercial,0.5421897930156468,16,31,117,122,5,78.25425953834477,9759
51b686e1-da39-4585-ab24-0daa6044c12b,Commercial,0.1483279122956993,16,43,715,1268,553,68.32458285578451,7640
022a8446-13c1-4d74-b7f0-cb46a14c5404,Healthcare,0.7647235658733739,38,39,552,1172,620,26.348264243201985,8206
2b93a122-2788-45fd-94df-c7074b1bf464,Commercial,0.017497522088165907,45,44,640,1118,478,64.88528354926794,8343
9cf3a1a6-0a5b-4668-a7bc-2c5b44d2d244,Educational,0.09208332391712426,42,29,235,1258,1023,20.451947654934884,7101
98cf9240-46e0-418c-ab99-fefbbe3b60d3,Educational,0.6507777846527537,5,16,577,751,174,51.25031838036005,2663
3e53b8a6-22cd-49d5-97b2-84adabe094fe,Healthcare,0.7293656681357291,18,30,558,919,361,73.966619299315,6446
f404a281-bef0-405a-8258-4d403a8d122e,Healthcare,0.17779296441770898,50,6,49,315,266,96.6621651655706,7514
c77f3dfc-73ec-4076-9931-fd9b74a1cf13,Healthcare,0.3659116358946477,20,17,482,743,261,38.642858423590184,3934
85a9a947-8487-4372-9924-f676ddb52155,Educational,0.5038068000969821,8,45,431,1027,596,88.67935212612993,9717
9376a1fd-1ff6-44e8-972d-3348842cb638,Educational,0.9051806475789457,23,49,395,417,22,98.65827121901904,5770
b55e2c11-88b8-4e99-8ff9-706a15166f7d,Residental,0.6910070295573825,35,44,332,597,265,78.94835518516332,2256
30ecec7a-be79-4e4d-9221-929e85fe38c4,Educational,0.7934744306049712,38,12,345,1203,858,63.723942344249494,7033
39b1caae-0ffe-4518-b7d6-ba32924985be,Commercial,0.1417431189403653,24,8,575,1119,544,45.11815999154693,6004
a1addb57-37e1-411a-93d8-ef5e6fc418ed,Healthcare,0.3720984736998836,50,50,192,1139,947,72.49642607455887,5757
5c562a5d-15ea-4856-a478-b7f633f98267,Residental,0.9373289951046474,1,5,94,1025,931,53.270509265400015,9339
0e4166f6-e26f-4a66-95b6-7c603ba6b9ae,Residental,0.9506372303150142,18,3,458,593,135,63.10780372105519,4533
346238bc-56d1-4d8a-8f81-12ed7bfa0f2a,Educational,0.1217196135474764,40,38,240,874,634,14.441339714877145,5629
4ae0c74c-acbd-441a-b6c9-b3c060a9a804,Healthcare,0.25127687452895264,12,18,468,905,437,15.398491295529281,9649
8cf7596e-025d-4fe4-b87a-2a3513e26b84,Healthcare,0.042143298279206376,32,41,425,1248,823,89.04642247700266,7019
959ee888-1663-4846-bc64-61e727e4d838,Residental,0.2712129983663435,42,21,272,1281,1009,12.484522839008344,4643
c8a0a248-499a-46c4-bd14-b62cdcca5f0b,Educational,0.6961974164427862,23,40,587,780,193,65.68390846720666,1495
7bdfc4ae-70eb-4d76-823a-c68aeb079860,Educational,0.10225393610060707,36,8,408,1413,1005,35.14461814869773,8103
ce407707-2f72-41fc-b6eb-bb9682a408dc,Healthcare,0.04981056365069991,39,41,57,197,140,24.941443116622523,4279
808b1428-caa7-4a87-a93b-27085653d703,Commercial,0.39048204758824645,9,32,15,1181,1166,44.12054899257687,2246
853fce90-23af-420a-927a-e93d635031e0,Residental,0.7133022314207782,43,7,255,758,503,14.102298610428859,3818
d121d703-8a43-4a25-801e-4cd830023911,Commercial,0.15029394562585252,18,18,690,978,288,16.7744150083858,5884
8dc64ee3-1708-476b-9034-f94401541f96,Residental,0.6726144722057132,47,47,259,507,248,79.3305674978647,1860
6df24929-24f1-4cf0-bf18-9d7cc9580aed,Educational,0.8597965996545117,50,35,709,776,67,72.72178939553623,2144
5ac97864-ee02-497d-97cb-2810dbc3126d,Healthcare,0.8337141631819813,35,47,622,1413,791,57.332371803966986,1866
aca267c0-2630-4b05-ac80-8769eb6093a2,Residental,0.6031214916783717,43,26,408,502,94,31.2006674718867,5233
0fadbba3-2585-4ffb-9e1e-3cbd6b28de01,Commercial,0.9707287247305947,17,40,38,502,464,65.13640965766461,3044
5c0f21c1-0d0e-4de7-92d9-3d0a92c45d2a,Educational,0.44243923915265515,32,12,720,1365,645,40.451605179565604,4048
5489b8a6-1ae3-47ed-bf80-0bb99153bdf3,Residental,0.2242933309763907,31,29,336,792,456,57.84849410876033,1429
e55d1f1b-4128-41f6-ab8a-715e7106a2c3,Educational,0.5945795238483923,30,33,326,1165,839,24.164588309070165,1159
bcd1a93e-362b-4fbd-abb3-b6489010aea0,Commercial,0.41082455825594766,37,39,394,585,191,54.67614530568667,9901
777a6004-806b-40c5-bdc7-ac7dec69fabf,Educational,0.7590752104268809,46,27,300,891,591,29.26363119302998,6236
f4010adf-878b-4a91-9345-d22aa2a44400,Healthcare,0.01677146190321588,44,30,371,943,572,51.16814755015138,5560
43c70245-e5a7-47e5-a880-7871797beeef,Commercial,0.5871875074953662,48,47,246,791,545,86.59905675239064,6673
90f41dcf-ebc8-4d12-9305-91750003150b,Educational,0.5018225359748874,3,30,19,340,321,24.219445170382052,4603
4bbd7e7f-f514-402f-bbca-757577c2ec13,Residental,0.2720687290335969,48,47,384,1322,938,61.32728380754602,6750
030c7bad-cc89-4ef4-a197-5765f98900ae,Residental,0.8866637217114531,30,44,253,1308,1055,98.55315780772494,6706
e79a0c6e-fdae-40f6-bce3-198d1b6f62cf,Commercial,0.28531080347760274,14,4,612,1437,825,79.03096115852811,2998
7718b7a0-8903-4ff3-9d12-d4ef0d8bd9c5,Residental,0.9628236618104802,15,32,671,907,236,36.664803058395975,3189
6d9c40f6-e61d-49c0-be63-0a9a43ef7057,Residental,0.6431329842297521,19,9,337,482,145,46.14761398100504,6505
23ccd69c-d262-4388-b927-b7506e66f7f0,Commercial,0.08293239908934325,29,43,614,1272,658,92.95819400507641,8089
2b22c5ca-143e-42df-b4cd-cde4adfd5793,Commercial,0.837001069458967,36,40,413,507,94,58.70052330256252,1747
ad891e76-8d72-4837-aa90-420355660ba3,Healthcare,0.8236759705128011,9,40,51,704,653,16.41559448546972,9761
107b3994-3d86-48fa-89ba-54529ff8e913,Healthcare,0.5626129531047785,19,49,384,495,111,33.63975208676838,4649
75a23d40-d1e5-44f5-85cc-fae50afbe916,Commercial,0.14285090162581904,14,46,279,687,408,68.08648915816154,9208
f1665524-7926-4b87-9290-6ab6e444ad54,Healthcare,0.8468031347524823,21,24,252,894,642,57.303968912698544,6675
62f4441b-380b-4799-9178-19957208b839,Educational,0.2654433227860823,32,5,158,215,57,46.28614592743153,2027
a096fcc7-84ce-48f2-bcc5-2157d201f469,Commercial,0.6199242890366249,39,34,46,868,822,47.889438544208765,8406
0fd0e073-8ca3-491d-971f-ec4f41e3f32e,Commercial,0.06837866569959361,38,38,574,997,423,82.505771541256,6449
add7a227-35e6-42ed-b8f7-4151cc656709,Healthcare,0.4001626650006246,15,10,10,984,974,39.301312822104435,2908
86b6ad35-013d-4897-b3f9-936e86ce4b62,Commercial,0.604865074488318,22,44,390,1334,944,48.04629811593379,6611
0a55119f-62a1-4510-9f7b-82532c62c81b,Healthcare,0.5961707023021444,43,32,55,877,822,74.16572054729717,1551
99b07675-549e-4a31-a32e-673bdf0e8e3a,Educational,0.4503598183596421,47,38,13,1316,1303,85.80752267109467,5388
299528f2-10f8-486f-99ae-2d0cd1f3ea84,Residental,0.03155254488239101,17,30,536,1077,541,42.79070226810654,4543
5901cecb-5480-4ac9-9587-29264cead8e3,Commercial,0.745472305649231,44,27,211,641,430,40.93898843436717,4677
c878a2e9-1574-449f-9f86-a53da67e3085,Healthcare,0.5121989146689178,43,43,169,577,408,48.74107195712062,4804
6f1a0575-6d89-4c03-9792-914a34a36c7f,Healthcare,0.1611913102968684,46,29,442,658,216,48.33200562837685,6966
e89194e1-01a5-44d4-93ea-802380cd88a0,Commercial,0.3178199242619998,49,25,48,683,635,22.956753115833312,7508
cd851944-6554-4388-89bf-b6dd51a7e9ef,Healthcare,0.7306889010857235,17,50,158,529,371,68.4202644869782,3959
39cca5a4-acc2-45b6-964c-066a49a42350,Educational,0.8298277912670309,15,24,552,1340,788,60.544430463997635,5146
172f0139-41ac-4f73-9833-33de60c96f14,Residental,0.580500593534011,23,12,570,583,13,70.63894156048195,8390
011f2f9a-02a5-413c-abc9-1b4f790455af,Commercial,0.3881863316409563,27,22,70,97,27,11.353291023931554,7499
65e7b3f0-1375-4b3e-8ee0-9d130c692ddd,Educational,0.21898285862843114,13,16,312,936,624,41.13886267061067,3448
da486751-8879-41ad-9370-801fc0f22387,Educational,0.9849417345534881,3,27,366,1299,933,85.16653134241301,6652
6a5ecc50-1555-4329-ab6b-1b2ebfa9abd5,Educational,0.5156435007953233,42,45,580,1213,633,29.04488241921311,6296
0e256da0-2102-400d-ad3a-61aef90522d0,Healthcare,0.6666666677063204,45,19,157,577,420,83.9151051480567,1555
7db2e423-3aea-41be-b270-8fef367e3f34,Residental,0.9346517416157144,14,31,638,1383,745,16.009364145005236,3014
8c27c43f-5724-451c-b673-ecdcc26aeda7,Healthcare,0.36751541796581955,41,8,329,1126,797,56.2513101697777,2205
da99f590-7d79-40cd-a057-e8262acef2a8,Residental,0.4212734998502916,10,26,73,684,611,55.418323165237084,1782
401d6f4e-04b0-42ea-8956-4442be4a67a8,Healthcare,0.35260960749757253,18,19,667,731,64,52.50782683260768,9785
82d648a4-2b71-4267-8a68-767734212209,Healthcare,0.9689831858117516,10,42,419,601,182,22.84235855556396,6003
d0a613ad-7f95-406c-bad2-587a40750ae0,Commercial,0.6778965676715455,19,48,140,543,403,20.251493712832648,7474
f2feb7ce-8d78-419f-b892-0fd7b79569e2,Educational,0.7264528917996969,22,40,301,315,14,85.6613572036644,6622
1f076344-92ba-4edb-a11e-646ae389dc9e,Residental,0.32853826016351984,12,15,110,1085,975,47.94875203185773,5350
1271fd5a-0f11-47d0-9924-d88443bfdbf9,Residental,0.4299702873654151,31,33,688,1159,471,29.088677945781352,4349
074766b7-ad38-4fbe-a940-0dd2f2aa94a2,Commercial,0.8818242087181394,35,48,431,918,487,57.11751724246489,4060
ddedb852-61f7-4d06-876b-44d69c30d3b2,Healthcare,0.6726930698575838,35,4,229,679,450,42.49657521970669,4227
aec9c15e-705c-42d3-a426-5e61c813d97e,Residental,0.05152828621948413,3,48,311,779,468,60.07509478477731,7629
afc36d7d-1332-47d4-ac8e-b1035be0f970,Residental,0.9697694162909293,22,38,182,513,331,44.13905306073272,2086
059f3dbb-5edf-4510-84e3-181c8c991963,Educational,0.8700543560983588,29,46,627,947,320,92.71129724497408,4977
c209a9b8-1836-4b07-ac70-db55be325bbe,Residental,0.19791834189791568,23,20,2,12,10,82.36698481790148,7551
3663706f-48c6-4ea3-800b-1bdad91cb0b4,Healthcare,0.544280770822157,24,46,217,1196,979,11.108809722386916,8093
e9ec2da1-4528-4ca7-bfd1-3abe7b7d987e,Healthcare,0.7350231525817148,15,28,708,1221,513,68.10430219059947,6639
cac3f120-a69f-45d9-b3b9-62469564acd9,Educational,0.3212091533320638,23,31,645,1121,476,80.62129623244324,3497
5af4e010-9d85-4208-84ef-bd9cc50030a5,Educational,0.3970876964134811,18,38,658,753,95,78.54106734265608,2326
3b829ddd-2838-4c27-a902-9469c6d0ea7e,Residental,0.6368486871215578,46,39,537,1164,627,55.540901772548274,1650
1a4b9e82-7c6d-4acf-aace-9506a03a6f73,Healthcare,0.9270331138810203,49,38,490,1204,714,36.43097904566333,9103
937c1955-b4ab-4595-ae93-bc4a31d5d04b,Educational,0.06384586436545359,22,31,10,738,728,77.31463397976006,2417
4d1ab31c-9c1f-4514-bc4a-862182f3ef9c,Residental,0.21967389890152456,50,5,629,900,271,54.313513644791875,6738
64f76ff0-1d36-40a4-948c-6af477a4f444,Commercial,0.4277476750567889,38,3,266,1275,1009,99.60378269014663,8920
bc554070-58d5-4cf0-987e-70fe98b2ae62,Educational,0.19650017692706478,9,30,30,872,842,10.752865892113002,8713
b49e8403-d67e-4825-9831-9cf57ab9c6ee,Healthcare,0.622019686159274,43,31,368,984,616,95.05962485117998,9821
c0bf6450-3003-4512-9bac-9d4f50928460,Commercial,0.5539381255887169,40,41,357,1291,934,21.73282708501938,3564
12261a5e-3271-4b2b-9c26-6e0fa724fa61,Healthcare,0.8776170257098447,40,22,401,853,452,12.320409114943514,7197
2f92b887-b55c-43f3-8434-7d08f3ee0d91,Commercial,0.2568450389632615,5,30,492,640,148,44.147652372160884,3763
65998e07-ad3c-448c-b3e6-07bc6e9d0622,Residental,0.8748110832758536,27,6,563,891,328,58.74953655731566,5251
4779841b-d88b-4b95-a512-e9a96ae07709,Educational,0.5628474098954435,23,46,607,623,16,60.77435431796331,7717
afc3123f-f6c3-41d7-bc6a-7c502cc6d326,Educational,0.9311668153212533,40,13,298,875,577,90.7510917831156,9244
0ac1e5cf-a3f3-4acd-bd29-0d0a01bcf893,Healthcare,0.040603204011439575,35,42,535,1391,856,28.270109689367416,5330
3913ad75-eedb-4933-b454-ccc96a2af947,Residental,0.9873376641782297,2,43,221,832,611,42.96641013918934,3647
d90bbe78-4bd6-4150-9f6e-43bfc8e9cf59,Healthcare,0.35807568548231217,29,34,111,586,475,87.65763108501413,2316
129f761a-38e0-47ca-80fb-f5203aa1e2ef,Residental,0.9572839934843355,24,15,537,662,125,48.911996633616155,3868
21ae4cf1-25a7-4371-a71d-50bb970b40cd,Commercial,0.5279217012260997,39,21,429,1153,724,95.10540080831468,5652
e98c6c9d-74fe-4ce0-972d-0509e6a480ad,Commercial,0.6951748943894689,7,14,20,301,281,27.759447277506958,7732
16ba42ac-4326-49db-bdbf-287fa2075795,Educational,0.017157269161446775,13,38,158,726,568,86.59307902778374,2191
a684a97f-50c1-4c07-90cc-89a12a20cc98,Healthcare,0.5434349950674642,47,46,566,1250,684,48.605583391278046,4110
ae4e1f70-986d-4fee-aab0-d8ab9c896bfc,Commercial,0.31947366244249686,38,9,63,875,812,55.50063651152527,8633
b21d1d93-5d93-47dc-a0ab-1e6c495b6f18,Healthcare,0.7807349800358994,42,19,128,1279,1151,88.64958017680722,6603
dd251e20-160a-4ea8-90a4-bf74ca0ba643,Residental,0.6799210333097039,39,40,274,910,636,66.64056807822895,3899
1b87321c-8539-46f2-a22f-e4db0f9872d5,Residental,0.366891737887056,7,47,707,1316,609,84.22022894361093,3832
42535de8-171d-4147-9146-02e4c4bca995,Educational,0.8774951305033382,20,42,700,974,274,29.817309780731847,6043
01d0d7fc-5cc1-492f-bfd4-8fe94ba673ce,Healthcare,0.22722628884696627,34,32,370,968,598,25.30555032249776,4042
78104050-97d1-4356-b99a-85a80860c47f,Residental,0.7482720832425048,7,3,438,759,321,94.61946589581102,4734
97aa2e36-911d-4579-8958-a9fcc8c69f23,Healthcare,0.8401034922166721,11,14,526,949,423,81.41200686428706,2916
0f47a2bc-2570-4206-b1c6-162e4dbc824c,Educational,0.3605868076286366,29,32,213,614,401,15.501083711141986,6836
08a6489f-c1d6-46e9-b9dc-58cc9552a9dd,Healthcare,0.9342229004786001,12,20,642,1012,370,39.87167000411355,1310
b5b3cba7-114e-4652-8ebd-7ac4a9607a70,Residental,0.4608645057342178,9,46,138,758,620,88.6452893873445,2297
3327a952-9d80-4b0b-9581-c9ea3f0491ee,Educational,0.9319193305165627,31,38,243,1014,771,25.34084111434784,7849
930151f1-847d-4e26-ae7b-04ee9445e3db,Commercial,0.9034415182942517,47,6,667,1145,478,14.631551713305875,9152
c61e3ec6-db2d-44f7-9e0c-af40d438f304,Educational,0.7622763459403855,27,14,696,762,66,98.91113961212149,3252
17db119b-b82a-4aea-b5e4-3e96ca1db32a,Healthcare,0.23326592731202234,18,10,644,676,32,88.94698439941952,4360
31cc4909-a550-4628-9716-afc4c2dd8d15,Commercial,0.45663744089922,45,45,707,766,59,32.487223502908826,9516
ece27001-efb9-494f-9149-f1a3a0b5792b,Educational,0.221778077000498,33,27,689,1095,406,43.80865924531701,6764
96b4f43f-b58c-495d-90e9-1f5d2a1ce291,Residental,0.8826297110574718,20,1,452,946,494,50.459753425716784,9140
76257422-96ec-4aa7-aa89-5713c502fc38,Educational,0.4440013864741472,13,30,114,1409,1295,21.89855724356717,8177
d43e082c-bc25-4d0b-8efd-c9590704ceef,Educational,0.3955507144474911,27,6,271,1116,845,39.34502673952089,9153
81953619-ec71-4af6-828a-a99c89bffd5f,Commercial,0.4293703666532708,37,27,211,1396,1185,11.866656690924543,4362
5674f6b4-4f4a-43c9-b66e-593d4d08bf48,Residental,0.8394556466808383,4,44,67,730,663,16.989079805403307,4678
c25ca075-2fc5-47ef-91e0-2341ce5396b7,Commercial,0.2417145555407405,34,32,584,1349,765,26.588054181239052,6769
bf2454f5-4f0c-4e76-a3bd-8205b066ea6a,Educational,0.5138612625903598,23,12,319,834,515,66.87316805045134,4185
1b2f7d36-7e3b-4de8-8096-558cca369da6,Residental,0.06171400410951722,50,8,308,1394,1086,53.32652142259531,9158
1799cce6-d86c-4e81-959f-230ace0d6a3b,Commercial,0.003047810600135703,35,10,176,1336,1160,10.58689119014765,8769
47578793-2128-43d7-b692-4b648b5f901e,Residental,0.43774606338925093,4,50,58,347,289,97.65526677937261,4216
616ef4bc-88d1-4e30-9f9e-9521b058c496,Residental,0.41468058818193265,25,48,437,517,80,80.52257676403394,1503
dfc68939-9183-4db8-9d64-0cc66450a3f2,Residental,0.8694325248477337,22,11,243,781,538,96.72552939355255,4818
d00be9e9-4e7b-412b-9be3-e3671998d233,Residental,0.5146066330020892,47,12,17,731,714,29.952105469544314,1228
70a7bcbf-e116-43b2-9757-1df024ee9d32,Educational,0.866288253044286,46,16,297,555,258,19.7237516192353,2114
642f7ffb-7b6e-4c00-a5de-f3cb183abfe0,Commercial,0.6688890987660846,11,48,90,164,74,44.79684792577487,1906
91627276-6c8d-42e0-8696-418364de6b77,Residental,0.5836481622660666,9,33,241,383,142,34.08312543975542,2002
50845f27-6d1e-4c20-ba34-726259c848e6,Healthcare,0.4322324821980569,36,31,360,1304,944,11.153985950325772,9770
a95eead4-e2e1-4547-b6aa-d57509c40fd4,Healthcare,0.5154004763242536,5,15,427,1029,602,42.02545913179188,2068
ee001112-bcfd-4222-95bd-bda245b546ae,Commercial,0.10339791016948752,35,16,125,844,719,44.063888304190755,5538
7c67afa8-9869-4ee1-8293-61cd4a33a156,Educational,0.10953446688700175,46,9,506,653,147,17.3916190537757,2155
a24b7026-1e0a-4c70-9659-2f38ee887adb,Residental,0.6088453508712525,40,10,414,787,373,64.51966608698886,9232
7492c068-6a7b-4e1a-8c51-676403d3b5ff,Commercial,0.9645811131551323,29,47,100,730,630,69.55360284910071,5617
ddb25c55-78ba-4217-9b72-4b759b4eaf25,Healthcare,0.9599162371782064,47,48,205,523,318,57.689736726075935,7778
8c8f7e91-3ead-4a61-8d69-33597312d49b,Residental,0.9249544171018098,18,31,58,653,595,48.68468068330782,5505
737eca38-4950-4e6d-aa7b-dc0eddb31c4a,Residental,0.9672012185473107,22,7,372,1291,919,74.51022763381766,5769
4fab7e7a-44a1-43a9-a9e5-d2cd9dde35c9,Educational,0.02147931147790305,14,24,334,702,368,45.68792995612305,2288
ec023d3d-7298-4a08-a3b4-ca89fe6b7e00,Residental,0.4902772344603019,48,41,70,397,327,89.36604088585482,2220
5baa9872-c6b1-4a07-89b4-ca5155b8b797,Commercial,0.9834239535236555,17,25,618,1266,648,24.97829638343313,6780
6132dab7-d080-43f4-a486-babc51d020e5,Residental,0.9681795073502931,32,43,431,741,310,66.06388299769185,1744
e818816a-9d08-4ac4-812e-6804defc6fa6,Commercial,0.5414253996834701,41,40,509,1163,654,87.12605884682199,1518
e44f6d5d-341c-4da9-bcc5-94d2725df4d3,Residental,0.40614297359620144,1,35,537,710,173,96.36955441166936,1574
8ae9ef9e-d88a-44ec-90de-522abe182f7c,Educational,0.17346412353069507,2,31,644,1410,766,71.75009954239994,6922
f3210fd4-9ee7-4625-bcb7-c6f91c26369f,Healthcare,0.47231956973592737,37,20,281,389,108,72.52255494535524,4774
20760ad0-acf5-4eec-b212-a09cc7720ef2,Educational,0.46115575769369144,48,31,144,836,692,81.63004183643186,2342
56f06b08-8c29-427d-8c0b-b709dd942ee7,Commercial,0.029401417607909375,5,9,516,906,390,10.558463720062846,5797
697eeb2f-374c-44a8-b138-3cefb085ae95,Commercial,0.6991007996440138,36,25,376,456,80,48.55161540900776,5748
3f4515c5-a5e6-4226-b67e-45987cfa7a73,Educational,0.8662491119792814,6,16,48,1291,1243,52.99025373799861,8374
7fcc4c6c-048c-4055-bf6b-979eb882bb17,Healthcare,0.3932431589450571,13,7,688,1379,691,10.624399394907508,4221
bf513bda-e199-4f8e-b779-edca7d3137d6,Educational,0.48801435518391034,34,26,401,861,460,83.66939414917034,8320
dbc4027d-668b-4415-ba0e-5ccbd1268da7,Healthcare,0.7319362071112163,6,24,609,623,14,77.96728113257056,2889
e58ad613-135a-4ad1-8f9b-08f2ccc8a364,Commercial,0.8523045840649327,30,40,384,1033,649,57.07342538490037,5220
172d37ce-39d0-4865-a3b4-0506b84cd441,Healthcare,0.4459071413477106,3,7,395,447,52,55.112468348060744,2455
d7945ce3-f61c-44c1-8462-1a0299816f6a,Healthcare,0.5845769166931097,35,43,578,1422,844,24.218193869931106,3482
b63deeef-b0f3-4ec9-82a1-774a4a9a8d57,Commercial,0.1580225262409768,24,36,134,758,624,49.181816028165336,4588
890fa797-8ef5-48c0-a0ff-ff9078d77a58,Commercial,0.5800870648230969,46,21,268,873,605,59.47156144834936,4531
7602c094-af35-454d-b781-6771bf3e76b0,Commercial,0.3298195800802334,46,11,264,952,688,90.71463166046397,4397
a9b1aed9-580b-4bbc-8b7d-2f5aaf0bfbbe,Educational,0.6302390052064881,14,44,336,1273,937,44.66586837458745,5323
aaa6c28f-f623-4c2a-a79b-ef6ea9ecf536,Educational,0.36710416074307906,29,18,11,1105,1094,93.18660020921092,1399
2985be4e-6d24-470d-a7fe-a8b738db378f,Residental,0.7578862096296355,36,12,661,1425,764,37.1450232458798,9925
d1623b65-4d22-41ea-a7a8-9b222410996b,Residental,0.7721316044592569,1,29,363,586,223,70.73360707102914,3911
8557799d-fab4-47b0-874e-135493fbdffe,Educational,0.6411988305869067,22,2,38,1173,1135,59.763035320998064,4158
da66c6fa-70ef-4704-b534-48365ea99221,Residental,0.006885481998749277,36,25,412,1399,987,73.84313370830827,3397
59b8d8fc-e88b-4d1c-adb9-b1c9e3417bfa,Residental,0.6210505296281391,40,41,545,983,438,35.84608192611576,3128
8ebc48b8-e7fa-4316-beac-8fbdc4d433e4,Educational,0.9988714375723656,21,48,290,1027,737,61.808260075310294,7509
94038c95-e819-4ac6-99e1-0f48443f543e,Residental,0.3771772347967034,46,12,100,1345,1245,82.04554221793765,2411
e26a1cfa-980a-45d8-9f45-91b8f091548f,Healthcare,0.26328661510189144,6,49,22,398,376,23.385815884677935,2402
f2ba2fe6-a949-45e8-90bb-04c8ca7471ae,Commercial,0.6445638103169297,37,6,446,537,91,42.48278028703652,7604
ed86812c-8035-4fef-9554-438f9643d2de,Educational,0.3243328446468936,25,44,585,669,84,48.343297681762884,4203
1e650f63-45fe-4d5b-8538-a4d404e57752,Healthcare,0.43182001370382594,37,35,630,716,86,81.78908386933918,6143
5b28cbee-a64e-4907-942a-7dc72b54f474,Commercial,0.5352813024059803,38,26,493,761,268,19.336381308865903,3899
5664e655-4e73-464b-af30-642c06df9104,Commercial,0.8431781522857199,40,22,100,911,811,59.049214703800224,4874
2615cbba-9938-42ec-bdca-b5e36c1c3654,Healthcare,0.8577315498208044,42,8,326,1370,1044,62.05635750483605,5123
a791c69b-b1bc-4bd7-afc4-975d4cb9d3dc,Educational,0.7624542183639247,33,25,656,1021,365,25.919993780705127,1140
a93d4f7f-9217-484c-800c-24ef35a19dc9,Educational,0.2317945184671102,2,44,597,1310,713,26.509461171723938,4784
0877d933-6c10-4ed8-bb40-38a67acceefb,Healthcare,0.18240744934560882,25,22,237,342,105,59.84599209327658,9168
b53e27d0-c23d-4672-913e-6221c43eda37,Educational,0.48037403117908184,44,12,574,971,397,84.7695971114978,5920
3e948055-a87e-4d7d-b04b-f75729a555c4,Residental,0.736058180414287,42,13,144,401,257,17.500610832485087,7911
b6a1a1fb-ee84-474d-97c1-d33aa9d82749,Educational,0.20763297144763415,19,37,422,710,288,10.934906568071916,5594
30a08215-e65e-41d4-99c7-27f0b95ebbb0,Healthcare,0.42730859517690445,24,50,61,1205,1144,36.02114925938235,3310
4bb12eb4-2a1a-43da-b0a3-5901e0ef3d5a,Commercial,0.502528426637991,36,39,580,1201,621,79.23882884579957,8848
c32a3780-d1dd-4a2a-9088-918deb8ecd3d,Healthcare,0.8339495901367743,19,26,653,852,199,48.969982869502786,1492
af6f083b-bb49-43e8-a8f5-e7fc60c8877f,Residental,0.4113729541080896,39,13,439,975,536,85.80519645040408,1847
6b66fe42-632b-4d35-8b13-60c9948cfab3,Healthcare,0.058443655755636814,18,17,604,956,352,51.08767925446066,7347
00173ff7-2b52-457c-befc-7429878e4cdf,Commercial,0.411970755930805,23,48,109,337,228,90.21674669987782,3899
a997b490-aac5-4a99-983c-112f7e15cfba,Educational,0.22083758756832061,10,8,14,1120,1106,93.66248740082497,5758
fa8dade5-4807-43ec-91c3-ec997a254397,Commercial,0.7166289580479998,17,3,618,957,339,86.33860502993289,8657
97b2218b-cae7-4955-8ea6-43ab59f35e1a,Educational,0.6036389715486075,25,12,656,1073,417,65.14217307030981,7596
f55a5739-7bec-4e2c-a0ff-3a89e40e94b7,Healthcare,0.8343357586797382,43,34,253,797,544,24.37961713679595,5639
224bdaa4-109d-4bc0-8ed3-aa5103c6d3f2,Educational,0.30213109046509623,50,40,58,61,3,45.693083774551134,7892
b778e73d-d317-4fd0-9b7e-3ab3d86a08e2,Residental,0.5987557581470224,7,34,105,488,383,16.624098765887798,9347
10b9a378-66d7-4df9-9b1a-f7b1089bd9e1,Educational,0.4995983564573242,28,10,69,336,267,90.27726529395962,9322
51603ed0-30f6-4a2f-accb-3cc55b3028be,Educational,0.6833962380404597,16,41,211,783,572,99.16182599102676,4365
8f2eb573-504f-40c4-9982-5af1144a7fc4,Healthcare,0.0026948778497117853,49,47,644,823,179,16.71215479710898,2825
185ae31c-ddae-489b-a478-d8679c4bee0a,Educational,0.9235427442949676,18,10,547,1166,619,53.041633017695915,4563
a256ca50-d47b-435e-a149-fdc5c34430dd,Residental,0.11697543871173222,7,14,134,378,244,15.755730533976024,3356
c11af702-27ee-4e88-a2c5-85c6f3c2ab79,Residental,0.9775029819433845,45,7,62,737,675,14.565680661738533,5440
87030546-5e59-47b0-b225-b2f0b71d9065,Residental,0.43068968993133006,16,1,228,1423,1195,57.275715499326644,6217
01cd8ab8-ed95-4e94-8375-aa2e9a36e64c,Educational,0.4501301437794335,28,29,628,924,296,85.9142432909051,7680
56ba1fb8-da7d-458e-b145-be8cc6cb36ee,Residental,0.34209069048144514,36,26,399,1207,808,39.04256309002109,6135
58f6276a-cf0a-4c97-8d26-ac8a837e8a54,Commercial,0.8878315887982074,18,29,30,791,761,34.541681143780536,3213
0b17b821-f888-4d39-8f2e-53b419c5fbd1,Residental,0.31468810624036525,7,50,445,1220,775,14.66014019077728,7340
6ae7cf6c-af0e-4dda-a2fe-af49d6e2e18c,Healthcare,0.6292002912258248,6,29,295,498,203,33.762706957725115,1994
6c51488d-ab31-4457-9380-f2ce61c47132,Educational,0.6157963999156628,9,7,661,1349,688,73.95265548448171,8826
15c35d30-4bdd-423e-8523-940d5eaf9b4e,Educational,0.578927196361297,12,49,634,1192,558,13.921049068746724,8590
de5e95d6-1c92-454c-aab8-2c87940f0092,Healthcare,0.2875954570210698,27,47,402,959,557,36.215916649611685,5379
adedbbe4-f811-42d3-8857-d33b54320f54,Healthcare,0.4684768105176921,12,36,531,953,422,63.49406397960391,9008
046a59b0-c510-42d3-ba97-517f01b11912,Residental,0.8847571525501121,8,36,184,405,221,79.37818287451788,8107
da5e0dfe-1a7d-430e-882e-b1525d2e24c3,Healthcare,0.9603910947407971,43,50,574,1366,792,18.642367677340822,3724
315be0c3-9d29-4665-b975-ee20c5e1f44a,Commercial,0.3429631331852737,22,36,225,751,526,20.77750418817047,5712
1be1e458-030d-46e8-8680-c088a5f122c9,Healthcare,0.8120390689620579,16,20,279,331,52,31.529077198751846,2246
8304ed1c-17a2-4503-b3b4-a313cae6e250,Commercial,0.12451342443026447,38,12,24,1346,1322,13.652788560661474,8423
f166ed30-f2c6-4784-9757-553442839804,Commercial,0.6679310051803623,10,44,204,889,685,77.78481924693745,2313
d5792c48-b772-4b76-8268-d06ec9ddabcd,Commercial,0.7829934426015649,40,13,6,1227,1221,20.507091389034947,2906
3a7df168-8ae2-41e0-9c04-8d1055966f37,Residental,0.20160492055046186,26,16,608,1039,431,92.44274471734575,5229
de731d17-1e42-4ab2-b493-aa335cf3b636,Healthcare,0.05942740129152835,47,26,215,1409,1194,10.041680145252577,6479
db4cc5b3-4c15-4041-a417-b69d22b92c6b,Healthcare,0.8807038454430293,4,23,372,925,553,25.268522299282708,7704
8570ad41-3765-4efe-bcef-ed1f22ddb549,Educational,0.7371195422991437,23,37,143,991,848,36.01598356497411,7414
25baccdd-d7b5-4aa2-8eaa-b50e616f9516,Residental,0.7532563640942073,1,50,95,930,835,81.04257221633442,8728
668948e8-65ff-4409-af3f-dad7a48d425e,Educational,0.6926056384470961,19,17,174,306,132,71.2307896812467,6608
fc97b38e-65f5-4cb3-afcd-a01065253036,Healthcare,0.8772892911846211,41,15,572,635,63,37.22542473787769,4148
6d02e251-e807-46db-b1ee-2fa71494647f,Commercial,0.45432229313846384,26,41,684,1419,735,71.37094237451697,2951
d5176d57-d58a-4acd-a70a-77fbd0b7e577,Residental,0.6580167407350174,6,35,576,703,127,19.313888501838473,9175
33a7248d-d451-44b2-8ea6-a96b06c56c8d,Residental,0.09020335608105035,10,23,272,1367,1095,16.653555374004394,9290
4928cf18-8bf2-4596-bb04-c39d9341a782,Healthcare,0.7897067900594512,38,36,183,334,151,21.380389279869622,3795
6e610b85-8c89-4229-8407-16542346a955,Commercial,0.8976606388291652,4,2,476,958,482,90.35513727256918,8170
953acd84-389f-4745-9e70-85079085e612,Healthcare,0.9642190350621189,36,30,69,1054,985,36.67374465708302,5002
b9135653-c785-4dda-a522-6b24dd9f390e,Residental,0.7990402343972138,12,46,124,1116,992,45.99264069900988,1280
870db2b7-ad90-4917-8899-90bd97839470,Healthcare,0.630302075857232,14,11,387,1080,693,18.676453264929933,6522
1c999bcc-bd7a-41bd-9ba7-b3a04485462f,Educational,0.7846942515537503,4,21,550,1324,774,19.418989510863597,4678
c4212b33-b63b-4a23-aabc-aa05cb33b1aa,Residental,0.39536078903131155,12,43,71,538,467,55.92313656221936,2896
5399acfe-a1b4-42a0-9bfd-e326e3297f12,Educational,0.9212165364477258,40,14,515,666,151,19.421985604835903,2760
4038a7cf-d7c8-41be-83a8-a9c50f2b444d,Educational,0.3839881371089836,35,24,640,720,80,69.54148271966969,2386
c7e56904-26d4-40c2-82d9-40285f5f24c9,Residental,0.7092913592485529,3,22,456,948,492,97.66649817494158,4105
1fdb482a-147d-4204-be4b-aec96e2bc142,Educational,0.008323756736442589,44,32,670,1287,617,94.35557661646469,7048
32567952-dcc8-4e25-a7ce-3c17e68ce50c,Educational,0.03166236551859358,5,16,490,867,377,41.61042387403468,6788
3c8489c6-14a9-4a0c-abf0-444809066abd,Educational,0.8530406775070706,30,35,29,1081,1052,95.60208715102657,6192
9e4fe771-34ca-404d-8b68-dd921a58e32c,Healthcare,0.5461909027651101,37,37,616,1350,734,27.279224389391366,5231
8b176a04-afe6-48d3-9272-82771d191321,Healthcare,0.10993478723226724,28,21,522,668,146,52.009787377814035,3384
46aea292-7eb3-41e2-8903-e5790bc88334,Educational,0.5335286940599342,18,42,124,1382,1258,10.24858535908446,6481
e2b6f57b-39f5-4f20-99c4-f6501bff217e,Residental,0.47778441623520973,35,13,88,406,318,94.00978688294295,4502
056f704e-2d88-4769-9e36-477df399bf10,Healthcare,0.2460786415431413,40,6,53,827,774,83.62863754067527,3103
0e8caf13-e87e-45bd-b84d-f5996a0caac3,Educational,0.16303728741489631,42,4,335,1361,1026,63.549116890354135,7325
773bd3ab-90ec-4046-b7d1-0a93cdc6de8b,Healthcare,0.24681183787336003,32,27,250,1176,926,97.2060434345368,6644
1012cafe-87b3-46e9-b5d6-89eb5068b0ce,Commercial,0.9625938504053974,27,16,628,1057,429,42.08674214818917,4886
96352da2-74d1-49fe-96a1-6b0c226fe39f,Educational,0.4819150371021601,14,1,107,379,272,18.355136254518698,2289
9b583c0d-0ff3-418b-8431-611ece6cb8ae,Educational,0.8000057373185059,11,33,572,1348,776,75.2456326341751,8380
81dae95e-9d0c-4fa9-a953-459de34050b0,Residental,0.4158726511883519,7,42,390,1267,877,55.3722876939015,7004
66bd6bab-ab8f-46a7-bdeb-fe7804f8cf86,Commercial,0.7483207026819914,26,24,716,1304,588,78.0472807567943,6635
6ab53c81-14a5-434d-ad69-de116294047f,Commercial,0.12641755502938246,48,35,554,769,215,19.778779347958867,7875
636f653c-1f37-4418-9864-d429623de67a,Healthcare,0.16408879601436166,33,21,453,709,256,29.112301922352025,7576
92ca90fd-ed1b-487f-aa36-86beff92bac7,Educational,0.393593411703166,31,30,123,459,336,88.3647641992779,5695
605e2b95-82de-4474-812c-1c0a51c44730,Healthcare,0.37705168110747456,43,50,426,555,129,35.301859750240105,8359
e5986cae-01d5-464e-bbb4-ba18a22a30ff,Residental,0.8851112489293053,46,44,640,706,66,57.844532270195415,5205
6ab03baa-3aad-4380-842e-77218666afe3,Healthcare,0.9887171626437369,3,15,706,831,125,46.17914690419248,6437
37c9adfc-52f9-48bd-92df-99478614dec0,Educational,0.9350081968393895,32,1,321,1150,829,65.03762391488118,6211
fe98bb0a-5255-4f79-b729-5ef192927d48,Healthcare,0.6654482457655757,42,14,690,1007,317,97.10562341879681,4031
4f529ee4-f060-45c5-a823-62498fb3a4fc,Healthcare,0.9681018292404285,24,10,266,617,351,31.81441339089099,5197
39d16261-e5e5-471b-bb0e-4d76b9b5406e,Commercial,0.9985315337190648,21,18,268,641,373,84.02115430679929,1867
9815ab9c-42d5-4775-822a-13db8fc2dd1a,Residental,0.019916451655178857,24,19,134,891,757,17.366789654431997,2812
d264d488-9f4d-4616-9d95-4a52a9e9c872,Educational,0.7924046095320129,16,26,246,682,436,29.73767107097965,5895
a1b31946-9450-4b85-a214-8dd82c3b1d7e,Commercial,0.848948971629143,43,13,363,1105,742,39.94660113850222,5051
a669734e-9abe-4070-b00e-6f9cf378d338,Educational,0.8121807444666118,19,46,674,893,219,51.714079151755634,1109
e696bdd9-a2e2-4285-8543-97faa33971cf,Healthcare,0.9162940166574562,46,5,572,1061,489,80.7225714018148,7353
588bc921-1131-496c-b601-712f4c61c7f9,Residental,0.6214702062352616,49,9,429,1435,1006,71.12214337038057,7494
6352d324-9e2e-4e2a-a37d-e787577eed7c,Healthcare,0.39704877770632496,34,28,676,1343,667,86.8479237967127,8293
1f8c91b5-30c2-4229-a910-0048c917f1e9,Commercial,0.9253193054649433,15,46,77,252,175,68.61597173066187,1697
9221f3b2-4263-4fc3-9596-f5da7cebaa8a,Residental,0.21201438976421982,22,30,231,609,378,90.75206289472123,1123
f5190242-22be-4406-a901-383c42f5810d,Commercial,0.8977983339624275,8,3,624,1357,733,31.275740109770986,4355
0ec6d7e1-4e12-4d3b-a3fc-555793d6337f,Residental,0.512186463577407,8,2,666,872,206,59.956210190576854,8295
34f3dfa0-031f-436f-ab1e-c47be4265da7,Residental,0.5870454963516689,9,32,142,1106,964,77.14175784181806,4308
f60f387c-b0a8-4b97-a34a-4c5b4613e8cf,Residental,0.6719906435155336,35,47,2,1271,1269,51.95491642746974,3998
8c3a46ca-2a4b-41b5-a537-d8d28b7100a5,Healthcare,0.1304035339911005,50,22,664,1425,761,32.53515230849864,7507
2aabd115-3f7a-4d04-abaf-3a0a563b9aec,Residental,0.3463214596765525,23,33,662,1297,635,32.09942834875992,8093
7ab549f8-895c-483f-83af-372df779a219,Healthcare,0.27282778861983914,29,14,239,1377,1138,48.26992982855069,3307
f10a1c9e-31f2-4686-a4a8-ceb19571e8c2,Healthcare,0.6863850650468016,22,29,89,272,183,50.26704506846079,8348
3202e33b-c8b5-4c74-b91d-b1a008b8063b,Residental,0.2605789055744919,26,24,475,1154,679,31.70277661973085,3635
fd953e9c-df8b-4ca1-a9f4-80dcd191e2f8,Healthcare,0.9771236570358385,49,20,560,1008,448,44.45609633475604,9946
fbe82c9f-0b3f-4711-a154-1dfc7aebbcf5,Educational,0.8470692798829366,31,36,421,1220,799,79.10576468555446,5108
908e15d5-dd5f-4455-ad12-e0eecd860fb3,Educational,0.27158513115301375,47,4,487,491,4,49.950420200540165,6637
4699bb28-b35f-4c87-8ab2-085767aa5a76,Commercial,0.6778623573860445,37,18,436,1278,842,50.933345419752904,4702
1f233de9-33ef-41f5-b053-d3f11e6b9fad,Commercial,0.09190629458415045,37,45,106,1191,1085,79.78913988729659,5249
05dd7dd8-5d4d-487d-8e0c-cdbe7131de07,Commercial,0.27733505157914806,35,7,345,514,169,10.064165928856015,5112
d7ba4ee9-0960-41bb-9cd3-83c8eef50fb8,Residental,0.7348035193355891,43,16,572,608,36,34.852515199435715,7525
b0e30f96-fc4a-4578-9235-ab78c7b568d9,Residental,0.2783656737652991,37,43,558,1401,843,76.44224118583942,7329
e2261101-312f-4fa7-ac7b-42dfc6c06bee,Educational,0.6192051038255103,7,36,6,957,951,40.545669038644064,6845
14da775c-9731-48e9-82ee-e82127996a95,Commercial,0.3787282101469346,1,22,687,941,254,82.37882154771629,8553
54be0d32-d85b-4cfc-aab5-48054d795870,Residental,0.21781678393906878,15,9,353,1326,973,57.97638598365947,6969
578ecaf0-54fb-4258-b6e0-c549447c9c13,Educational,0.3781619674519069,43,8,541,1119,578,82.46904811032124,4566
490e4db6-ffc2-4c3c-997f-85c32d054933,Healthcare,0.9899149362541406,36,40,429,634,205,24.067488548684107,4818
76acdf7e-b21c-43ea-a6df-6586db4f8d40,Educational,0.9630866325106073,41,44,470,683,213,25.452969673101563,4879
b7d64695-ded0-4370-a349-f69a42d3a9f5,Healthcare,0.19894249963954747,36,44,668,1354,686,13.284168450481495,2779
151e43ff-4538-452d-890b-a04edaaf87a5,Residental,0.18695865770278108,24,22,475,806,331,81.28946133739062,2600
386557e5-f7bd-4da9-a561-15a8909bde11,Commercial,0.15072296559869347,26,30,136,663,527,63.3071469192081,3688
61c2dc68-bb68-4930-b488-72104be4345f,Residental,0.24475060446091756,30,2,39,451,412,34.93499984746448,4937
b156e850-669d-47f5-a3c7-315973671f63,Healthcare,0.8052650070801943,33,40,713,1276,563,73.90994062461095,8243
70a4460d-dd07-4e99-977e-5cc989fc9a84,Healthcare,0.9017508480618138,4,2,430,516,86,77.99644334774977,6530
b2d95fb8-6e04-407b-abcc-a2396a264033,Commercial,0.120006620534864,7,41,507,1171,664,80.50707614944068,2659
9ae51b0c-5022-4ad0-bf35-b1c6b57dd8bd,Educational,0.8998225586048293,5,36,91,1178,1087,51.090975232834644,2161
065e1ef3-d4a7-473d-bf65-99c7114fbe57,Commercial,0.4245383489961928,33,10,72,1056,984,83.5515063838281,8398
5859153d-e8df-48ea-8e59-a0195b635b54,Residental,0.8729159705675388,49,42,609,950,341,61.71541171408433,4557
1f026b5c-426a-494a-a007-f707cba0291d,Healthcare,0.9111754968315325,30,25,553,765,212,94.55228040543871,9929
b70f9979-7b45-4ab6-9dac-06ede03908ac,Residental,0.6989888892340268,34,35,636,894,258,34.976269099291635,9037
a78d2120-ab0f-4f4e-9f32-0673b61f0b0c,Residental,0.1794041945162761,31,32,262,527,265,78.47558187737044,3218
cbbddcf8-6835-4aa5-af94-3088e7b0c1ad,Residental,0.6854329289422078,49,24,505,1243,738,86.77722160113663,8943
ebfb4100-eb6c-459a-9912-8971b4247984,Healthcare,0.09130913981653421,38,34,627,633,6,66.55783082178638,6571
031747c5-d863-4b7b-bdec-396facdfe72b,Healthcare,0.4166194627771008,48,43,7,699,692,43.705825318537286,8050
d24d4af4-8841-4f04-b442-c36dc40ddfad,Commercial,0.2401058360448486,10,50,86,1126,1040,68.63649231647821,5740
d73d96f1-d40f-40cf-bfe0-a77eddeb6f09,Commercial,0.5270712467928519,48,10,249,774,525,70.09798524409902,6806
32102f87-ba99-47df-b79d-32e437d2d226,Residental,0.24310196389087613,36,16,148,454,306,67.52124895692901,4187
c9916fc1-7cc6-4cf3-a1ee-3ea5339384bc,Healthcare,0.3956827282466161,47,38,211,572,361,19.83772214680634,2036
83d03f1e-d871-45dd-a742-90b1250fee95,Residental,0.8939542444353528,11,49,700,792,92,23.584590901134774,3832
0e71ea65-c4b1-4219-a2dc-b863a8d86088,Healthcare,0.8548751144698348,40,16,155,567,412,22.303767260202598,1745
d2152d6a-d3bb-43f7-846c-be0533e3b226,Healthcare,0.09376503963712257,6,38,328,1416,1088,44.6964159865641,7647
a710c13a-32ef-455c-832a-b369c5d64f89,Healthcare,0.7568850936190478,38,40,600,1084,484,56.45972303196072,8949
567880c2-6484-4d11-81f1-94743ea549a1,Educational,0.40198613804758143,24,20,79,653,574,91.23021283594363,1123
75de9e21-b527-4706-a99e-413696c216ea,Commercial,0.3023150491983979,21,44,63,390,327,58.86611362081868,2112
8f1bda84-3e5a-49c7-b12f-c12ad5b943d5,Residental,0.8645074720955522,49,24,482,1181,699,90.13083198442656,6820
7ceb5831-2311-4cad-9f70-0a9bdf837052,Educational,0.4572977680819593,47,1,319,870,551,33.65704092199709,9531
0a3df253-d6ef-4056-9c59-f48908d6a2e0,Healthcare,0.5611670146932511,2,19,708,1244,536,31.82467704711543,7010
1ec5255b-13cc-4c10-9b84-73b354f734e3,Commercial,0.07449002750335187,36,47,439,755,316,29.31140057667774,8159
ed295ec0-7f7e-4836-afa8-7bc05665e159,Healthcare,0.3537335538304244,47,24,490,1148,658,69.98757198552607,7639
80641056-7037-49e5-a71f-03bc34daed22,Healthcare,0.9574612999110497,5,1,445,1377,932,69.82194694629703,4041
71c9d752-9655-419d-a0f1-6a1c28accc93,Residental,0.34553726250492456,17,23,18,1008,990,80.2386194183926,9657
9569e4b0-c091-47e7-8cc1-7a4a94f8ba09,Residental,0.7760484097498639,17,15,356,480,124,43.56865103076957,4697
7ec967fd-e007-4de1-b75d-46ad30db7729,Residental,0.9960311994931512,17,14,263,1213,950,82.42570357784635,3129
85f5e463-5a2a-472b-9e49-3e18ea5f1cb8,Residental,0.7529975657186899,44,29,408,799,391,32.8517234045441,7675
88e2ed41-f3db-4737-b8db-4e7bb075441f,Commercial,0.719062942170119,44,26,585,768,183,40.88637302773791,1822
0c5973b6-2ce0-453b-9a3a-88aed8b16ee5,Commercial,0.4292243633158168,15,42,501,585,84,78.90769963046394,8597
76c27bf8-c7e3-4b63-9466-80088c054ca5,Educational,0.5511589605117366,38,39,521,1368,847,87.97737108836776,1458
9742a2c1-cd8b-41db-8dbb-935abf076d2d,Residental,0.3859983156478277,37,48,301,1431,1130,59.742440896760414,7941
2663bcd4-bec3-484b-a901-e814bf845e45,Educational,0.29388650596165833,11,27,586,1108,522,97.10016935280646,4299
62b94b2c-5978-40b6-8cb8-e3a6a004ba88,Educational,0.5502994376588534,15,29,366,661,295,10.36768575787885,3503
a4aa95fe-06a7-41c2-bdda-94882afe1b69,Educational,0.3059160029988428,33,38,247,538,291,26.429525356333162,5608
50ab3509-4e46-4c03-bd7f-ba4b9eacdeab,Educational,0.495077123531093,47,44,701,959,258,27.276739994462265,4549
113fce50-1807-4dad-ac78-2412ba4bfac1,Residental,0.018322200535692224,22,8,264,1182,918,11.755504799387637,1814
8317147b-6610-4307-9336-f7a5ce98ead8,Commercial,0.09078476169885952,48,40,79,650,571,91.98504478727736,5344
9f685ed0-cc34-4355-a9dc-e6459852b4ae,Healthcare,0.620737692408544,8,9,91,843,752,33.152642656950036,4936
cd0f24a1-043c-40e4-8e87-ff403257a1c9,Residental,0.4866822758116456,4,15,490,914,424,50.40213323365745,7761
f2fb448e-8b87-40eb-871e-f202d5114c2f,Commercial,0.44664916019600853,26,13,587,1084,497,13.24099541538748,5107
a8ae0e05-ec5f-4a6a-b42f-13b50bba6ac6,Residental,0.993226943589302,8,5,457,806,349,15.37026324109386,2714
55805b3d-7740-4892-a811-a951ec3466e3,Residental,0.06500402269557592,21,11,517,1030,513,81.50823635864246,3516
bb3b9e91-7063-4985-b529-8dbb6b51fd58,Healthcare,0.7893079973121699,14,18,152,306,154,66.43486744938414,9549
217f2120-5878-4b23-aad9-6858664fe042,Healthcare,0.3632020898587828,34,4,252,282,30,34.25600994462167,8550
2720bc4e-e735-4b87-acc7-d90590fbd7ca,Healthcare,0.2812246638695314,4,6,12,434,422,59.641452880877985,4189
f49a9e34-9c6a-4dbd-adfa-36dce17b43c6,Residental,0.5420702844674868,38,29,443,1288,845,57.55631919487869,9273
900d6dae-338d-467d-8a37-4cdfe900f411,Healthcare,0.7604128675368097,18,31,658,669,11,57.50849359407082,8621
da49e671-0b7b-49b1-a7bb-85ef64f46d18,Residental,0.0023966460315008042,46,18,271,1434,1163,15.008641018025335,8594
7c802609-3096-42da-b532-52dc32ee80e1,Healthcare,0.7869222605201553,22,38,539,797,258,54.60853194151517,7646
cfb0b2ca-d5c5-4039-9e54-ce4f7daf8277,Residental,0.9426428543509062,13,45,104,1260,1156,56.427027966792984,9335
a457793d-9126-42fc-9b07-bd4089528284,Healthcare,0.8820460850737656,5,32,11,72,61,43.14917395490441,9552
d83a59d3-df8d-4d43-ba50-a0961aaf847f,Healthcare,0.6353552988181209,27,13,66,730,664,49.815727301341425,8134
e697ca91-50e1-4f8f-9d95-6d3b83d19d23,Commercial,0.18243426672758367,16,19,5,874,869,22.865364573877176,8755
cd0c4282-9e97-4ed4-8f04-e89c4e9d5f21,Healthcare,0.26356546634141975,45,31,703,1145,442,66.26752383591766,3150
2f655833-7a16-42ed-93ca-e38df2428113,Healthcare,0.4224474537286067,46,14,496,1117,621,45.891934750514096,6097
6ab070fc-e008-4bf3-96bd-46259debb7b2,Educational,0.37412050064322366,27,2,160,478,318,93.10255014682366,6101
807f061f-fa37-4297-a33f-98bb75fc96b0,Commercial,0.43012856658489973,9,2,275,384,109,40.280695666212324,6208
87c97f6a-df39-4db1-9188-d49425c2e7be,Healthcare,0.9168837075007591,28,16,180,861,681,54.466269053914615,3744
29866e3f-6463-4959-88c2-19b14adaf89b,Healthcare,0.3061655653012365,40,42,431,801,370,92.12765384836878,1112
00d3341d-3666-45d2-8ee3-6b1eea6732b0,Educational,0.5076178665520805,26,18,112,379,267,78.68457089794457,9162
eab11e56-9b58-4e72-b50a-1335966ef688,Healthcare,0.23591541268184102,4,13,663,1144,481,40.639140550526164,7193
5fea919a-70d0-4458-a61c-e49ef5f9e8e8,Educational,0.6643518695593996,15,2,54,516,462,63.59086998837191,6500
b3d722e0-35a7-458f-9732-7e4d8a040271,Residental,0.3584896321802721,36,20,528,1356,828,33.536730027124484,3186
dc775da2-b05f-4c4e-9324-0a636dfb3da3,Residental,0.7493647278981759,14,39,240,1277,1037,24.1499769917966,8079
e571754e-13f5-476c-ac00-bea749ea0ea0,Commercial,0.8413226255223594,11,34,245,635,390,41.80175151889082,3565
c965cfbe-ff0e-4402-a6a3-fdbe9f7bdf98,Healthcare,0.33589776533916915,45,25,411,1309,898,72.23532309468968,2076
16fe558f-8fa1-4d94-a27e-01976e4db80c,Residental,0.15728776517729104,15,17,678,1182,504,38.79570554851861,5361
0b838766-59fb-4ec7-b9d2-dc697bf3a834,Residental,0.17200455945671678,44,17,61,1268,1207,23.46866478435087,7640
148fb812-08b8-45d9-9bb0-64a142c0fafe,Healthcare,0.5418517033956125,3,19,457,1071,614,45.08249365103123,2627
f7d45bad-6207-446a-b70f-272903325eb7,Healthcare,0.9670657888266924,37,36,58,251,193,56.00682763004109,4871
457edd38-fb42-42b7-b46f-4aca6ad00124,Residental,0.5345215274752712,42,6,641,1422,781,69.79391302769443,8824
8614adea-de31-44e6-8a17-2cb15dbbc9a0,Healthcare,0.8609907729494972,10,23,165,1263,1098,31.14567551214131,9434
bbc626fa-7046-4ce9-80a1-b82e0fd66159,Healthcare,0.7784514295095196,29,31,281,843,562,58.08674943392407,2890
23801cd6-79ce-4d1a-89e9-21374984072b,Educational,0.9986760737142246,30,11,677,1411,734,75.23724590759402,1533
907320e2-b362-44a4-b96d-f952e1250e8f,Educational,0.7750845861278324,18,37,217,412,195,47.346608812369816,3712
5c1839de-63a3-4a1b-9df9-846fd9fb9956,Educational,0.9631234493398163,10,48,459,632,173,15.470364787448702,3443
4576459f-0e6a-449d-9668-00baf15ccf44,Healthcare,0.1337487782127279,49,8,623,670,47,20.268167347920024,9579
b14da38b-eb6c-4e09-bdbd-a8689fcf3066,Healthcare,0.381101213115826,44,32,300,933,633,91.27617480184266,5672
d5f34fdc-b924-471b-bfcc-b9e17e806230,Commercial,0.5128381586586782,17,38,657,867,210,94.8095423006603,5128
c2f18078-3ff7-4d68-b016-f1a27f04adbd,Residental,0.9276378507595823,49,28,285,1168,883,71.84564557034915,8337
8a8cd4d4-6edc-472c-b8ab-56c4900ccea9,Residental,0.7792712344295214,40,17,156,290,134,39.9736730346316,4966
b298d082-cf3f-4f9e-abcb-1997b8ff5ac9,Educational,0.5457118898024499,9,23,249,831,582,69.58418251047203,9882
7905535c-9ad8-4960-81e4-315d2368e17e,Educational,0.2348977314456474,32,40,445,685,240,57.396632539437505,6509
ab71ec27-3a9e-4035-a850-45314bd8bc85,Commercial,0.45996217184940624,20,35,44,541,497,75.59638804002094,9398
0139bd97-d5b3-4eed-a481-4cee233838a3,Educational,0.13010491073129782,41,6,385,1330,945,12.274142868658952,5639
4ff9b9e2-bb98-4f61-bc28-39a90e0848d6,Healthcare,0.25200129422763673,23,14,496,1391,895,11.36015303201193,9413
bdf11dc7-d6f4-4167-8bfc-859c2a572efc,Residental,0.6603999603334509,39,48,425,1187,762,38.81116948258237,1489
dc0ae6f2-9567-48e2-9265-1c0bdfc0c5e3,Healthcare,0.8300343556229691,3,42,206,595,389,29.545514392544025,9970
57fe83af-97bc-4982-80d7-eb1d311222fb,Commercial,0.8777107527279541,42,15,150,556,406,64.53734224637603,8102
6b5c036b-56f2-4155-b8e4-5ea203a43895,Healthcare,0.6782026459151083,47,4,187,1436,1249,97.14885273589013,2706
0bdfd87d-2460-4716-bee9-27c52bd9da54,Healthcare,0.8426238911176628,18,8,328,1197,869,51.27509749740648,4120
cae26ee8-dfae-4a5e-b0b3-d706cc92c677,Educational,0.4365709409893729,19,7,599,664,65,76.49864713395982,2276
5f6deeca-f6df-4553-8157-ad7c2ddc391c,Educational,0.8304664979567545,29,12,173,931,758,62.42687084684617,9520
473eece4-b760-428c-a23e-048c362913ea,Residental,0.8094140283215607,23,31,613,1294,681,38.90724741125586,1051
f09b99bf-c196-4584-ba15-04121d70b6f9,Healthcare,0.32510832878755735,4,49,119,125,6,65.81426239924721,6951
dc62bdf0-c545-49cc-9505-b67a89c6c5cf,Educational,0.0696807475878165,43,49,443,528,85,56.290571927899926,7684
6a1c0bd8-dc7c-48d5-af2e-1bd47652ef40,Healthcare,0.28568055120904157,25,25,550,682,132,20.7208300372116,6709
852ebdc3-fd5d-4b7d-90d1-649a4a7d957d,Commercial,0.833469713129338,8,49,248,483,235,98.38279028189181,4910
7ea044af-869a-40d4-97e0-81bfd485b178,Healthcare,0.3042589788707545,30,49,643,779,136,42.38634328329997,1270
9309b571-0e16-4e94-853b-5409dcef436b,Healthcare,0.44647286881689774,45,28,180,1376,1196,70.46685462311812,3127
c365bac7-d1f9-48a8-81db-e25e43aaa70d,Healthcare,0.07337003583948787,24,26,394,647,253,87.97268939024627,9788
bc1e0a6f-491f-4ee4-ba32-b6caf3cd5596,Educational,0.18258855255620754,28,16,399,1278,879,85.74167858550007,9071
021d69cb-f4ac-4e84-aca8-4ad747eeea27,Educational,0.7112314818639551,6,50,135,1370,1235,68.87076602364206,1012
d35276e3-3601-45a9-84c8-0073e8058589,Healthcare,0.2803979178820708,37,21,82,88,6,69.78167113683807,1611
b26651f9-53da-4b00-91e0-2832713f8d1a,Healthcare,0.44571088171016526,4,24,665,708,43,74.91736441028364,3047
7872452b-08a6-4feb-9874-babcc2febf9d,Educational,0.11582933322160915,8,41,284,351,67,32.75590359521441,6267
35faaeba-929b-4151-93ee-1c3a1768a33d,Healthcare,0.5611857547538063,6,20,151,1011,860,80.31614524417888,5126
0ef620d6-fc9a-443f-baf1-b72a99ddc565,Residental,0.038601490880842526,2,44,353,473,120,47.03385835892745,4995
f11259a5-ed0f-41b8-b597-759ddeba7565,Educational,0.8570593760595943,36,40,651,933,282,16.39137110384315,1222
5bab0954-c788-4823-8b49-ba0010f8c2ae,Residental,0.61147912167913,43,32,712,1277,565,25.879623460047128,3575
75897931-c7bb-40d4-a99f-a4b8a312cb4c,Residental,0.44079394548986384,44,25,474,1265,791,59.71075315041539,6315
b43a0b67-73bb-42cb-9ba3-ed1f2933c958,Healthcare,0.3605976859601395,13,46,318,345,27,57.59093606173465,7926
9c688403-cce0-4ec2-b5da-7c7eafcbf6f3,Commercial,0.8363345907570309,32,31,182,370,188,20.4778798497992,5246
0bf4e89e-a461-4c16-8c0f-cd16bf7ef552,Residental,0.7790403086644643,4,9,600,830,230,47.1037975485954,5291
3a99b111-a67f-4625-ad10-598964b73eff,Commercial,0.3359322088291401,11,17,305,850,545,91.92536632761667,7859
263f0e2d-69a8-4961-aa78-221663100239,Educational,0.07257107263330742,4,46,391,489,98,61.487982027026796,8137
b71fa5d1-7ed4-4c42-b232-5acab3a97399,Healthcare,0.9302071088914551,43,30,298,1360,1062,56.46399395513349,9485
ee8128ec-6b02-4307-bb21-0b6bd4499518,Healthcare,0.8259776584314649,35,35,91,691,600,44.4500494026099,5466
e5132979-6acb-4b42-b04c-d86036b5a5d4,Healthcare,0.461412018280859,38,15,224,263,39,53.74858832237297,7704
a6a4e228-b376-42ad-8bb7-6675cfdb97a3,Residental,0.393432582382222,25,33,360,454,94,13.534790757097014,4345
edcc15ee-c2b6-458f-aacd-2e5af41d6eba,Healthcare,0.2433110862362894,40,27,175,543,368,57.387247285780546,3047
6f43980f-7bde-480e-9717-e7c0ce974165,Educational,0.6809167762514151,24,1,104,1137,1033,66.15172713435678,2680
3055e5e5-254f-42b8-820c-9edd11b006e9,Commercial,0.39279279694190194,21,41,526,1376,850,52.595405532000235,8183
6db4d441-b7d3-4c07-9188-f3b0eb3b82a9,Residental,0.6911501346728913,5,14,89,633,544,87.4926529245492,5133
eb4914ff-dc7c-4249-b6a4-090ae9f8a5e8,Residental,0.27161645977184823,18,9,345,1165,820,56.76499607443356,1243
2b91f5a3-9ff0-499d-a72b-2f8868e9ccde,Commercial,0.5586280761940271,27,44,649,785,136,59.816512878551684,5007
4357e4e2-556d-4090-aa19-5b3ec6b17440,Educational,0.38885511694230035,50,42,293,768,475,85.00514825745245,6775
27c9ebfc-8dea-478f-8484-0ac65b3c1cb6,Healthcare,0.19226985448570777,22,18,443,933,490,65.08570160465351,9337
e7fa890a-9745-4a39-81c6-6b07265de8c0,Healthcare,0.13757781854351925,1,29,272,594,322,66.07954937989915,7953
ca189e79-c255-428c-85b3-47e014be4177,Commercial,0.20386527413442768,9,2,412,904,492,73.4355154768484,7335
b3880a9e-bcba-4ba4-8a3a-f56e7f16bda3,Educational,0.9856136188172818,34,48,176,557,381,14.44483850720141,9036
a10eb942-b420-4f3e-bc07-5c9c942db7f2,Commercial,0.5961152857590463,27,30,452,836,384,79.2012471855185,9138
040ea4ae-5493-4413-83b2-5fc5ff3c3fe7,Commercial,0.693144982985808,7,49,418,964,546,20.732022164730665,4425
003868f1-6145-4d28-9c53-9fa76d236a8e,Educational,0.7385872124219598,14,23,190,450,260,67.54887688757738,9750
abdcc50d-b283-40dc-b4a4-9b92f0e05e9b,Commercial,0.4026395068754888,25,24,622,657,35,13.565899332808028,8538
1c6776e0-5ab1-47d3-89a5-2b02223b9c8c,Healthcare,0.9970571835575291,11,14,672,860,188,28.75462773597674,1970
95c75e43-67d0-4872-acb7-26015c4b460b,Residental,0.7562593463079521,40,29,673,1352,679,46.514438848546085,7496
8db64e6a-dea8-474a-b5a5-1da54068d9f6,Educational,0.28518229662011163,47,5,604,836,232,94.34891342263217,7003
0b2af4c1-0740-4dd6-9a4b-aede05ac972b,Residental,0.6212179947622664,22,9,291,1065,774,42.91367354232575,1758
c7517033-fac1-4a73-92f8-fd1336020e9b,Commercial,0.8635200347016264,36,34,659,725,66,98.20186879510871,4412
c117ce29-c1e4-44ba-a797-300761337c6a,Healthcare,0.615872169990518,23,14,615,887,272,13.30032430472717,8871
c1523462-44ac-4617-b926-3504fe95b83a,Healthcare,0.42505119797401447,11,20,272,544,272,83.70285270237396,6159
256af62e-3088-4842-8053-2e623c74d5d6,Commercial,0.974819160442702,2,14,303,540,237,50.68985357158142,7570
96364e22-5d62-4e5e-b82f-63b19d1e6591,Residental,0.566402907210269,22,28,694,1371,677,34.61333373942314,7467
a9fbfeef-44ee-43f4-b55c-82deb83f90ca,Educational,0.29120425033402986,38,2,234,275,41,27.022626408099665,6844
d027a058-7118-4327-8920-71e2f3d08705,Educational,0.9214313120877906,4,12,690,1028,338,46.10458795958945,7063
336521b7-9a8e-4cc2-9d02-9f358c804408,Residental,0.5124903471300533,29,5,42,999,957,86.28755323398747,5453
11bdbc10-c066-4356-a114-71c145ffd89b,Educational,0.4662431103349536,27,17,445,1387,942,68.50253936163102,6580
9291fcba-5fc1-487b-a6c4-c972fe62335d,Commercial,0.5021466760322085,9,16,297,632,335,35.59542237088656,4935
7792ae5c-ed19-49f1-bd68-5f4400fe498b,Residental,0.3822360675061215,28,19,443,1236,793,18.999054753261206,8803
ecbbd4f2-1b40-42da-8613-783180aea03f,Commercial,0.29583061983746983,6,25,465,1409,944,37.33723620509588,2636
6bb71886-82da-4625-8e33-308394e04827,Commercial,0.7431763379363403,40,6,537,820,283,34.20709664050034,2049
c1485cc3-4c2d-4fe6-a529-4f87e4cc3db3,Educational,0.638876113903006,43,42,495,1320,825,41.247963791571976,5322
ff3fc3fa-98fd-4d0e-b106-b735f2d3b51c,Educational,0.5031804378564568,34,43,603,1313,710,26.790836184236824,6172
f23706c7-b8c7-45a7-a93f-159818a454cf,Commercial,0.8125737925778557,38,13,176,226,50,74.36904225522078,5331
105bae7e-0336-41ce-820f-dde763edb36b,Commercial,0.44886790494237017,39,30,211,221,10,92.64589451462209,9729
ed48ce7d-efeb-4e01-8272-5b3cf03da37b,Educational,0.5638616211896127,16,31,627,1021,394,44.58789035216757,3563
019e8bae-06c6-464d-bf01-9fa6e4fa68a0,Commercial,0.3511076141370233,41,28,712,786,74,71.35741012015305,6666
a6008f37-0cff-48b6-bd46-7c2a1ac9a4bd,Healthcare,0.23343282210829652,6,1,220,1224,1004,89.08742090625255,9184
3f76417b-75dc-45e3-9c62-fe35bcec39cf,Commercial,0.03861446544087721,26,18,185,1300,1115,49.30430632216709,7753
a48d99dc-9eb7-43f2-8256-e07f4c8069fb,Commercial,0.5462125723025903,4,43,326,888,562,71.15207018325131,6990
df4a50ed-f15a-4d77-a3aa-54d0d1a8bcfa,Healthcare,0.8923087496436678,34,38,363,753,390,96.92725839035636,7057
982fd454-96c2-45bc-b0ac-b703a2cd5da4,Educational,0.8989729716466032,48,7,285,1202,917,54.25795896953771,2243
3f8b4e53-b5f5-49a3-8531-7e7d9fb5f39f,Educational,0.6372340207508667,6,37,708,976,268,94.45411034265311,8359
83c8a301-ac01-459e-aa75-8ce8ccd2d906,Commercial,0.860273657545956,7,47,118,146,28,71.479786784948,4915
92a0ecf3-b43d-47dd-9cff-220d906b76da,Residental,0.1247928876088128,9,20,197,598,401,53.639770619131674,8909
46b14bb1-2600-4831-b6ad-c2725e7eb76a,Educational,0.5414291067999967,12,12,7,787,780,22.79749313779385,7975
54cf2188-d834-464d-afff-323ac52bd954,Commercial,0.8480042304790857,36,30,224,1008,784,94.23822044015228,7063
dadb12d0-f8ad-4f9c-8cf6-0241fb76bea0,Healthcare,0.3550119856575207,18,30,709,1082,373,84.59198865008342,7256
546c66c5-3aca-40b8-9d45-f727ac5c3204,Educational,0.665091632379067,31,4,167,341,174,54.448958789121306,9412
387abae9-2f4d-4e24-a3cd-2fe6f73e4522,Residental,0.28237714757073484,11,37,255,1022,767,19.1964896072326,2862
fc1598f6-8cdf-46e7-9501-f76fafa31962,Residental,0.3766572037755942,41,8,689,1197,508,83.29184411631387,9152
3606807b-4422-49dc-8657-e239d784ff88,Healthcare,0.4653310018329829,40,39,513,835,322,40.813298844013886,6919
763ba06b-b0e3-4727-8a77-263dc342e570,Commercial,0.15254324018267884,10,10,668,1074,406,11.712597788072047,2465
2645eab9-5a71-4d4d-a19a-50571d610062,Educational,0.03820214573464009,8,10,373,422,49,76.59859970805864,3748
588eac98-c75f-41b5-8762-a2c1512e0284,Commercial,0.7674197725990484,14,29,148,345,197,47.45808697750197,8949
08159a60-f27b-4d64-84fd-f92aa4fa7417,Educational,0.749876223061762,29,45,198,666,468,83.7428864708304,6551
e04c2045-d09f-46a3-bcdb-6e0c0f6b6550,Healthcare,0.5757757811864358,8,19,48,366,318,67.55316717695769,6502
84539107-888b-4494-8434-d30197684bd4,Educational,0.7033058771802492,20,18,274,839,565,65.0804635339025,7643
42fbe368-16e9-4a4e-b31b-cfb7a96c3609,Residental,0.8303719706359444,28,10,223,1414,1191,38.78626889585068,6834
80391701-4ab6-4e39-aa00-5190b53c0e8c,Residental,0.9086794528190485,41,25,106,1045,939,84.896384236462,1280
3c0dab2c-6ec4-43b0-9bd8-7d9f99fc94e8,Healthcare,0.5054568320314126,9,32,63,237,174,59.49518713594067,8282
cb41d2fe-e599-478f-ab27-323ac51124d6,Educational,0.7276353894696538,35,4,537,674,137,64.21401289324878,8555
a5803b2b-66c7-4b80-8ce8-8a69b8c22afd,Educational,0.7957182890036913,42,1,144,358,214,88.3319323801795,1150
b04818f0-17a5-406b-ac3b-e220cfc8e353,Healthcare,0.9362585441637125,36,2,487,1166,679,43.974366947321926,6492
2bc54034-0240-443e-bc1e-ca56178b2cef,Healthcare,0.6476377248584518,2,1,355,1215,860,68.37039246948106,6231
eae20cd0-fcfc-4e8e-990e-a9d23669f397,Educational,0.2233422855658721,32,27,534,1012,478,67.34766157187349,6878
16888da6-8d69-4175-baff-f446001cc7e1,Educational,0.3648948315310202,43,19,20,1261,1241,25.671003697220257,7744
4b53ceae-6119-4640-a54f-20474c307ee5,Residental,0.8516846719646394,21,28,70,129,59,20.601528728842382,5374
27945508-12f7-4ff6-bc5c-07601f59cad7,Residental,0.3281067250124141,10,29,679,954,275,66.15015590825388,2543
f9a484eb-18ab-46fd-bbe7-e015e2fdb21f,Healthcare,0.10455552995453543,47,12,610,800,190,91.70666046499652,2487
d6847a61-0f64-471a-959e-163f21bd68bb,Residental,0.6803833630239361,17,16,403,555,152,84.25909315185741,2915
ac1992eb-fdc0-4fea-9abc-a200acee11ff,Commercial,0.5898989221158686,32,32,429,1406,977,78.83017824791654,7574
20d6b17e-2b39-4307-86f6-3b536ebbe8b3,Healthcare,0.6634503427146219,47,47,153,282,129,79.91115103712603,6969
cdbcabeb-2f5e-4826-b907-06c2403330ec,Residental,0.3284840091590926,37,4,626,1119,493,68.2106626052896,9509
2ad9f404-aaa7-424c-97a3-e5a9c0c70cdd,Residental,0.5767066325734097,15,45,694,1288,594,49.15658210289203,1366
541bd205-e45a-473f-a0cc-538d6ce60458,Commercial,0.14950282693363548,46,30,699,720,21,92.27063707048428,2758
dc64b60f-ecd1-4a71-88bf-3cb3e1750b54,Commercial,0.9548334837824338,30,8,11,982,971,93.29987832028556,9092
c341544e-34d1-4ef2-a79a-10db114efccf,Healthcare,0.941703278522596,16,47,541,1001,460,21.37916711921669,9929
7ca31b3c-a02f-495e-8706-53ea851fe96a,Educational,0.8648451617166134,41,42,313,1034,721,85.52653122559158,4068
aca27642-46fd-427c-9613-b59b1d1e43c6,Residental,0.2806017063051638,50,39,89,688,599,32.837661382877435,3078
152b81ba-e1be-4943-8082-74456d42273f,Commercial,0.4603804425599507,38,50,300,1238,938,57.383346766841136,7959
3d18caef-101b-40c7-b937-b928623f6706,Educational,0.174103140253409,33,7,688,986,298,28.544379059156018,9887
531b25cd-67e9-4c3d-ba04-13748bac1a13,Healthcare,0.6104674922934157,17,42,92,1214,1122,68.95291184401303,4798
852fff5f-a121-4cad-b486-4d7b7b86d889,Educational,0.8286803447662425,27,21,578,774,196,62.35558711822712,2629
56c8f277-fe1a-4605-9251-0f61fc5ea4bd,Educational,0.6080214499550272,1,29,129,839,710,23.610831149051666,7873
d48adc2c-b1a2-436a-a5f8-db067fdee89a,Educational,0.3075846357131714,13,43,270,1125,855,29.075612949555715,7808
06bdb7a8-f8f0-48b2-9d08-645c047b6a03,Healthcare,0.7212259374772005,15,33,681,1366,685,28.70264883263409,4637
6a39d9b8-7345-46f3-bd4c-a00bf43c3d07,Healthcare,0.7994913537617361,3,13,454,1433,979,56.10215868491917,7256
0bff2c50-d8a4-4383-a169-9465acbf5cba,Educational,0.6699797323061526,43,23,704,1092,388,44.1696490009472,5984
665f8e3d-8dc4-439f-8f57-ef327f964423,Educational,0.12941625109407506,11,23,171,753,582,24.874866432778195,2298
d7fe8d7c-1aa2-4739-b801-ecfaa307ec51,Commercial,0.4477273182826925,16,50,595,717,122,91.04561496117884,2134
723ada02-24ff-43d6-a277-3742015eaf4c,Educational,0.9156682663894953,34,44,77,1267,1190,84.38639572713704,8757
52feec44-b45c-4c42-b896-6a6bc7ed17cc,Educational,0.4561242816807569,50,30,124,770,646,75.74655998024156,9793
736afce9-512e-47aa-ba2e-abc4ca71f247,Commercial,0.35265993574347443,14,18,455,724,269,92.04754309437016,3316
cf9016e9-adfa-4eb6-9cdf-46a07daa333e,Residental,0.9590441896469171,17,8,715,934,219,88.56673487488477,3881
7d992e9a-2568-46d4-9cb1-3baf61bbc590,Residental,0.21657161343517606,8,2,474,690,216,58.41554793266685,2001
02843520-916e-4afd-b3ce-fbad7b9d476d,Commercial,0.08730463509382758,38,2,440,1380,940,88.43075263964069,6224
3da238ae-45ae-4981-9fc7-5605da01e940,Healthcare,0.971730474493793,49,14,317,566,249,28.62351772184947,7410
b74b2457-c829-48c7-9ce7-3556c29282d9,Commercial,0.012477581676246241,26,6,188,1197,1009,92.43208029251277,4157
c136f223-f28b-46c9-89a6-f4ae999250c8,Residental,0.7241261098194838,19,11,159,1330,1171,71.7313105600482,6674
157bc376-28af-4339-8899-df88eb8997dc,Residental,0.37389955821547294,20,42,41,1152,1111,11.214723620356805,8994
23f10fbb-2893-4d5f-b72a-a11dbc7167c7,Residental,0.9449513464337901,26,50,54,955,901,27.4526563803564,6828
8e885996-4b4a-443e-b5b4-632a47299052,Educational,0.6384382447696927,44,44,23,472,449,97.64277301558218,6254
fdcd9aa6-cf3c-4b8d-8c24-b8fb48a4510a,Residental,0.41449101262140475,25,47,396,1394,998,25.50781639585157,7890
0a3bd897-36d6-4ee6-96d6-ee75dce3a13f,Commercial,0.35892997946145655,44,5,510,747,237,11.31809065758388,4522
e29a9a13-efa2-4a08-9239-4c9b30f16b14,Residental,0.46427054851907246,9,18,101,544,443,82.55761299756732,2407
7efcc0a0-b984-4171-a353-71a85c2a15a3,Educational,0.5325734256159028,11,12,74,139,65,57.30655485581857,7068
4676e58e-203c-446a-a26a-086f3145fd43,Educational,0.8940846057845746,3,38,176,216,40,78.64920510391963,2661
a1448e59-db8e-4e25-a145-58d7450311f1,Healthcare,0.2013313342988502,31,19,358,1026,668,87.53216299494231,4645
75d9f33d-54cb-4033-be41-697ee682bae8,Commercial,0.8979591263833856,14,7,339,677,338,88.34445207354453,6883
07a83024-0563-4eef-a296-d8ef19cae7dc,Healthcare,0.8150335340435366,16,16,5,612,607,68.44734750099369,7998
d9340538-cd5a-47fb-9ebf-95a33a6d5458,Healthcare,0.9441713564322434,15,40,708,960,252,30.99176367666505,7246
f9fb8791-79d8-4926-9d27-f0eee983bf00,Residental,0.559359032956764,43,12,502,1207,705,85.08417602401252,5918
3876d67c-dac0-45a5-95d4-2cf9b948a719,Healthcare,0.8184938252099324,13,14,179,523,344,43.017833753452805,1535
4a5e4d6e-32af-40f0-afbb-44fd9deb8863,Educational,0.4734315585118336,1,16,531,1322,791,84.39829379223234,6754
fbeaabd1-b1c3-4412-8361-91424362be9f,Commercial,0.9258097241361831,31,39,69,1264,1195,42.61146063592442,8275
f9b71f5f-d35f-4b1d-8d0b-924afbb6e9ad,Educational,0.555698252599969,34,5,28,493,465,13.544226978992977,8310
3199bd9d-0af7-4a7d-8f6b-880a2fea5547,Healthcare,0.48316631109334396,18,28,267,609,342,62.22309630419898,8381
466ef4e1-db25-4a84-9ffc-fc8f8d497e1a,Healthcare,0.02373997531565164,40,30,451,1165,714,33.80079155958947,1353
85bd06f9-c641-49b1-91a8-6bbfa0bd350a,Residental,0.03690967766586761,20,37,375,1436,1061,28.23370967223541,2335
a0801fc4-dfbb-4186-bfca-108ebaff6507,Residental,0.4882286187784204,14,32,118,779,661,22.550846572454113,6046
6733847c-c20b-41a9-9baf-05364cacd463,Healthcare,0.9018851137431361,10,14,95,263,168,27.070696564668445,5739
acf2ef8a-4da1-4c3a-a0ed-a372da698570,Residental,0.2591236938699911,11,16,181,386,205,79.98648052673953,6130
6cbba339-1a91-4986-b8e2-905fb3bfe2df,Residental,0.28502536674585155,26,48,431,1092,661,12.135048792035839,4246
ddfe32ee-a5ca-4aa7-a704-07e20d30c3e1,Commercial,0.5623398433652141,23,1,604,1053,449,46.02463357047033,9025
7b592ea8-9528-4d22-aa5a-18fabaeaaaf3,Residental,0.3715162657233544,30,3,72,223,151,39.71773471745913,8401
90b8c9b1-d244-4cab-8f7a-626b9bfab8ad,Residental,0.8715698619678349,27,32,129,222,93,28.39901552530729,2734
1b2b049a-2760-4402-b311-1bbfe465b810,Healthcare,0.19538553152155613,4,37,258,347,89,20.824078217277183,7362
6f1b837a-f6ab-41db-a3f4-4578a96a5e8f,Educational,0.4327915628294903,22,29,259,1229,970,22.082112446947807,6021
7c918700-3d00-4d76-974c-5b3f4c4a7db5,Residental,0.05759749962164207,13,14,420,467,47,21.995100269443103,7424
c891b90a-e41e-45a0-bdfd-303687a5283d,Educational,0.14555738130595364,26,31,247,266,19,38.47495626757441,2210
